Rk,Team,Date,PTS,,Opp,Result,MP,FG,FGA,FG%,2P,2PA,2P%,3P,3PA,3P%,FT,FTA,FT%,PTS,FG,FGA,FG%,2P,2PA,2P%,3P,3PA,3P%,FT,FTA,FT%,PTS
1,HOU,2019-10-30,159,@,WAS,W 159-158,240,55,103,.534,32,49,.653,23,54,.426,26,33,.788,159,57,91,.626,37,55,.673,20,36,.556,24,29,.828,158
2,HOU,2019-11-30,158,,ATL,W 158-111,240,52,89,.584,27,38,.711,25,51,.490,29,34,.853,158,38,89,.427,23,43,.535,15,46,.326,20,25,.800,111
3,WAS,2019-10-30,158,,HOU,L 158-159,240,57,91,.626,37,55,.673,20,36,.556,24,29,.828,158,55,103,.534,32,49,.653,23,54,.426,26,33,.788,159
4,HOU,2020-07-31,153,@,DAL,W 153-149 (OT),265,52,101,.515,33,53,.623,19,48,.396,30,39,.769,153,50,105,.476,29,56,.518,21,49,.429,28,38,.737,149
5,ATL,2020-01-26,152,,WAS,W 152-133,240,54,93,.581,39,58,.672,15,35,.429,29,34,.853,152,42,88,.477,31,55,.564,11,33,.333,38,42,.905,133
6,MIL,2020-01-28,151,,WAS,W 151-131,240,50,90,.556,31,53,.585,19,37,.514,32,35,.914,151,44,94,.468,30,62,.484,14,32,.438,29,34,.853,131
7,LAC,2019-12-01,150,,WAS,W 150-125,240,52,94,.553,38,62,.613,14,32,.438,32,40,.800,150,47,102,.461,36,72,.500,11,30,.367,20,27,.741,125
8,LAC,2019-11-16,150,,ATL,W 150-101,240,50,93,.538,33,60,.550,17,33,.515,33,35,.943,150,34,90,.378,28,66,.424,6,24,.250,27,37,.730,101
9,BOS,2020-08-05,149,,BRK,W 149-115,240,50,88,.568,30,49,.612,20,39,.513,29,35,.829,149,45,95,.474,37,63,.587,8,32,.250,17,21,.810,115
10,DAL,2020-07-31,149,,HOU,L 149-153 (OT),265,50,105,.476,29,56,.518,21,49,.429,28,38,.737,149,52,101,.515,33,53,.623,19,48,.396,30,39,.769,153
11,SAS,2019-12-23,145,@,MEM,W 145-115,240,60,89,.674,45,65,.692,15,24,.625,10,14,.714,145,45,96,.469,30,59,.508,15,37,.405,10,16,.625,115
12,ATL,2020-03-09,143,,CHO,W 143-138 (2OT),290,53,96,.552,32,53,.604,21,43,.488,16,27,.593,143,49,104,.471,30,56,.536,19,48,.396,21,23,.913,138
13,NYK,2019-12-17,143,,ATL,W 143-120,240,53,95,.558,40,67,.597,13,28,.464,24,31,.774,143,45,99,.455,30,56,.536,15,43,.349,15,20,.750,120
14,DAL,2019-11-22,143,,CLE,W 143-101,240,58,100,.580,38,63,.603,20,37,.541,7,9,.778,143,37,86,.430,25,57,.439,12,29,.414,15,17,.882,101
15,MIN,2020-02-08,142,,LAC,W 142-115,240,52,95,.547,26,51,.510,26,44,.591,12,18,.667,142,41,86,.477,32,60,.533,9,26,.346,24,29,.828,115
16,LAL,2019-12-08,142,,MIN,W 142-125,240,55,94,.585,41,63,.651,14,31,.452,18,20,.900,142,44,84,.524,29,47,.617,15,37,.405,22,26,.846,125
17,DAL,2019-11-20,142,,GSW,W 142-94,240,51,90,.567,29,52,.558,22,38,.579,18,23,.783,142,35,90,.389,27,63,.429,8,27,.296,16,25,.640,94
18,ATL,2020-02-28,141,,BRK,W 141-118,240,50,97,.515,31,58,.534,19,39,.487,22,30,.733,141,42,92,.457,24,46,.522,18,46,.391,16,21,.762,118
19,BOS,2020-02-13,141,,LAC,W 141-133 (2OT),290,45,103,.437,27,60,.450,18,43,.419,33,40,.825,141,46,110,.418,35,75,.467,11,35,.314,30,37,.811,133
20,DAL,2019-12-28,141,@,GSW,W 141-121,240,48,92,.522,24,41,.585,24,51,.471,21,21,1.000,141,45,93,.484,27,54,.500,18,39,.462,13,17,.765,121
21,PHI,2019-12-07,141,,CLE,W 141-94,240,57,90,.633,46,64,.719,11,26,.423,16,23,.696,141,36,96,.375,27,61,.443,9,35,.257,13,17,.765,94
22,LAC,2019-10-24,141,@,GSW,W 141-122,240,50,80,.625,32,48,.667,18,32,.563,23,30,.767,141,39,99,.394,24,57,.421,15,42,.357,29,30,.967,122
23,SAC,2020-08-06,140,,NOP,W 140-125,240,50,93,.538,34,60,.567,16,33,.485,24,33,.727,140,47,82,.573,33,48,.688,14,34,.412,17,23,.739,125
24,POR,2020-07-31,140,,MEM,W 140-135 (OT),265,49,91,.538,36,61,.590,13,30,.433,29,34,.853,140,42,93,.452,29,52,.558,13,41,.317,38,50,.760,135
25,PHO,2020-03-08,140,,MIL,W 140-131,240,47,85,.553,28,42,.667,19,43,.442,27,31,.871,140,51,95,.537,38,62,.613,13,33,.394,16,21,.762,131
26,HOU,2020-02-26,140,,MEM,W 140-112,240,52,93,.559,29,43,.674,23,50,.460,13,15,.867,140,43,108,.398,30,69,.435,13,39,.333,13,21,.619,112
27,ATL,2020-02-09,140,,NYK,W 140-135 (2OT),290,49,108,.454,35,68,.515,14,40,.350,28,31,.903,140,52,110,.473,39,76,.513,13,34,.382,18,25,.720,135
28,OKC,2020-01-24,140,,ATL,W 140-111,240,50,86,.581,36,61,.590,14,25,.560,26,34,.765,140,42,92,.457,31,56,.554,11,36,.306,16,20,.800,111
29,TOR,2020-01-17,140,,WAS,W 140-111,240,52,91,.571,30,48,.625,22,43,.512,14,16,.875,140,40,89,.449,25,54,.463,15,35,.429,16,23,.696,111
30,BOS,2020-01-11,140,,NOP,W 140-105,240,55,100,.550,41,71,.577,14,29,.483,16,18,.889,140,40,100,.400,26,55,.473,14,45,.311,11,18,.611,105
31,MEM,2020-01-04,140,@,LAC,W 140-114,240,49,96,.510,31,57,.544,18,39,.462,24,28,.857,140,45,101,.446,38,71,.535,7,30,.233,17,22,.773,114
32,WAS,2019-11-27,140,@,PHO,W 140-132,240,51,89,.573,32,54,.593,19,35,.543,19,20,.950,140,48,93,.516,33,55,.600,15,38,.395,21,24,.875,132
33,BOS,2019-11-13,140,,WAS,W 140-133,240,49,96,.510,33,60,.550,16,36,.444,26,29,.897,140,50,96,.521,39,67,.582,11,29,.379,22,27,.815,133
34,BRK,2020-03-06,139,,SAS,W 139-120,240,51,96,.531,36,60,.600,15,36,.417,22,31,.710,139,43,92,.467,33,58,.569,10,34,.294,24,27,.889,120
35,MIN,2020-03-03,139,@,NOP,W 139-134,240,54,97,.557,40,63,.635,14,34,.412,17,20,.850,139,52,100,.520,38,61,.623,14,39,.359,16,27,.593,134
36,DAL,2020-02-24,139,,MIN,W 139-123,240,51,101,.505,35,57,.614,16,44,.364,21,28,.750,139,42,95,.442,27,53,.509,15,42,.357,24,34,.706,123
37,NYK,2020-02-03,139,@,CLE,W 139-134 (OT),265,57,102,.559,47,76,.618,10,26,.385,15,21,.714,139,52,92,.565,34,57,.596,18,35,.514,12,18,.667,134
38,NOP,2020-01-31,139,,MEM,W 139-111,240,51,95,.537,36,61,.590,15,34,.441,22,26,.846,139,45,96,.469,39,65,.600,6,31,.194,15,26,.577,111
39,POR,2020-01-26,139,,IND,W 139-129,240,49,90,.544,29,55,.527,20,35,.571,21,25,.840,139,48,93,.516,35,65,.538,13,28,.464,20,21,.952,129
40,BOS,2020-01-20,139,,LAL,W 139-107,240,52,93,.559,36,59,.610,16,34,.471,19,29,.655,139,39,89,.438,32,63,.508,7,26,.269,22,29,.759,107
41,HOU,2020-01-11,139,,MIN,W 139-109,240,49,95,.516,31,50,.620,18,45,.400,23,29,.793,139,36,95,.379,23,47,.489,13,48,.271,24,36,.667,109
42,HOU,2019-12-21,139,@,PHO,W 139-125,240,51,87,.586,32,46,.696,19,41,.463,18,23,.783,139,47,91,.516,39,63,.619,8,28,.286,23,30,.767,125
43,OKC,2019-12-06,139,,MIN,W 139-127 (OT),265,49,88,.557,44,70,.629,5,18,.278,36,40,.900,139,50,96,.521,37,58,.638,13,38,.342,14,20,.700,127
44,PHO,2019-12-05,139,@,NOP,W 139-132 (OT),265,50,106,.472,36,70,.514,14,36,.389,25,27,.926,139,44,87,.506,27,46,.587,17,41,.415,27,35,.771,132
45,CHO,2020-03-09,138,@,ATL,L 138-143 (2OT),290,49,104,.471,30,56,.536,19,48,.396,21,23,.913,138,53,96,.552,32,53,.604,21,43,.488,16,27,.593,143
46,NOP,2020-02-11,138,,POR,W 138-117,240,49,92,.533,35,58,.603,14,34,.412,26,32,.813,138,44,93,.473,37,64,.578,7,29,.241,22,28,.786,117
47,NOP,2020-01-16,138,,UTA,W 138-132 (OT),265,51,93,.548,40,67,.597,11,26,.423,25,35,.714,138,46,100,.460,31,61,.508,15,39,.385,25,32,.781,132
48,WAS,2019-11-20,138,,SAS,W 138-132,240,54,92,.587,36,62,.581,18,30,.600,12,15,.800,138,49,93,.527,37,61,.607,12,32,.375,22,29,.759,132
49,PHO,2019-11-10,138,,BRK,W 138-112,240,52,99,.525,33,57,.579,19,42,.452,15,19,.789,138,44,91,.484,36,57,.632,8,34,.235,16,17,.941,112
50,DAL,2019-11-09,138,@,MEM,W 138-122,240,52,97,.536,34,55,.618,18,42,.429,16,20,.800,138,50,95,.526,38,59,.644,12,36,.333,10,14,.714,122
51,MIL,2020-02-24,137,@,WAS,W 137-134 (OT),265,49,86,.570,32,49,.653,17,37,.459,22,27,.815,137,47,98,.480,32,63,.508,15,35,.429,25,33,.758,134
52,TOR,2020-02-10,137,,MIN,W 137-126,240,51,89,.573,34,56,.607,17,33,.515,18,23,.783,137,39,86,.453,21,46,.457,18,40,.450,30,35,.857,126
53,MIA,2020-02-03,137,,PHI,W 137-106,240,48,85,.565,32,53,.604,16,32,.500,25,30,.833,137,36,83,.434,23,45,.511,13,38,.342,21,25,.840,106
54,MIL,2019-11-30,137,,CHO,W 137-96,240,54,96,.563,34,52,.654,20,44,.455,9,15,.600,137,37,101,.366,22,56,.393,15,45,.333,7,8,.875,96
55,DAL,2019-11-24,137,@,HOU,W 137-123,240,49,102,.480,32,58,.552,17,44,.386,22,28,.786,137,45,98,.459,35,54,.648,10,44,.227,23,31,.742,123
56,MIL,2019-11-21,137,,POR,W 137-129,240,50,106,.472,34,63,.540,16,43,.372,21,26,.808,137,50,103,.485,33,64,.516,17,39,.436,12,14,.857,129
57,WAS,2019-11-15,137,@,MIN,W 137-116,240,54,100,.540,44,72,.611,10,28,.357,19,25,.760,137,42,89,.472,31,52,.596,11,37,.297,21,29,.724,116
58,MEM,2019-11-06,137,,MIN,W 137-121,240,50,88,.568,38,65,.585,12,23,.522,25,30,.833,137,43,96,.448,27,51,.529,16,45,.356,19,26,.731,121
59,SAC,2020-08-13,136,@,LAL,W 136-122,240,54,95,.568,33,48,.688,21,47,.447,7,12,.583,136,48,98,.490,33,63,.524,15,35,.429,11,15,.733,122
60,DAL,2020-08-08,136,,MIL,W 136-132 (OT),265,48,115,.417,31,62,.500,17,53,.321,23,25,.920,136,47,99,.475,32,55,.582,15,44,.341,23,34,.676,132
61,NYK,2020-03-11,136,@,ATL,W 136-131 (OT),265,50,94,.532,39,66,.591,11,28,.393,25,34,.735,136,48,106,.453,34,65,.523,14,41,.341,21,26,.808,131
62,LAC,2020-03-01,136,,PHI,W 136-130,240,45,76,.592,32,52,.615,13,24,.542,33,41,.805,136,48,95,.505,27,52,.519,21,43,.488,13,20,.650,130
63,ORL,2020-02-28,136,,MIN,W 136-125,240,53,98,.541,41,58,.707,12,40,.300,18,22,.818,136,46,95,.484,29,51,.569,17,44,.386,16,24,.667,125
64,DET,2020-01-18,136,@,ATL,W 136-103,240,51,86,.593,36,54,.667,15,32,.469,19,25,.760,136,40,93,.430,30,59,.508,10,34,.294,13,15,.867,103
65,SAS,2019-12-28,136,,DET,W 136-109,240,53,93,.570,35,58,.603,18,35,.514,12,15,.800,136,40,90,.444,28,54,.519,12,36,.333,17,30,.567,109
66,CHI,2019-12-11,136,,ATL,W 136-102,240,54,94,.574,43,70,.614,11,24,.458,17,19,.895,136,35,83,.422,22,45,.489,13,38,.342,19,26,.731,102
67,LAL,2019-12-06,136,@,POR,W 136-113,240,46,85,.541,29,49,.592,17,36,.472,27,33,.818,136,39,86,.453,29,52,.558,10,34,.294,25,29,.862,113
68,POR,2019-11-27,136,,OKC,W 136-119,240,49,94,.521,35,64,.547,14,30,.467,24,24,1.000,136,39,88,.443,28,53,.528,11,35,.314,30,38,.789,119
69,MEM,2020-07-31,135,@,POR,L 135-140 (OT),265,42,93,.452,29,52,.558,13,41,.317,38,50,.760,135,49,91,.538,36,61,.590,13,30,.433,29,34,.853,140
70,HOU,2020-02-20,135,@,GSW,W 135-105,240,45,85,.529,20,36,.556,25,49,.510,20,22,.909,135,44,89,.494,37,56,.661,7,33,.212,10,12,.833,105
71,ORL,2020-02-10,135,,ATL,W 135-126,240,50,95,.526,32,57,.561,18,38,.474,17,22,.773,135,47,88,.534,31,51,.608,16,37,.432,16,17,.941,126
72,NYK,2020-02-09,135,@,ATL,L 135-140 (2OT),290,52,110,.473,39,76,.513,13,34,.382,18,25,.720,135,49,108,.454,35,68,.515,14,40,.350,28,31,.903,140
73,LAC,2020-01-05,135,,NYK,W 135-132,240,45,83,.542,27,51,.529,18,32,.563,27,33,.818,135,48,84,.571,36,61,.590,12,23,.522,24,37,.649,132
74,MIA,2019-12-10,135,,ATL,W 135-121 (OT),265,53,103,.515,39,62,.629,14,41,.341,15,22,.682,135,45,95,.474,25,41,.610,20,54,.370,11,18,.611,121
75,LAC,2019-12-08,135,@,WAS,W 135-119,240,50,96,.521,35,56,.625,15,40,.375,20,27,.741,135,40,88,.455,26,55,.473,14,33,.424,25,30,.833,119
76,SAS,2019-12-03,135,,HOU,W 135-133 (2OT),290,50,106,.472,37,76,.487,13,30,.433,22,32,.688,135,42,111,.378,27,60,.450,15,51,.294,34,36,.944,133
77,MIL,2019-11-20,135,@,ATL,W 135-127,240,46,87,.529,29,44,.659,17,43,.395,26,34,.765,135,44,96,.458,30,65,.462,14,31,.452,25,31,.806,127
78,BOS,2019-11-09,135,@,SAS,W 135-115,240,48,94,.511,34,57,.596,14,37,.378,25,28,.893,135,39,99,.394,25,69,.362,14,30,.467,23,30,.767,115
79,BRK,2019-11-04,135,,NOP,W 135-125,240,49,92,.533,33,51,.647,16,41,.390,21,28,.750,135,48,97,.495,35,65,.538,13,32,.406,16,21,.762,125
80,PHI,2020-08-14,134,@,HOU,W 134-96,240,49,87,.563,31,49,.633,18,38,.474,18,22,.818,134,35,80,.438,23,32,.719,12,48,.250,14,16,.875,96
81,POR,2020-08-13,134,@,BRK,W 134-133,240,50,104,.481,37,65,.569,13,39,.333,21,24,.875,134,53,96,.552,39,63,.619,14,33,.424,13,19,.684,133
82,POR,2020-08-11,134,@,DAL,W 134-131,240,46,98,.469,31,60,.517,15,38,.395,27,29,.931,134,42,81,.519,22,37,.595,20,44,.455,27,33,.818,131
83,DEN,2020-08-08,134,,UTA,W 134-132 (2OT),290,51,108,.472,42,71,.592,9,37,.243,23,30,.767,134,47,105,.448,25,50,.500,22,55,.400,16,22,.727,132
84,NOP,2020-03-03,134,,MIN,L 134-139,240,52,100,.520,38,61,.623,14,39,.359,16,27,.593,134,54,97,.557,40,63,.635,14,34,.412,17,20,.850,139
85,WAS,2020-02-24,134,,MIL,L 134-137 (OT),265,47,98,.480,32,63,.508,15,35,.429,25,33,.758,134,49,86,.570,32,49,.653,17,37,.459,22,27,.815,137
86,CLE,2020-02-03,134,,NYK,L 134-139 (OT),265,52,92,.565,34,57,.596,18,35,.514,12,18,.667,134,57,102,.559,47,76,.618,10,26,.385,15,21,.714,139
87,MIA,2020-01-22,134,,WAS,W 134-129 (OT),265,43,85,.506,26,52,.500,17,33,.515,31,36,.861,134,50,99,.505,37,57,.649,13,42,.310,16,20,.800,129
88,DEN,2020-01-16,134,@,GSW,W 134-131 (OT),265,47,100,.470,30,65,.462,17,35,.486,23,26,.885,134,42,95,.442,22,50,.440,20,45,.444,27,31,.871,131
89,MEM,2020-01-10,134,,SAS,W 134-121,240,52,100,.520,36,62,.581,16,38,.421,14,16,.875,134,42,87,.483,25,47,.532,17,40,.425,20,23,.870,121
90,LAC,2019-12-21,134,@,SAS,W 134-109,240,54,99,.545,42,63,.667,12,36,.333,14,19,.737,134,42,82,.512,32,54,.593,10,28,.357,15,19,.789,109
91,LAC,2019-11-24,134,,NOP,W 134-109,240,46,98,.469,30,55,.545,16,43,.372,26,33,.788,134,43,98,.439,30,57,.526,13,41,.317,10,18,.556,109
92,MIL,2019-11-04,134,@,MIN,W 134-106,240,50,93,.538,36,54,.667,14,39,.359,20,30,.667,134,37,103,.359,24,60,.400,13,43,.302,19,22,.864,106
93,GSW,2019-10-28,134,@,NOP,W 134-123,240,51,104,.490,37,69,.536,14,35,.400,18,24,.750,134,48,103,.466,33,56,.589,15,47,.319,12,22,.545,123
94,MEM,2019-10-27,134,,BRK,W 134-133 (OT),265,50,103,.485,36,70,.514,14,33,.424,20,25,.800,134,44,101,.436,29,56,.518,15,45,.333,30,37,.811,133
95,BRK,2020-08-13,133,,POR,L 133-134,240,53,96,.552,39,63,.619,14,33,.424,13,19,.684,133,50,104,.481,37,65,.569,13,39,.333,21,24,.875,134
96,ORL,2020-08-13,133,,NOP,W 133-127,240,48,84,.571,33,56,.589,15,28,.536,22,30,.733,133,48,87,.552,38,53,.717,10,34,.294,21,27,.778,127
97,SAC,2020-03-03,133,,WAS,W 133-126,240,50,89,.562,37,60,.617,13,29,.448,20,24,.833,133,41,80,.513,25,42,.595,16,38,.421,28,34,.824,126
98,DEN,2020-03-01,133,,TOR,W 133-118,240,47,83,.566,29,47,.617,18,36,.500,21,30,.700,133,41,89,.461,31,51,.608,10,38,.263,26,29,.897,118
99,MIL,2020-02-28,133,,OKC,W 133-86,240,50,100,.500,29,55,.527,21,45,.467,12,14,.857,133,33,91,.363,27,56,.482,6,35,.171,14,20,.700,86
100,LAC,2020-02-13,133,@,BOS,L 133-141 (2OT),290,46,110,.418,35,75,.467,11,35,.314,30,37,.811,133,45,103,.437,27,60,.450,18,43,.419,33,40,.825,141
101,LAC,2020-02-09,133,@,CLE,W 133-92,240,53,93,.570,41,57,.719,12,36,.333,15,20,.750,133,35,95,.368,28,62,.452,7,33,.212,15,22,.682,92
102,BRK,2020-01-31,133,,CHI,W 133-118,240,50,80,.625,35,49,.714,15,31,.484,18,25,.720,133,42,86,.488,30,52,.577,12,34,.353,22,26,.846,118
103,PHO,2020-01-28,133,@,DAL,W 133-104,240,51,86,.593,39,58,.672,12,28,.429,19,21,.905,133,37,83,.446,30,50,.600,7,33,.212,23,27,.852,104
104,SAC,2020-01-27,133,@,MIN,W 133-129 (OT),265,44,88,.500,26,48,.542,18,40,.450,27,34,.794,133,43,89,.483,20,43,.465,23,46,.500,20,33,.606,129
105,WAS,2020-01-26,133,@,ATL,L 133-152,240,42,88,.477,31,55,.564,11,33,.333,38,42,.905,133,54,93,.581,39,58,.672,15,35,.429,29,34,.853,152
106,DAL,2020-01-23,133,@,POR,W 133-125,240,48,93,.516,26,46,.565,22,47,.468,15,24,.625,133,46,91,.505,25,52,.481,21,39,.538,12,15,.800,125
107,LAC,2020-01-18,133,@,NOP,W 133-130,240,46,93,.495,36,62,.581,10,31,.323,31,39,.795,133,46,86,.535,31,45,.689,15,41,.366,23,36,.639,130
108,TOR,2019-12-16,133,,CLE,W 133-113,240,52,89,.584,36,57,.632,16,32,.500,13,17,.765,133,44,90,.489,32,55,.582,12,35,.343,13,17,.765,113
109,WAS,2019-12-16,133,@,DET,W 133-119,240,49,88,.557,31,54,.574,18,34,.529,17,21,.810,133,41,86,.477,28,47,.596,13,39,.333,24,34,.706,119
110,HOU,2019-12-03,133,@,SAS,L 133-135 (2OT),290,42,111,.378,27,60,.450,15,51,.294,34,36,.944,133,50,106,.472,37,76,.487,13,30,.433,22,32,.688,135
111,WAS,2019-11-13,133,@,BOS,L 133-140,240,50,96,.521,39,67,.582,11,29,.379,22,27,.815,133,49,96,.510,33,60,.550,16,36,.444,26,29,.897,140
112,BRK,2019-10-27,133,@,MEM,L 133-134 (OT),265,44,101,.436,29,56,.518,15,45,.333,30,37,.811,133,50,103,.485,36,70,.514,14,33,.424,20,25,.800,134
113,MIL,2020-08-08,132,@,DAL,L 132-136 (OT),265,47,99,.475,32,55,.582,15,44,.341,23,34,.676,132,48,115,.417,31,62,.500,17,53,.321,23,25,.920,136
114,UTA,2020-08-08,132,@,DEN,L 132-134 (2OT),290,47,105,.448,25,50,.500,22,55,.400,16,22,.727,132,51,108,.472,42,71,.592,9,37,.243,23,30,.767,134
115,DEN,2020-08-05,132,@,SAS,W 132-126,240,50,91,.549,36,55,.655,14,36,.389,18,21,.857,132,46,93,.495,35,63,.556,11,30,.367,23,27,.852,126
116,PHI,2020-08-03,132,,SAS,W 132-130,240,46,87,.529,32,56,.571,14,31,.452,26,30,.867,132,46,93,.495,34,67,.507,12,26,.462,26,29,.897,130
117,ORL,2020-08-02,132,,SAC,W 132-116,240,43,82,.524,25,44,.568,18,38,.474,28,35,.800,132,45,91,.495,37,63,.587,8,28,.286,18,22,.818,116
118,CLE,2020-03-08,132,,SAS,W 132-129 (OT),265,43,94,.457,30,60,.500,13,34,.382,33,45,.733,132,43,98,.439,33,72,.458,10,26,.385,33,36,.917,129
119,ORL,2020-03-06,132,@,MIN,W 132-118,240,51,84,.607,44,63,.698,7,21,.333,23,31,.742,132,46,98,.469,36,61,.590,10,37,.270,16,20,.800,118
120,LAC,2020-02-28,132,,DEN,W 132-103,240,48,89,.539,30,50,.600,18,39,.462,18,20,.900,132,41,91,.451,32,66,.485,9,25,.360,12,16,.750,103
121,UTA,2020-01-16,132,@,NOP,L 132-138 (OT),265,46,100,.460,31,61,.508,15,39,.385,25,32,.781,132,51,93,.548,40,67,.597,11,26,.423,25,35,.714,138
122,NYK,2020-01-05,132,@,LAC,L 132-135,240,48,84,.571,36,61,.590,12,23,.522,24,37,.649,132,45,83,.542,27,51,.529,18,32,.563,27,33,.818,135
123,DET,2019-12-26,132,,WAS,W 132-102,240,46,86,.535,27,38,.711,19,48,.396,21,26,.808,132,38,92,.413,31,68,.456,7,24,.292,19,27,.704,102
124,NOP,2019-12-05,132,,PHO,L 132-139 (OT),265,44,87,.506,27,46,.587,17,41,.415,27,35,.771,132,50,106,.472,36,70,.514,14,36,.389,25,27,.926,139
125,MIL,2019-12-02,132,,NYK,W 132-88,240,48,86,.558,32,51,.627,16,35,.457,20,32,.625,132,28,91,.308,18,52,.346,10,39,.256,22,33,.667,88
126,DET,2019-12-01,132,,SAS,W 132-98,240,52,88,.591,37,57,.649,15,31,.484,13,18,.722,132,36,88,.409,29,62,.468,7,26,.269,19,22,.864,98
127,PHO,2019-11-27,132,,WAS,L 132-140,240,48,93,.516,33,55,.600,15,38,.395,21,24,.875,132,51,89,.573,32,54,.593,19,35,.543,19,20,.950,140
128,SAS,2019-11-20,132,@,WAS,L 132-138,240,49,93,.527,37,61,.607,12,32,.375,22,29,.759,132,54,92,.587,36,62,.581,18,30,.600,12,15,.800,138
129,HOU,2019-11-18,132,,POR,W 132-108,240,47,100,.470,30,55,.545,17,45,.378,21,26,.808,132,40,96,.417,29,60,.483,11,36,.306,17,23,.739,108
130,TOR,2019-11-18,132,,CHO,W 132-96,240,50,97,.515,30,54,.556,20,43,.465,12,15,.800,132,33,78,.423,18,33,.545,15,45,.333,15,24,.625,96
131,NOP,2019-11-14,132,,LAC,W 132-127,240,47,98,.480,29,64,.453,18,34,.529,20,29,.690,132,46,84,.548,35,60,.583,11,24,.458,24,31,.774,127
132,DAL,2020-08-11,131,,POR,L 131-134,240,42,81,.519,22,37,.595,20,44,.455,27,33,.818,131,46,98,.469,31,60,.517,15,38,.395,27,29,.931,134
133,ATL,2020-03-11,131,,NYK,L 131-136 (OT),265,48,106,.453,34,65,.523,14,41,.341,21,26,.808,131,50,94,.532,39,66,.591,11,28,.393,25,34,.735,136
134,LAC,2020-03-10,131,@,GSW,W 131-107,240,46,92,.500,26,48,.542,20,44,.455,19,19,1.000,131,37,79,.468,26,41,.634,11,38,.289,22,27,.815,107
135,MIL,2020-03-08,131,@,PHO,L 131-140,240,51,95,.537,38,62,.613,13,33,.394,16,21,.762,131,47,85,.553,28,42,.667,19,43,.442,27,31,.871,140
136,PHO,2020-02-24,131,@,UTA,W 131-111,240,49,87,.563,37,67,.552,12,20,.600,21,24,.875,131,32,68,.471,22,42,.524,10,26,.385,37,43,.860,111
137,OKC,2020-02-23,131,,SAS,W 131-103,240,50,87,.575,40,65,.615,10,22,.455,21,24,.875,131,38,103,.369,27,65,.415,11,38,.289,16,19,.842,103
138,GSW,2020-02-01,131,@,CLE,W 131-112,240,48,90,.533,30,55,.545,18,35,.514,17,19,.895,131,41,95,.432,25,51,.490,16,44,.364,14,14,1.000,112
139,WAS,2020-01-28,131,@,MIL,L 131-151,240,44,94,.468,30,62,.484,14,32,.438,29,34,.853,131,50,90,.556,31,53,.585,19,37,.514,32,35,.914,151
140,HOU,2020-01-24,131,@,MIN,W 131-124,240,47,91,.516,36,59,.610,11,32,.344,26,31,.839,131,48,98,.490,37,66,.561,11,32,.344,17,20,.850,124
141,GSW,2020-01-16,131,,DEN,L 131-134 (OT),265,42,95,.442,22,50,.440,20,45,.444,27,31,.871,131,47,100,.470,30,65,.462,17,35,.486,23,26,.885,134
142,DEN,2019-11-17,131,@,MEM,W 131-114,240,49,89,.551,31,57,.544,18,32,.563,15,23,.652,131,39,84,.464,23,48,.479,16,36,.444,20,24,.833,114
143,DAL,2019-11-03,131,@,CLE,W 131-111,240,50,94,.532,30,53,.566,20,41,.488,11,13,.846,131,39,96,.406,21,48,.438,18,48,.375,15,22,.682,111
144,MIN,2019-11-02,131,@,WAS,W 131-109,240,51,94,.543,34,55,.618,17,39,.436,12,17,.706,131,37,95,.389,25,60,.417,12,35,.343,23,27,.852,109
145,MIA,2019-10-26,131,@,MIL,W 131-126 (OT),265,46,101,.455,30,57,.526,16,44,.364,23,36,.639,131,41,94,.436,24,40,.600,17,54,.315,27,35,.771,126
146,PHO,2020-08-11,130,@,PHI,W 130-117,240,49,89,.551,37,61,.607,12,28,.429,20,21,.952,130,46,93,.495,31,60,.517,15,33,.455,10,14,.714,117
147,MIL,2020-08-06,130,,MIA,W 130-116,240,41,78,.526,26,41,.634,15,37,.405,33,38,.868,130,35,83,.422,14,37,.378,21,46,.457,25,27,.926,116
148,SAS,2020-08-03,130,@,PHI,L 130-132,240,46,93,.495,34,67,.507,12,26,.462,26,29,.897,130,46,87,.529,32,56,.571,14,31,.452,26,30,.867,132
149,POR,2020-03-02,130,@,ORL,W 130-107,240,49,88,.557,33,55,.600,16,33,.485,16,16,1.000,130,37,96,.385,23,53,.434,14,43,.326,19,22,.864,107
150,PHI,2020-03-01,130,@,LAC,L 130-136,240,48,95,.505,27,52,.519,21,43,.488,13,20,.650,130,45,76,.592,32,52,.615,13,24,.542,33,41,.805,136
151,ORL,2020-02-26,130,@,ATL,W 130-120,240,49,100,.490,35,68,.515,14,32,.438,18,25,.720,130,42,94,.447,29,58,.500,13,36,.361,23,25,.920,120
152,DAL,2020-02-12,130,,SAC,W 130-111,240,48,85,.565,31,45,.689,17,40,.425,17,21,.810,130,41,99,.414,29,60,.483,12,39,.308,17,22,.773,111
153,TOR,2020-01-28,130,,ATL,W 130-114,240,48,97,.495,35,54,.648,13,43,.302,21,27,.778,130,41,92,.446,29,45,.644,12,47,.255,20,25,.800,114
154,NOP,2020-01-18,130,,LAC,L 130-133,240,46,86,.535,31,45,.689,15,41,.366,23,36,.639,130,46,93,.495,36,62,.581,10,31,.323,31,39,.795,133
155,TOR,2020-01-15,130,@,OKC,W 130-121,240,52,85,.612,37,58,.638,15,27,.556,11,15,.733,130,43,85,.506,27,43,.628,16,42,.381,19,20,.950,121
156,HOU,2019-12-31,130,,DEN,W 130-104,240,46,87,.529,30,53,.566,16,34,.471,22,31,.710,130,45,97,.464,37,72,.514,8,25,.320,6,9,.667,104
157,ORL,2019-12-15,130,@,NOP,W 130-119,240,46,89,.517,29,55,.527,17,34,.500,21,26,.808,130,47,88,.534,28,45,.622,19,43,.442,6,12,.500,119
158,HOU,2019-12-13,130,@,ORL,W 130-107,240,48,86,.558,26,47,.553,22,39,.564,12,13,.923,130,40,91,.440,25,54,.463,15,37,.405,12,16,.750,107
159,DAL,2019-12-07,130,,NOP,W 130-84,240,46,86,.535,33,48,.688,13,38,.342,25,31,.806,130,32,89,.360,29,57,.509,3,32,.094,17,21,.810,84
160,BRK,2019-12-04,130,@,ATL,W 130-118,240,50,101,.495,36,70,.514,14,31,.452,16,18,.889,130,48,90,.533,39,64,.609,9,26,.346,13,21,.619,118
161,TOR,2019-12-01,130,,UTA,W 130-110,240,47,90,.522,28,54,.519,19,36,.528,17,21,.810,130,38,90,.422,25,55,.455,13,35,.371,21,29,.724,110
162,LAL,2019-11-22,130,@,OKC,W 130-127,240,45,88,.511,28,57,.491,17,31,.548,23,29,.793,130,49,93,.527,38,62,.613,11,31,.355,18,20,.900,127
163,PHO,2019-10-26,130,,LAC,W 130-122,240,43,86,.500,26,43,.605,17,43,.395,27,34,.794,130,40,87,.460,29,55,.527,11,32,.344,31,39,.795,122
164,TOR,2019-10-22,130,,NOP,W 130-122 (OT),265,42,103,.408,28,63,.444,14,40,.350,32,38,.842,130,43,102,.422,24,57,.421,19,45,.422,17,20,.850,122
165,BRK,2020-08-09,129,@,LAC,W 129-120,240,47,85,.553,27,42,.643,20,43,.465,15,19,.789,129,45,93,.484,32,57,.561,13,36,.361,17,20,.850,120
166,HOU,2020-08-09,129,@,SAC,W 129-112,240,43,91,.473,25,34,.735,18,57,.316,25,30,.833,129,41,87,.471,31,50,.620,10,37,.270,20,23,.870,112
167,SAS,2020-07-31,129,,SAC,W 129-120,240,48,90,.533,37,65,.569,11,25,.440,22,27,.815,129,46,95,.484,34,57,.596,12,38,.316,16,20,.800,120
168,SAS,2020-03-08,129,@,CLE,L 129-132 (OT),265,43,98,.439,33,72,.458,10,26,.385,33,36,.917,129,43,94,.457,30,60,.500,13,34,.382,33,45,.733,132
169,BRK,2020-03-03,129,@,BOS,W 129-120 (OT),265,43,100,.430,29,51,.569,14,49,.286,29,38,.763,129,44,103,.427,29,54,.537,15,49,.306,17,23,.739,120
170,ATL,2020-02-29,129,,POR,W 129-117,240,46,84,.548,28,42,.667,18,42,.429,19,22,.864,129,47,94,.500,39,66,.591,8,28,.286,15,21,.714,117
171,UTA,2020-02-28,129,,WAS,W 129-119,240,44,89,.494,25,52,.481,19,37,.514,22,30,.733,129,45,98,.459,31,61,.508,14,37,.378,15,21,.714,119
172,MIN,2020-02-26,129,@,MIA,W 129-126,240,47,91,.516,30,45,.667,17,46,.370,18,25,.720,129,41,78,.526,30,52,.577,11,26,.423,33,43,.767,126
173,PHI,2020-02-24,129,,ATL,W 129-112,240,45,88,.511,33,58,.569,12,30,.400,27,30,.900,129,40,97,.412,32,59,.542,8,38,.211,24,27,.889,112
174,SAC,2020-02-20,129,,MEM,W 129-125,240,42,83,.506,23,44,.523,19,39,.487,26,36,.722,129,43,85,.506,31,55,.564,12,30,.400,27,32,.844,125
175,ATL,2020-02-20,129,,MIA,W 129-124,240,41,85,.482,25,50,.500,16,35,.457,31,35,.886,129,40,98,.408,29,61,.475,11,37,.297,33,38,.868,124
176,BRK,2020-02-05,129,,GSW,W 129-88,240,51,100,.510,37,66,.561,14,34,.412,13,15,.867,129,35,96,.365,30,57,.526,5,39,.128,13,18,.722,88
177,LAL,2020-02-04,129,,SAS,W 129-102,240,50,85,.588,38,57,.667,12,28,.429,17,25,.680,129,40,91,.440,27,64,.422,13,27,.481,9,15,.600,102
178,MIL,2020-02-02,129,,PHO,W 129-108,240,48,97,.495,33,59,.559,15,38,.395,18,27,.667,129,41,104,.394,35,81,.432,6,23,.261,20,23,.870,108
179,TOR,2020-02-02,129,,CHI,W 129-102,240,47,84,.560,31,50,.620,16,34,.471,19,23,.826,129,35,90,.389,20,42,.476,15,48,.313,17,26,.654,102
180,LAL,2020-02-01,129,@,SAC,W 129-113,240,44,86,.512,25,43,.581,19,43,.442,22,27,.815,129,39,91,.429,25,47,.532,14,44,.318,21,26,.808,113
181,MIN,2020-01-27,129,,SAC,L 129-133 (OT),265,43,89,.483,20,43,.465,23,46,.500,20,33,.606,129,44,88,.500,26,48,.542,18,40,.450,27,34,.794,133
182,IND,2020-01-26,129,@,POR,L 129-139,240,48,93,.516,35,65,.538,13,28,.464,20,21,.952,129,49,90,.544,29,55,.527,20,35,.571,21,25,.840,139
183,IND,2020-01-24,129,@,GSW,W 129-118,240,50,87,.575,33,59,.559,17,28,.607,12,13,.923,129,40,82,.488,21,43,.488,19,39,.487,19,23,.826,118
184,UTA,2020-01-22,129,@,GSW,W 129-96,240,50,93,.538,33,53,.623,17,40,.425,12,23,.522,129,35,88,.398,29,65,.446,6,23,.261,20,24,.833,96
185,WAS,2020-01-22,129,@,MIA,L 129-134 (OT),265,50,99,.505,37,57,.649,13,42,.310,16,20,.800,129,43,85,.506,26,52,.500,17,33,.515,31,36,.861,134
186,POR,2020-01-20,129,,GSW,W 129-124 (OT),265,44,100,.440,30,56,.536,14,44,.318,27,30,.900,129,48,116,.414,39,80,.488,9,36,.250,19,22,.864,124
187,LAL,2020-01-10,129,@,DAL,W 129-114,240,47,89,.528,37,65,.569,10,24,.417,25,32,.781,129,39,96,.406,28,58,.483,11,38,.289,25,37,.676,114
188,SAS,2020-01-08,129,@,BOS,W 129-114,240,48,87,.552,39,58,.672,9,29,.310,24,26,.923,129,37,89,.416,24,51,.471,13,38,.342,27,30,.900,114
189,BOS,2019-12-27,129,,CLE,W 129-117,240,49,95,.516,35,55,.636,14,40,.350,17,19,.895,129,44,85,.518,35,62,.565,9,23,.391,20,29,.690,117
190,MIA,2019-12-20,129,,NYK,W 129-114,240,43,77,.558,25,39,.641,18,38,.474,25,34,.735,129,41,94,.436,31,60,.517,10,34,.294,22,33,.667,114
191,DEN,2019-12-05,129,@,NYK,W 129-92,240,49,87,.563,28,48,.583,21,39,.538,10,18,.556,129,34,83,.410,25,49,.510,9,34,.265,15,23,.652,92
192,POR,2019-11-21,129,@,MIL,L 129-137,240,50,103,.485,33,64,.516,17,39,.436,12,14,.857,129,50,106,.472,34,63,.540,16,43,.372,21,26,.808,137
193,MIN,2019-11-13,129,,SAS,W 129-114,240,45,91,.495,34,57,.596,11,34,.324,28,34,.824,129,44,90,.489,41,73,.562,3,17,.176,23,29,.793,114
194,MIL,2019-11-06,129,@,LAC,W 129-124,240,42,98,.429,24,49,.490,18,49,.367,27,34,.794,129,41,98,.418,28,67,.418,13,31,.419,29,36,.806,124
195,HOU,2019-11-06,129,,GSW,W 129-112,240,48,97,.495,27,52,.519,21,45,.467,12,19,.632,129,38,96,.396,25,63,.397,13,33,.394,23,28,.821,112
196,MIA,2019-11-03,129,,HOU,W 129-100,240,47,89,.528,29,48,.604,18,41,.439,17,22,.773,129,31,79,.392,17,31,.548,14,48,.292,24,31,.774,100
197,PHI,2019-11-02,129,@,POR,W 129-128,240,54,107,.505,43,74,.581,11,33,.333,10,12,.833,129,45,78,.577,26,44,.591,19,34,.559,19,25,.760,128
198,MIL,2019-10-28,129,,CLE,W 129-112,240,48,92,.522,31,54,.574,17,38,.447,16,24,.667,129,45,100,.450,33,61,.541,12,39,.308,10,12,.833,112
199,PHO,2020-08-13,128,,DAL,W 128-102,240,49,89,.551,35,55,.636,14,34,.412,16,21,.762,128,39,89,.438,31,63,.492,8,26,.308,16,19,.842,102
200,PHO,2020-08-10,128,,OKC,W 128-101,240,42,89,.472,25,55,.455,17,34,.500,27,29,.931,128,35,90,.389,22,51,.431,13,39,.333,18,21,.857,101
201,BOS,2020-08-02,128,,POR,W 128-124,240,42,77,.545,24,47,.511,18,30,.600,26,34,.765,128,45,90,.500,26,48,.542,19,42,.452,15,16,.938,124
202,ORL,2020-07-31,128,@,BRK,W 128-118,240,46,87,.529,35,56,.625,11,31,.355,25,28,.893,128,44,91,.484,31,49,.633,13,42,.310,17,23,.739,118
203,DEN,2020-02-23,128,,MIN,W 128-116,240,53,90,.589,42,60,.700,11,30,.367,11,17,.647,128,40,90,.444,26,50,.520,14,40,.350,22,29,.759,116
204,NOP,2020-02-21,128,@,POR,W 128-115,240,45,84,.536,27,50,.540,18,34,.529,20,33,.606,128,43,94,.457,33,67,.493,10,27,.370,19,25,.760,115
205,LAC,2020-02-05,128,,MIA,W 128-111,240,45,89,.506,21,35,.600,24,54,.444,14,19,.737,128,40,93,.430,24,51,.471,16,42,.381,15,21,.714,111
206,DET,2020-02-02,128,,DEN,W 128-123 (OT),265,48,94,.511,34,63,.540,14,31,.452,18,24,.750,128,48,96,.500,38,64,.594,10,32,.313,17,22,.773,123
207,HOU,2020-01-31,128,,DAL,W 128-121,240,45,98,.459,24,53,.453,21,45,.467,17,20,.850,128,43,90,.478,29,54,.537,14,36,.389,21,27,.778,121
208,LAL,2020-01-23,128,@,BRK,W 128-113,240,47,94,.500,28,56,.500,19,38,.500,15,20,.750,128,40,91,.440,19,45,.422,21,46,.457,12,15,.800,113
209,MIL,2020-01-16,128,,BOS,W 128-123,240,43,87,.494,27,56,.482,16,31,.516,26,37,.703,128,43,98,.439,28,49,.571,15,49,.306,22,27,.815,123
210,MIL,2020-01-14,128,,NYK,W 128-102,240,45,92,.489,30,56,.536,15,36,.417,23,28,.821,128,36,102,.353,25,65,.385,11,37,.297,19,26,.731,102
211,LAC,2020-01-14,128,,CLE,W 128-103,240,49,94,.521,34,56,.607,15,38,.395,15,21,.714,128,38,91,.418,24,54,.444,14,37,.378,13,15,.867,103
212,LAL,2020-01-13,128,,CLE,W 128-99,240,48,88,.545,37,58,.638,11,30,.367,21,28,.750,128,38,85,.447,31,60,.517,7,25,.280,16,24,.667,99
213,UTA,2020-01-08,128,,NYK,W 128-104,240,49,90,.544,33,47,.702,16,43,.372,14,23,.609,128,42,97,.433,33,72,.458,9,25,.360,11,11,1.000,104
214,UTA,2020-01-06,128,@,NOP,W 128-126,240,46,90,.511,30,57,.526,16,33,.485,20,24,.833,128,45,94,.479,33,63,.524,12,31,.387,24,30,.800,126
215,WAS,2020-01-04,128,,DEN,W 128-114,240,50,91,.549,44,75,.587,6,16,.375,22,27,.815,128,40,87,.460,34,58,.586,6,29,.207,28,34,.824,114
216,SAC,2020-01-02,128,,MEM,W 128-123,240,44,90,.489,30,56,.536,14,34,.412,26,31,.839,128,45,93,.484,32,59,.542,13,34,.382,20,21,.952,123
217,LAL,2019-12-28,128,@,POR,W 128-120,240,47,91,.516,36,59,.610,11,32,.344,23,28,.821,128,41,86,.477,26,51,.510,15,35,.429,23,27,.852,120
218,DEN,2019-12-22,128,@,LAL,W 128-104,240,45,92,.489,34,60,.567,11,32,.344,27,30,.900,128,39,83,.470,29,54,.537,10,29,.345,16,22,.727,104
219,MEM,2019-12-14,128,,WAS,W 128-111,240,48,84,.571,37,57,.649,11,27,.407,21,24,.875,128,36,85,.424,22,47,.468,14,38,.368,25,32,.781,111
220,ORL,2019-12-04,128,,PHO,W 128-114,240,49,85,.576,35,60,.583,14,25,.560,16,20,.800,128,43,88,.489,28,55,.509,15,33,.455,13,20,.650,114
221,UTA,2019-11-23,128,,NOP,W 128-120,240,42,82,.512,27,46,.587,15,36,.417,29,33,.879,128,42,101,.416,25,60,.417,17,41,.415,19,20,.950,120
222,DET,2019-11-22,128,,ATL,W 128-103,240,49,82,.598,32,48,.667,17,34,.500,13,20,.650,128,38,88,.432,28,51,.549,10,37,.270,17,17,1.000,103
223,PHO,2019-11-14,128,,ATL,W 128-112,240,41,85,.482,26,46,.565,15,39,.385,31,38,.816,128,40,91,.440,32,60,.533,8,31,.258,24,30,.800,112
224,POR,2019-11-02,128,,PHI,L 128-129,240,45,78,.577,26,44,.591,19,34,.559,19,25,.760,128,54,107,.505,43,74,.581,11,33,.333,10,12,.833,129
225,NOP,2020-08-13,127,@,ORL,L 127-133,240,48,87,.552,38,53,.717,10,34,.294,21,27,.778,127,48,84,.571,33,56,.589,15,28,.536,22,30,.733,133
226,IND,2020-08-01,127,,PHI,W 127-121,240,48,95,.505,34,61,.557,14,34,.412,17,23,.739,127,46,93,.495,37,68,.544,9,25,.360,20,25,.800,121
227,PHO,2020-03-06,127,,POR,W 127-117,240,45,91,.495,26,49,.531,19,42,.452,18,19,.947,127,43,87,.494,30,55,.545,13,32,.406,18,24,.750,117
228,DAL,2020-03-04,127,,NOP,W 127-123 (OT),265,44,95,.463,22,45,.489,22,50,.440,17,24,.708,127,50,114,.439,33,68,.485,17,46,.370,6,11,.545,123
229,MEM,2020-03-02,127,@,ATL,W 127-88,240,46,92,.500,32,60,.533,14,32,.438,21,31,.677,127,32,99,.323,23,64,.359,9,35,.257,15,16,.938,88
230,TOR,2020-02-23,127,,IND,W 127-81,240,47,92,.511,30,48,.625,17,44,.386,16,18,.889,127,31,95,.326,23,62,.371,8,33,.242,11,17,.647,81
231,BOS,2020-02-21,127,@,MIN,W 127-117,240,44,95,.463,34,66,.515,10,29,.345,29,37,.784,127,36,89,.404,21,47,.447,15,42,.357,30,35,.857,117
232,CLE,2020-02-12,127,,ATL,W 127-105,240,48,94,.511,38,66,.576,10,28,.357,21,25,.840,127,36,84,.429,23,50,.460,13,34,.382,20,25,.800,105
233,DEN,2020-02-10,127,,SAS,W 127-120,240,45,80,.563,27,45,.600,18,35,.514,19,23,.826,127,41,85,.482,25,53,.472,16,32,.500,22,25,.880,120
234,PHO,2020-02-07,127,,HOU,W 127-91,240,43,77,.558,28,46,.609,15,31,.484,26,27,.963,127,29,85,.341,18,37,.486,11,48,.229,22,26,.846,91
235,ATL,2020-02-05,127,@,MIN,W 127-120,240,43,82,.524,30,50,.600,13,32,.406,28,30,.933,127,45,91,.495,36,56,.643,9,35,.257,21,28,.750,120
236,DEN,2020-02-04,127,,POR,W 127-99,240,46,90,.511,29,56,.518,17,34,.500,18,25,.720,127,36,91,.396,27,60,.450,9,31,.290,18,22,.818,99
237,DEN,2020-01-31,127,@,MIL,W 127-115,240,48,100,.480,26,54,.481,22,46,.478,9,9,1.000,127,43,95,.453,31,55,.564,12,40,.300,17,26,.654,115
238,POR,2020-01-31,127,@,LAL,W 127-119,240,49,97,.505,36,61,.590,13,36,.361,16,21,.762,127,45,96,.469,34,64,.531,11,32,.344,18,28,.643,119
239,ATL,2020-01-30,127,,PHI,W 127-117,240,42,87,.483,31,52,.596,11,35,.314,32,37,.865,127,38,82,.463,29,51,.569,9,31,.290,32,45,.711,117
240,MEM,2020-01-29,127,@,NYK,W 127-106,240,43,86,.500,30,58,.517,13,28,.464,28,33,.848,127,39,91,.429,30,63,.476,9,28,.321,19,29,.655,106
241,SAS,2020-01-29,127,,UTA,W 127-120,240,46,82,.561,38,51,.745,8,31,.258,27,30,.900,127,37,84,.440,23,46,.500,14,38,.368,32,46,.696,120
242,DET,2020-01-22,127,,SAC,W 127-106,240,39,73,.534,27,44,.614,12,29,.414,37,44,.841,127,42,98,.429,32,63,.508,10,35,.286,12,23,.522,106
243,DAL,2020-01-15,127,@,SAC,W 127-123,240,47,92,.511,34,52,.654,13,40,.325,20,24,.833,127,50,96,.521,38,63,.603,12,33,.364,11,20,.550,123
244,UTA,2020-01-12,127,@,WAS,W 127-116,240,48,90,.533,38,60,.633,10,30,.333,21,25,.840,127,47,93,.505,40,71,.563,7,22,.318,15,17,.882,116
245,MIL,2020-01-10,127,@,SAC,W 127-106,240,47,95,.495,37,56,.661,10,39,.256,23,30,.767,127,44,96,.458,34,61,.557,10,35,.286,8,10,.800,106
246,MIL,2020-01-04,127,,SAS,W 127-118,240,43,87,.494,26,42,.619,17,45,.378,24,33,.727,127,38,92,.413,27,60,.450,11,32,.344,31,34,.912,118
247,NOP,2019-12-29,127,,HOU,W 127-112,240,50,102,.490,32,58,.552,18,44,.409,9,13,.692,127,42,81,.519,27,42,.643,15,39,.385,13,20,.650,112
248,MIL,2019-12-13,127,@,MEM,W 127-114,240,44,87,.506,33,57,.579,11,30,.367,28,33,.848,127,38,98,.388,18,49,.367,20,49,.408,18,23,.783,114
249,MIL,2019-12-11,127,,NOP,W 127-112,240,50,93,.538,31,54,.574,19,39,.487,8,9,.889,127,39,88,.443,23,43,.535,16,45,.356,18,22,.818,112
250,UTA,2019-12-11,127,@,MIN,W 127-116,240,47,83,.566,31,48,.646,16,35,.457,17,22,.773,127,40,91,.440,25,50,.500,15,41,.366,21,26,.808,116
251,MIN,2019-12-06,127,@,OKC,L 127-139 (OT),265,50,96,.521,37,58,.638,13,38,.342,14,20,.700,127,49,88,.557,44,70,.629,5,18,.278,36,40,.900,139
252,POR,2019-12-04,127,,SAC,W 127-116,240,47,84,.560,31,52,.596,16,32,.500,17,21,.810,127,44,95,.463,33,61,.541,11,34,.324,17,23,.739,116
253,MIL,2019-12-04,127,@,DET,W 127-103,240,44,90,.489,30,55,.545,14,35,.400,25,27,.926,127,39,93,.419,28,57,.491,11,36,.306,14,22,.636,103
254,DET,2019-12-03,127,@,CLE,W 127-94,240,51,94,.543,33,59,.559,18,35,.514,7,11,.636,127,38,90,.422,30,63,.476,8,27,.296,10,14,.714,94
255,ORL,2019-12-03,127,@,WAS,W 127-120,240,46,90,.511,31,59,.525,15,31,.484,20,27,.741,127,45,89,.506,33,54,.611,12,35,.343,18,23,.783,120
256,OKC,2019-11-22,127,,LAL,L 127-130,240,49,93,.527,38,62,.613,11,31,.355,18,20,.900,127,45,88,.511,28,57,.491,17,31,.548,23,29,.793,130
257,ATL,2019-11-20,127,,MIL,L 127-135,240,44,96,.458,30,65,.462,14,31,.452,25,31,.806,127,46,87,.529,29,44,.659,17,43,.395,26,34,.765,135
258,OKC,2019-11-15,127,,PHI,W 127-119 (OT),265,41,76,.539,31,52,.596,10,24,.417,35,41,.854,127,45,90,.500,31,58,.534,14,32,.438,15,22,.682,119
259,LAC,2019-11-14,127,@,NOP,L 127-132,240,46,84,.548,35,60,.583,11,24,.458,24,31,.774,127,47,98,.480,29,64,.453,18,34,.529,20,29,.690,132
260,GSW,2019-11-04,127,,POR,W 127-118,240,42,86,.488,32,60,.533,10,26,.385,33,36,.917,127,47,105,.448,34,65,.523,13,40,.325,11,14,.786,118
261,SAS,2019-11-01,127,@,GSW,W 127-110,240,44,93,.473,31,58,.534,13,35,.371,26,30,.867,127,39,84,.464,26,56,.464,13,28,.464,19,21,.905,110
262,MIN,2019-10-23,127,@,BRK,W 127-126 (OT),265,46,108,.426,33,65,.508,13,43,.302,22,28,.786,127,48,101,.475,33,67,.493,15,34,.441,15,26,.577,126
263,MIL,2020-08-11,126,@,WAS,W 126-113,240,44,87,.506,26,49,.531,18,38,.474,20,28,.714,126,39,95,.411,27,60,.450,12,35,.343,23,30,.767,113
264,LAC,2020-08-06,126,@,DAL,W 126-111,240,50,92,.543,36,61,.590,14,31,.452,12,15,.800,126,39,87,.448,22,39,.564,17,48,.354,16,21,.762,111
265,SAS,2020-08-05,126,,DEN,L 126-132,240,46,93,.495,35,63,.556,11,30,.367,23,27,.852,126,50,91,.549,36,55,.655,14,36,.389,18,21,.857,132
266,LAC,2020-08-01,126,,NOP,W 126-103,240,37,87,.425,12,40,.300,25,47,.532,27,35,.771,126,38,85,.447,29,55,.527,9,30,.300,18,28,.643,103
267,ORL,2020-03-08,126,@,HOU,W 126-106,240,44,91,.484,31,62,.500,13,29,.448,25,31,.806,126,39,88,.443,30,56,.536,9,32,.281,19,25,.760,106
268,OKC,2020-03-06,126,@,NYK,W 126-103,240,47,96,.490,35,65,.538,12,31,.387,20,25,.800,126,41,91,.451,37,67,.552,4,24,.167,17,22,.773,103
269,WAS,2020-03-03,126,@,SAC,L 126-133,240,41,80,.513,25,42,.595,16,38,.421,28,34,.824,126,50,89,.562,37,60,.617,13,29,.448,20,24,.833,133
270,UTA,2020-03-02,126,@,CLE,W 126-113,240,47,83,.566,27,42,.643,20,41,.488,12,14,.857,126,42,91,.462,25,50,.500,17,41,.415,12,18,.667,113
271,MIA,2020-02-28,126,,DAL,W 126-118,240,41,79,.519,24,44,.545,17,35,.486,27,36,.750,126,40,84,.476,19,34,.559,21,50,.420,17,19,.895,118
272,MIA,2020-02-26,126,,MIN,L 126-129,240,41,78,.526,30,52,.577,11,26,.423,33,43,.767,126,47,91,.516,30,45,.667,17,46,.370,18,25,.720,129
273,CHI,2020-02-23,126,,WAS,W 126-117,240,45,81,.556,27,44,.614,18,37,.486,18,28,.643,126,37,73,.507,25,43,.581,12,30,.400,31,36,.861,117
274,MIL,2020-02-20,126,@,DET,W 126-106,240,47,93,.505,37,60,.617,10,33,.303,22,27,.815,126,40,83,.482,27,46,.587,13,37,.351,13,16,.813,106
275,WAS,2020-02-11,126,,CHI,W 126-114,240,48,89,.539,37,57,.649,11,32,.344,19,24,.792,126,44,92,.478,28,53,.528,16,39,.410,10,14,.714,114
276,ATL,2020-02-10,126,@,ORL,L 126-135,240,47,88,.534,31,51,.608,16,37,.432,16,17,.941,126,50,95,.526,32,57,.561,18,38,.474,17,22,.773,135
277,MIN,2020-02-10,126,@,TOR,L 126-137,240,39,86,.453,21,46,.457,18,40,.450,30,35,.857,126,51,89,.573,34,56,.607,17,33,.515,18,23,.783,137
278,HOU,2020-01-27,126,@,UTA,W 126-117,240,38,81,.469,23,41,.561,15,40,.375,35,49,.714,126,43,85,.506,31,43,.721,12,42,.286,19,26,.731,117
279,NOP,2020-01-20,126,@,MEM,W 126-116,240,42,88,.477,21,40,.525,21,48,.438,21,24,.875,126,46,103,.447,37,70,.529,9,33,.273,15,21,.714,116
280,SAS,2020-01-06,126,,MIL,W 126-104,240,45,88,.511,26,53,.491,19,35,.543,17,19,.895,126,38,95,.400,23,50,.460,15,45,.333,13,14,.929,104
281,NOP,2020-01-06,126,,UTA,L 126-128,240,45,94,.479,33,63,.524,12,31,.387,24,30,.800,126,46,90,.511,30,57,.526,16,33,.485,20,24,.833,128
282,LAC,2020-01-02,126,,DET,W 126-112,240,50,92,.543,39,64,.609,11,28,.393,15,21,.714,126,40,94,.426,33,61,.541,7,33,.212,25,35,.714,112
283,OKC,2019-12-20,126,,PHO,W 126-108,240,49,87,.563,39,63,.619,10,24,.417,18,21,.857,126,38,87,.437,27,55,.491,11,32,.344,21,23,.913,108
284,OKC,2019-12-18,126,,MEM,W 126-122,240,46,84,.548,39,60,.650,7,24,.292,27,34,.794,126,50,99,.505,40,73,.548,10,26,.385,12,15,.800,122
285,UTA,2019-12-07,126,,MEM,W 126-112,240,45,80,.563,26,46,.565,19,34,.559,17,18,.944,126,43,81,.531,33,46,.717,10,35,.286,16,25,.640,112
286,TOR,2019-11-27,126,,NYK,W 126-98,240,46,94,.489,25,53,.472,21,41,.512,13,17,.765,126,33,88,.375,21,47,.447,12,41,.293,20,24,.833,98
287,IND,2019-11-25,126,,MEM,W 126-114,240,51,94,.543,33,61,.541,18,33,.545,6,10,.600,126,46,96,.479,33,67,.493,13,29,.448,9,13,.692,114
288,MIL,2019-10-26,126,,MIA,L 126-131 (OT),265,41,94,.436,24,40,.600,17,54,.315,27,35,.771,126,46,101,.455,30,57,.526,16,44,.364,23,36,.639,131
289,HOU,2019-10-26,126,,NOP,W 126-123,240,43,94,.457,30,49,.612,13,45,.289,27,30,.900,126,46,100,.460,28,50,.560,18,50,.360,13,16,.813,123
290,CHO,2019-10-23,126,,CHI,W 126-125,240,45,88,.511,22,44,.500,23,44,.523,13,16,.813,126,49,105,.467,40,75,.533,9,30,.300,18,22,.818,125
291,BRK,2019-10-23,126,,MIN,L 126-127 (OT),265,48,101,.475,33,67,.493,15,34,.441,15,26,.577,126,46,108,.426,33,65,.508,13,43,.302,22,28,.786,127
292,TOR,2020-08-12,125,@,PHI,W 125-121,240,40,90,.444,22,47,.468,18,43,.419,27,40,.675,125,39,84,.464,22,44,.500,17,40,.425,26,33,.788,121
293,NOP,2020-08-06,125,@,SAC,L 125-140,240,47,82,.573,33,48,.688,14,34,.412,17,23,.739,125,50,93,.538,34,60,.567,16,33,.485,24,33,.727,140
294,POR,2020-08-06,125,@,DEN,W 125-115,240,43,92,.467,20,53,.377,23,39,.590,16,20,.800,125,44,84,.524,30,56,.536,14,28,.500,13,17,.765,115
295,MIA,2020-08-01,125,@,DEN,W 125-105,240,40,72,.556,27,43,.628,13,29,.448,32,37,.865,125,39,89,.438,31,54,.574,8,35,.229,19,24,.792,105
296,PHO,2020-07-31,125,@,WAS,W 125-112,240,42,80,.525,31,48,.646,11,32,.344,30,32,.938,125,42,91,.462,34,69,.493,8,22,.364,20,23,.870,112
297,PHI,2020-03-05,125,@,SAC,W 125-108,240,47,96,.490,30,59,.508,17,37,.459,14,17,.824,125,42,79,.532,31,50,.620,11,29,.379,13,18,.722,108
298,POR,2020-03-04,125,,WAS,W 125-104,240,42,81,.519,29,50,.580,13,31,.419,28,32,.875,125,40,103,.388,29,68,.426,11,35,.314,13,21,.619,104
299,NYK,2020-03-02,125,,HOU,W 125-123,240,47,97,.485,35,67,.522,12,30,.400,19,30,.633,125,39,94,.415,19,38,.500,20,56,.357,25,27,.926,123
300,NYK,2020-02-29,125,,CHI,W 125-115,240,47,85,.553,39,65,.600,8,20,.400,23,33,.697,125,41,89,.461,24,54,.444,17,35,.486,16,23,.696,115
301,MIN,2020-02-28,125,@,ORL,L 125-136,240,46,95,.484,29,51,.569,17,44,.386,16,24,.667,125,53,98,.541,41,58,.707,12,40,.300,18,22,.818,136
302,CLE,2020-02-24,125,,MIA,W 125-119 (OT),265,43,97,.443,29,60,.483,14,37,.378,25,34,.735,125,44,96,.458,28,54,.519,16,42,.381,15,20,.750,119
303,MEM,2020-02-20,125,@,SAC,L 125-129,240,43,85,.506,31,55,.564,12,30,.400,27,32,.844,125,42,83,.506,23,44,.523,19,39,.487,26,36,.722,129
304,LAL,2020-02-10,125,,PHO,W 125-100,240,47,91,.516,33,54,.611,14,37,.378,17,25,.680,125,32,76,.421,21,45,.467,11,31,.355,25,31,.806,100
305,LAL,2020-02-08,125,@,GSW,W 125-120,240,43,82,.524,29,53,.547,14,29,.483,25,34,.735,125,46,89,.517,33,57,.579,13,32,.406,15,23,.652,120
306,POR,2020-02-06,125,,SAS,W 125-117,240,49,92,.533,31,55,.564,18,37,.486,9,12,.750,125,41,92,.446,31,64,.484,10,28,.357,25,28,.893,117
307,NOP,2020-02-06,125,@,CHI,W 125-119,240,49,87,.563,33,49,.673,16,38,.421,11,19,.579,125,46,93,.495,33,64,.516,13,29,.448,14,23,.609,119
308,HOU,2020-02-04,125,,CHO,W 125-110,240,43,97,.443,23,37,.622,20,60,.333,19,23,.826,125,39,83,.470,26,50,.520,13,33,.394,19,24,.792,110
309,GSW,2020-02-03,125,@,WAS,W 125-117,240,43,87,.494,28,57,.491,15,30,.500,24,31,.774,125,42,83,.506,33,61,.541,9,22,.409,24,29,.828,117
310,POR,2020-01-29,125,,HOU,W 125-112,240,46,89,.517,33,53,.623,13,36,.361,20,27,.741,125,40,94,.426,23,47,.489,17,47,.362,15,18,.833,112
311,BRK,2020-01-29,125,,DET,W 125-115,240,43,85,.506,28,46,.609,15,39,.385,24,30,.800,125,42,83,.506,32,57,.561,10,26,.385,21,28,.750,115
312,NOP,2020-01-28,125,@,CLE,W 125-111,240,47,88,.534,34,54,.630,13,34,.382,18,24,.750,125,42,97,.433,31,63,.492,11,34,.324,16,18,.889,111
313,MEM,2020-01-24,125,@,DET,W 125-112,240,43,79,.544,32,57,.561,11,22,.500,28,31,.903,125,39,91,.429,28,59,.475,11,32,.344,23,31,.742,112
314,POR,2020-01-23,125,,DAL,L 125-133,240,46,91,.505,25,52,.481,21,39,.538,12,15,.800,125,48,93,.516,26,46,.565,22,47,.468,15,24,.625,133
315,LAL,2020-01-11,125,@,OKC,W 125-110,240,51,99,.515,36,67,.537,15,32,.469,8,10,.800,125,43,92,.467,34,61,.557,9,31,.290,15,17,.882,110
316,PHI,2019-12-23,125,@,DET,W 125-109,240,52,95,.547,40,65,.615,12,30,.400,9,11,.818,125,43,84,.512,33,54,.611,10,30,.333,13,18,.722,109
317,PHO,2019-12-21,125,,HOU,L 125-139,240,47,91,.516,39,63,.619,8,28,.286,23,30,.767,125,51,87,.586,32,46,.696,19,41,.463,18,23,.783,139
318,PHI,2019-12-21,125,,WAS,W 125-108,240,49,94,.521,35,61,.574,14,33,.424,13,21,.619,125,36,88,.409,29,57,.509,7,31,.226,29,34,.853,108
319,MIL,2019-12-14,125,,CLE,W 125-108,240,46,85,.541,32,48,.667,14,37,.378,19,26,.731,125,41,90,.456,26,55,.473,15,35,.429,11,15,.733,108
320,PHO,2019-12-09,125,,MIN,W 125-109,240,47,95,.495,31,55,.564,16,40,.400,15,19,.789,125,40,85,.471,34,63,.540,6,22,.273,23,29,.793,109
321,MIN,2019-12-08,125,@,LAL,L 125-142,240,44,84,.524,29,47,.617,15,37,.405,22,26,.846,125,55,94,.585,41,63,.651,14,31,.452,18,20,.900,142
322,WAS,2019-12-01,125,@,LAC,L 125-150,240,47,102,.461,36,72,.500,11,30,.367,20,27,.741,125,52,94,.553,38,62,.613,14,32,.438,32,40,.800,150
323,LAL,2019-11-29,125,,WAS,W 125-103,240,45,87,.517,31,55,.564,14,32,.438,21,28,.750,125,38,96,.396,28,59,.475,10,37,.270,17,19,.895,103
324,MIN,2019-11-25,125,@,ATL,W 125-113,240,41,90,.456,26,55,.473,15,35,.429,28,36,.778,125,41,94,.436,31,62,.500,10,32,.313,21,26,.808,113
325,WAS,2019-11-22,125,,CHO,W 125-118,240,48,91,.527,34,57,.596,14,34,.412,15,20,.750,125,48,93,.516,34,59,.576,14,34,.412,8,8,1.000,118
326,ORL,2019-11-17,125,,WAS,W 125-121,240,43,87,.494,28,49,.571,15,38,.395,24,26,.923,125,46,97,.474,27,56,.482,19,41,.463,10,12,.833,121
327,HOU,2019-11-16,125,@,MIN,W 125-105,240,43,94,.457,24,45,.533,19,49,.388,20,22,.909,125,38,84,.452,26,46,.565,12,38,.316,17,23,.739,105
328,ATL,2019-11-12,125,@,DEN,W 125-121,240,44,83,.530,29,49,.592,15,34,.441,22,34,.647,125,46,104,.442,35,63,.556,11,41,.268,18,22,.818,121
329,MIN,2019-11-08,125,,GSW,W 125-119 (OT),265,48,111,.432,39,75,.520,9,36,.250,20,29,.690,125,43,103,.417,33,68,.485,10,35,.286,23,24,.958,119
330,NOP,2019-11-04,125,@,BRK,L 125-135,240,48,97,.495,35,65,.538,13,32,.406,16,21,.762,125,49,92,.533,33,51,.647,16,41,.390,21,28,.750,135
331,TOR,2019-10-30,125,,DET,W 125-113,240,51,86,.593,38,59,.644,13,27,.481,10,12,.833,125,41,88,.466,27,58,.466,14,30,.467,17,23,.739,113
332,CHI,2019-10-23,125,@,CHO,L 125-126,240,49,105,.467,40,75,.533,9,30,.300,18,22,.818,125,45,88,.511,22,44,.500,23,44,.523,13,16,.813,126
333,LAC,2020-08-12,124,@,DEN,W 124-111,240,46,85,.541,32,48,.667,14,37,.378,18,23,.783,124,43,87,.494,30,52,.577,13,35,.371,12,19,.632,111
334,LAL,2020-08-10,124,,DEN,W 124-121,240,44,81,.543,30,52,.577,14,29,.483,22,32,.688,124,45,77,.584,32,54,.593,13,23,.565,18,23,.783,121
335,POR,2020-08-09,124,,PHI,W 124-121,240,43,91,.473,32,56,.571,11,35,.314,27,29,.931,124,47,97,.485,33,67,.493,14,30,.467,13,17,.765,121
336,UTA,2020-08-05,124,,MEM,W 124-115,240,38,84,.452,20,39,.513,18,45,.400,30,33,.909,124,43,91,.473,32,62,.516,11,29,.379,18,25,.720,115
337,POR,2020-08-02,124,@,BOS,L 124-128,240,45,90,.500,26,48,.542,19,42,.452,15,16,.938,124,42,77,.545,24,47,.511,18,30,.600,26,34,.765,128
338,PHI,2020-03-11,124,,DET,W 124-106,240,42,83,.506,28,50,.560,14,33,.424,26,32,.813,124,39,84,.464,28,49,.571,11,35,.314,17,25,.680,106
339,WAS,2020-03-01,124,@,GSW,W 124-110,240,40,82,.488,20,52,.385,20,30,.667,24,27,.889,124,42,89,.472,33,61,.541,9,28,.321,17,24,.708,110
340,OKC,2020-02-25,124,@,CHI,W 124-122,240,42,76,.553,28,46,.609,14,30,.467,26,35,.743,124,52,97,.536,40,66,.606,12,31,.387,6,9,.667,122
341,LAC,2020-02-24,124,,MEM,W 124-97,240,47,94,.500,31,57,.544,16,37,.432,14,17,.824,124,37,89,.416,30,62,.484,7,27,.259,16,22,.727,97
342,MIA,2020-02-22,124,,CLE,W 124-105,240,45,79,.570,26,39,.667,19,40,.475,15,20,.750,124,38,79,.481,25,43,.581,13,36,.361,16,22,.727,105
343,MIA,2020-02-20,124,@,ATL,L 124-129,240,40,98,.408,29,61,.475,11,37,.297,33,38,.868,124,41,85,.482,25,50,.500,16,35,.457,31,35,.886,129
344,NOP,2020-02-08,124,@,IND,W 124-117,240,44,95,.463,29,57,.509,15,38,.395,21,25,.840,124,44,83,.530,35,57,.614,9,26,.346,20,27,.741,117
345,POR,2020-02-01,124,,UTA,W 124-107,240,47,92,.511,32,63,.508,15,29,.517,15,18,.833,124,40,94,.426,22,53,.415,18,41,.439,9,9,1.000,107
346,SAC,2020-01-30,124,@,LAC,W 124-103,240,44,88,.500,23,47,.489,21,41,.512,15,18,.833,124,35,92,.380,22,61,.361,13,31,.419,20,25,.800,103
347,MIN,2020-01-24,124,,HOU,L 124-131,240,48,98,.490,37,66,.561,11,32,.344,17,20,.850,124,47,91,.516,36,59,.610,11,32,.344,26,31,.839,131
348,WAS,2020-01-23,124,@,CLE,W 124-112,240,47,85,.553,31,49,.633,16,36,.444,14,18,.778,124,44,96,.458,33,63,.524,11,33,.333,13,17,.765,112
349,GSW,2020-01-20,124,@,POR,L 124-129 (OT),265,48,116,.414,39,80,.488,9,36,.250,19,22,.864,124,44,100,.440,30,56,.536,14,44,.318,27,30,.900,129
350,LAL,2020-01-18,124,@,HOU,W 124-115,240,45,93,.484,34,60,.567,11,33,.333,23,32,.719,124,40,90,.444,28,53,.528,12,37,.324,23,29,.793,115
351,DAL,2020-01-14,124,@,GSW,W 124-97,240,49,96,.510,36,59,.610,13,37,.351,13,21,.619,124,39,87,.448,30,55,.545,9,32,.281,10,13,.769,97
352,NYK,2020-01-12,124,,MIA,W 124-121,240,46,90,.511,37,59,.627,9,31,.290,23,28,.821,124,42,78,.538,28,43,.651,14,35,.400,23,28,.821,121
353,DEN,2020-01-02,124,@,IND,W 124-116,240,46,87,.529,38,60,.633,8,27,.296,24,27,.889,124,43,82,.524,31,56,.554,12,26,.462,18,25,.720,116
354,LAC,2019-12-13,124,@,MIN,W 124-117,240,39,79,.494,28,54,.519,11,25,.440,35,39,.897,124,38,85,.447,28,44,.636,10,41,.244,31,37,.838,117
355,NYK,2019-12-11,124,@,GSW,W 124-122 (OT),265,43,90,.478,31,61,.508,12,29,.414,26,34,.765,124,45,104,.433,35,67,.522,10,37,.270,22,30,.733,122
356,NOP,2019-11-21,124,@,PHO,W 124-121,240,47,88,.534,31,53,.585,16,35,.457,14,22,.636,124,40,86,.465,27,55,.491,13,31,.419,28,32,.875,121
357,MIA,2019-11-20,124,,CLE,W 124-100,240,41,78,.526,22,41,.537,19,37,.514,23,31,.742,124,37,87,.425,25,49,.510,12,38,.316,14,16,.875,100
358,MIL,2019-11-14,124,,CHI,W 124-115,240,42,88,.477,36,55,.655,6,33,.182,34,47,.723,124,38,93,.409,20,50,.400,18,43,.419,21,25,.840,115
359,POR,2019-11-10,124,,ATL,W 124-113 (OT),265,45,104,.433,33,68,.485,12,36,.333,22,28,.786,124,42,104,.404,31,63,.492,11,41,.268,18,25,.720,113
360,MIA,2019-11-07,124,@,PHO,W 124-108,240,45,82,.549,30,54,.556,15,28,.536,19,24,.792,124,37,84,.440,26,52,.500,11,32,.344,23,31,.742,108
361,LAC,2019-11-06,124,,MIL,L 124-129,240,41,98,.418,28,67,.418,13,31,.419,29,36,.806,124,42,98,.429,24,49,.490,18,49,.367,27,34,.794,129
362,TOR,2019-11-06,124,,SAC,W 124-120,240,43,78,.551,29,49,.592,14,29,.483,24,29,.828,124,42,95,.442,22,51,.431,20,44,.455,16,21,.762,120
363,SAS,2019-10-26,124,,WAS,W 124-122,240,50,108,.463,40,80,.500,10,28,.357,14,17,.824,124,47,95,.495,31,61,.508,16,34,.471,12,17,.706,122
364,PHO,2019-10-23,124,,SAC,W 124-95,240,49,98,.500,38,65,.585,11,33,.333,15,18,.833,124,34,87,.391,24,58,.414,10,29,.345,17,26,.654,95
365,SAS,2020-08-11,123,,HOU,W 123-105,240,46,93,.495,33,61,.541,13,32,.406,18,20,.900,123,36,89,.404,22,41,.537,14,48,.292,19,21,.905,105
366,SAC,2020-03-07,123,@,POR,W 123-111,240,41,85,.482,20,46,.435,21,39,.538,20,23,.870,123,42,89,.472,32,50,.640,10,39,.256,17,26,.654,111
367,NOP,2020-03-04,123,@,DAL,L 123-127 (OT),265,50,114,.439,33,68,.485,17,46,.370,6,11,.545,123,44,95,.463,22,45,.489,22,50,.440,17,24,.708,127
368,TOR,2020-03-03,123,@,PHO,W 123-114,240,40,86,.465,26,52,.500,14,34,.412,29,35,.829,123,39,85,.459,24,46,.522,15,39,.385,21,25,.840,114
369,HOU,2020-03-02,123,@,NYK,L 123-125,240,39,94,.415,19,38,.500,20,56,.357,25,27,.926,123,47,97,.485,35,67,.522,12,30,.400,19,30,.633,125
370,MIN,2020-02-24,123,@,DAL,L 123-139,240,42,95,.442,27,53,.509,15,42,.357,24,34,.706,123,51,101,.505,35,57,.614,16,44,.364,21,28,.750,139
371,HOU,2020-02-24,123,,NYK,W 123-112,240,43,86,.500,27,38,.711,16,48,.333,21,31,.677,123,40,91,.440,29,62,.468,11,29,.379,21,30,.700,112
372,OKC,2020-02-13,123,@,NOP,W 123-118,240,46,92,.500,33,65,.508,13,27,.481,18,22,.818,123,42,86,.488,28,51,.549,14,35,.400,20,27,.741,118
373,MIL,2020-02-10,123,,SAC,W 123-111,240,43,96,.448,25,54,.463,18,42,.429,19,23,.826,123,42,101,.416,28,58,.483,14,43,.326,13,18,.722,111
374,UTA,2020-02-10,123,@,DAL,W 123-119,240,46,78,.590,31,43,.721,15,35,.429,16,21,.762,123,39,83,.470,24,40,.600,15,43,.349,26,31,.839,119
375,BOS,2020-02-03,123,@,ATL,W 123-115,240,48,90,.533,36,61,.590,12,29,.414,15,17,.882,123,42,84,.500,30,54,.556,12,30,.400,19,21,.905,115
376,DEN,2020-02-02,123,@,DET,L 123-128 (OT),265,48,96,.500,38,64,.594,10,32,.313,17,22,.773,123,48,94,.511,34,63,.540,14,31,.452,18,24,.750,128
377,DAL,2020-02-01,123,,ATL,W 123-100,240,44,94,.468,24,55,.436,20,39,.513,15,16,.938,123,37,91,.407,27,58,.466,10,33,.303,16,21,.762,100
378,NOP,2020-01-26,123,,BOS,W 123-108,240,44,92,.478,28,56,.500,16,36,.444,19,29,.655,123,41,89,.461,33,56,.589,8,33,.242,18,22,.818,108
379,PHO,2020-01-18,123,@,BOS,W 123-119,240,42,89,.472,29,58,.500,13,31,.419,26,30,.867,123,42,96,.438,27,54,.500,15,42,.357,20,22,.909,119
380,UTA,2020-01-18,123,,SAC,W 123-101,240,43,85,.506,29,43,.674,14,42,.333,23,24,.958,123,42,86,.488,32,60,.533,10,26,.385,7,12,.583,101
381,BOS,2020-01-16,123,@,MIL,L 123-128,240,43,98,.439,28,49,.571,15,49,.306,22,27,.815,123,43,87,.494,27,56,.482,16,31,.516,26,37,.703,128
382,SAC,2020-01-15,123,,DAL,L 123-127,240,50,96,.521,38,63,.603,12,33,.364,11,20,.550,123,47,92,.511,34,52,.654,13,40,.325,20,24,.833,127
383,ATL,2020-01-14,123,,PHO,W 123-110,240,46,93,.495,32,62,.516,14,31,.452,17,20,.850,123,40,87,.460,36,67,.537,4,20,.200,26,32,.813,110
384,NOP,2020-01-10,123,@,NYK,W 123-111,240,48,86,.558,30,48,.625,18,38,.474,9,17,.529,123,46,100,.460,41,73,.562,5,27,.185,14,20,.700,111
385,NOP,2020-01-08,123,,CHI,W 123-108,240,41,87,.471,26,43,.605,15,44,.341,26,32,.813,123,41,92,.446,27,57,.474,14,35,.400,12,21,.571,108
386,ORL,2020-01-08,123,,WAS,W 123-89,240,43,87,.494,33,60,.550,10,27,.370,27,34,.794,123,36,84,.429,30,61,.492,6,23,.261,11,19,.579,89
387,DEN,2020-01-06,123,@,ATL,W 123-115,240,47,92,.511,38,65,.585,9,27,.333,20,27,.741,123,35,77,.455,17,38,.447,18,39,.462,27,32,.844,115
388,CHO,2020-01-04,123,@,DAL,W 123-120 (OT),265,42,85,.494,31,60,.517,11,25,.440,28,31,.903,123,47,100,.470,32,50,.640,15,50,.300,11,13,.846,120
389,LAL,2020-01-03,123,,NOP,W 123-113,240,43,86,.500,29,57,.509,14,29,.483,23,28,.821,123,48,102,.471,37,65,.569,11,37,.297,6,7,.857,113
390,DAL,2020-01-02,123,,BRK,W 123-111,240,45,89,.506,27,51,.529,18,38,.474,15,17,.882,123,42,91,.462,30,54,.556,12,37,.324,15,17,.882,111
391,MEM,2020-01-02,123,@,SAC,L 123-128,240,45,93,.484,32,59,.542,13,34,.382,20,21,.952,123,44,90,.489,30,56,.536,14,34,.412,26,31,.839,128
392,MIL,2019-12-30,123,@,CHI,W 123-102,240,46,84,.548,35,52,.673,11,32,.344,20,24,.833,123,40,107,.374,23,63,.365,17,44,.386,5,8,.625,102
393,WAS,2019-12-30,123,,MIA,W 123-105,240,43,84,.512,26,47,.553,17,37,.459,20,30,.667,123,33,73,.452,23,45,.511,10,28,.357,29,39,.744,105
394,MIL,2019-12-21,123,@,NYK,W 123-102,240,41,85,.482,23,42,.548,18,43,.419,23,35,.657,123,39,97,.402,30,67,.448,9,30,.300,15,21,.714,102
395,HOU,2019-11-24,123,,DAL,L 123-137,240,45,98,.459,35,54,.648,10,44,.227,23,31,.742,123,49,102,.480,32,58,.552,17,44,.386,22,28,.786,137
396,NYK,2019-11-18,123,,CLE,W 123-105,240,44,98,.449,36,75,.480,8,23,.348,27,35,.771,123,36,76,.474,19,40,.475,17,36,.472,16,30,.533,105
397,LAL,2019-11-12,123,@,PHO,W 123-115,240,51,95,.537,41,70,.586,10,25,.400,11,21,.524,123,43,91,.473,27,53,.509,16,38,.421,13,17,.765,115
398,MIL,2019-11-01,123,@,ORL,W 123-91,240,47,93,.505,30,46,.652,17,47,.362,12,18,.667,123,34,91,.374,22,54,.407,12,37,.324,11,17,.647,91
399,BRK,2019-11-01,123,,HOU,W 123-116,240,42,85,.494,23,53,.434,19,32,.594,20,28,.714,123,41,99,.414,29,51,.569,12,48,.250,22,27,.815,116
400,NOP,2019-10-28,123,,GSW,L 123-134,240,48,103,.466,33,56,.589,15,47,.319,12,22,.545,123,51,104,.490,37,69,.536,14,35,.400,18,24,.750,134
401,NOP,2019-10-26,123,@,HOU,L 123-126,240,46,100,.460,28,50,.560,18,50,.360,13,16,.813,123,43,94,.457,30,49,.612,13,45,.289,27,30,.900,126
402,DAL,2019-10-25,123,@,NOP,W 123-116,240,45,93,.484,31,53,.585,14,40,.350,19,26,.731,123,45,98,.459,30,57,.526,15,41,.366,11,15,.733,116
403,LAL,2020-08-13,122,,SAC,L 122-136,240,48,98,.490,33,63,.524,15,35,.429,11,15,.733,122,54,95,.568,33,48,.688,21,47,.447,7,12,.583,136
404,BOS,2020-08-11,122,@,MEM,W 122-107,240,44,86,.512,28,49,.571,16,37,.432,18,23,.783,122,35,89,.393,28,60,.467,7,29,.241,30,38,.789,107
405,DAL,2020-08-10,122,@,UTA,W 122-114,240,48,85,.565,36,61,.590,12,24,.500,14,16,.875,122,39,82,.476,18,36,.500,21,46,.457,15,20,.750,114
406,SAS,2020-08-09,122,@,NOP,W 122-113,240,40,89,.449,29,61,.475,11,28,.393,31,32,.969,122,42,96,.438,30,66,.455,12,30,.400,17,22,.773,113
407,BOS,2020-08-09,122,,ORL,W 122-119 (OT),265,45,102,.441,33,62,.532,12,40,.300,20,24,.833,122,41,102,.402,26,55,.473,15,47,.319,22,26,.846,119
408,LAC,2020-08-08,122,@,POR,W 122-117,240,42,85,.494,27,51,.529,15,34,.441,23,28,.821,122,44,90,.489,27,47,.574,17,43,.395,12,17,.706,117
409,BOS,2020-08-07,122,@,TOR,W 122-100,240,47,96,.490,31,50,.620,16,46,.348,12,16,.750,122,38,89,.427,28,51,.549,10,38,.263,14,17,.824,100
410,WAS,2020-03-10,122,,NYK,W 122-115,240,35,74,.473,21,39,.538,14,35,.400,38,45,.844,122,42,81,.519,34,60,.567,8,21,.381,23,31,.742,115
411,LAL,2020-03-01,122,@,NOP,W 122-114,240,50,97,.515,37,62,.597,13,35,.371,9,10,.900,122,40,95,.421,33,63,.524,7,32,.219,27,33,.818,114
412,CHI,2020-02-25,122,,OKC,L 122-124,240,52,97,.536,40,66,.606,12,31,.387,6,9,.667,122,42,76,.553,28,46,.609,14,30,.467,26,35,.743,124
413,DAL,2020-02-21,122,@,ORL,W 122-106,240,43,84,.512,28,46,.609,15,38,.395,21,26,.808,122,41,104,.394,32,61,.525,9,43,.209,15,19,.789,106
414,SAC,2020-02-08,122,,SAS,W 122-102,240,45,86,.523,26,51,.510,19,35,.543,13,20,.650,122,41,81,.506,34,57,.596,7,24,.292,13,18,.722,102
415,LAC,2020-01-24,122,@,MIA,W 122-117,240,43,94,.457,27,59,.458,16,35,.457,20,23,.870,122,40,93,.430,27,49,.551,13,44,.295,24,29,.828,117
416,TOR,2020-01-20,122,@,ATL,W 122-117,240,38,92,.413,25,50,.500,13,42,.310,33,43,.767,122,41,83,.494,29,50,.580,12,33,.364,23,33,.697,117
417,TOR,2020-01-18,122,@,MIN,W 122-112,240,47,91,.516,34,56,.607,13,35,.371,15,17,.882,122,38,94,.404,24,44,.545,14,50,.280,22,27,.815,112
418,LAC,2020-01-16,122,,ORL,W 122-95,240,47,95,.495,33,63,.524,14,32,.438,14,20,.700,122,36,92,.391,22,50,.440,14,42,.333,9,16,.563,95
419,MEM,2020-01-12,122,,GSW,W 122-102,240,45,100,.450,34,65,.523,11,35,.314,21,25,.840,122,35,92,.380,18,58,.310,17,34,.500,15,21,.714,102
420,MIL,2020-01-11,122,@,POR,W 122-101,240,47,103,.456,33,65,.508,14,38,.368,14,20,.700,122,37,95,.389,27,59,.458,10,36,.278,17,21,.810,101
421,MIA,2020-01-08,122,@,IND,W 122-108,240,43,81,.531,27,43,.628,16,38,.421,20,25,.800,122,40,84,.476,31,57,.544,9,27,.333,19,25,.760,108
422,HOU,2020-01-08,122,@,ATL,W 122-115,240,39,92,.424,26,47,.553,13,45,.289,31,41,.756,122,39,106,.368,26,62,.419,13,44,.295,24,27,.889,115
423,MIA,2020-01-05,122,,POR,W 122-111,240,47,90,.522,29,46,.630,18,44,.409,10,16,.625,122,40,87,.460,27,50,.540,13,37,.351,18,20,.900,111
424,POR,2020-01-03,122,@,WAS,W 122-103,240,45,88,.511,39,63,.619,6,25,.240,26,33,.788,122,38,90,.422,27,57,.474,11,33,.333,16,25,.640,103
425,ORL,2020-01-01,122,@,WAS,W 122-101,240,45,95,.474,33,63,.524,12,32,.375,20,27,.741,122,33,87,.379,24,56,.429,9,31,.290,26,31,.839,101
426,MIN,2019-12-30,122,,BRK,W 122-115 (OT),265,42,104,.404,25,60,.417,17,44,.386,21,29,.724,122,40,99,.404,25,58,.431,15,41,.366,20,27,.741,115
427,PHO,2019-12-30,122,@,POR,W 122-116,240,44,92,.478,31,69,.449,13,23,.565,21,22,.955,122,44,96,.458,30,62,.484,14,34,.412,14,18,.778,116
428,BRK,2019-12-21,122,,ATL,W 122-112,240,46,100,.460,35,70,.500,11,30,.367,19,28,.679,122,39,105,.371,28,57,.491,11,48,.229,23,27,.852,112
429,TOR,2019-12-20,122,,WAS,W 122-118,240,38,78,.487,26,48,.542,12,30,.400,34,44,.773,122,40,87,.460,26,48,.542,14,39,.359,24,32,.750,118
430,HOU,2019-12-19,122,@,LAC,W 122-117,240,43,86,.500,29,49,.592,14,37,.378,22,29,.759,122,43,86,.500,27,49,.551,16,37,.432,15,19,.789,117
431,POR,2019-12-18,122,,GSW,W 122-112,240,44,97,.454,35,66,.530,9,31,.290,25,28,.893,122,41,103,.398,25,65,.385,16,38,.421,14,23,.609,112
432,MEM,2019-12-18,122,@,OKC,L 122-126,240,50,99,.505,40,73,.548,10,26,.385,12,15,.800,122,46,84,.548,39,60,.650,7,24,.292,27,34,.794,126
433,MIA,2019-12-14,122,@,DAL,W 122-118 (OT),265,39,91,.429,23,51,.451,16,40,.400,28,34,.824,122,45,101,.446,28,57,.491,17,44,.386,11,17,.647,118
434,DAL,2019-12-12,122,@,DET,W 122-111,240,45,88,.511,29,44,.659,16,44,.364,16,23,.696,122,40,89,.449,25,47,.532,15,42,.357,16,23,.696,111
435,IND,2019-12-11,122,,BOS,W 122-117,240,41,85,.482,31,60,.517,10,25,.400,30,36,.833,122,43,87,.494,29,51,.569,14,36,.389,17,22,.773,117
436,GSW,2019-12-11,122,,NYK,L 122-124 (OT),265,45,104,.433,35,67,.522,10,37,.270,22,30,.733,122,43,90,.478,31,61,.508,12,29,.414,26,34,.765,124
437,ATL,2019-12-08,122,@,CHO,W 122-107,240,44,91,.484,26,46,.565,18,45,.400,16,17,.941,122,36,90,.400,25,59,.424,11,31,.355,24,29,.828,107
438,MIA,2019-11-29,122,,GSW,W 122-105,240,44,82,.537,31,57,.544,13,25,.520,21,28,.750,122,30,77,.390,20,49,.408,10,28,.357,35,40,.875,105
439,MIL,2019-11-25,122,,UTA,W 122-118,240,43,97,.443,30,56,.536,13,41,.317,23,29,.793,122,43,85,.506,22,40,.550,21,45,.467,11,12,.917,118
440,LAC,2019-11-22,122,,HOU,W 122-119,240,45,87,.517,32,54,.593,13,33,.394,19,24,.792,122,39,84,.464,24,41,.585,15,43,.349,26,38,.684,119
441,LAL,2019-11-17,122,,ATL,W 122-101,240,47,89,.528,32,54,.593,15,35,.429,13,16,.813,122,37,86,.430,29,58,.500,8,28,.286,19,25,.760,101
442,UTA,2019-11-11,122,@,GSW,W 122-108,240,40,81,.494,24,46,.522,16,35,.457,26,32,.813,122,45,94,.479,35,63,.556,10,31,.323,8,14,.571,108
443,HOU,2019-11-11,122,@,NOP,W 122-116,240,44,85,.518,32,44,.727,12,41,.293,22,32,.688,122,41,95,.432,27,50,.540,14,45,.311,20,27,.741,116
444,MEM,2019-11-09,122,,DAL,L 122-138,240,50,95,.526,38,59,.644,12,36,.333,10,14,.714,122,52,97,.536,34,55,.618,18,42,.429,16,20,.800,138
445,TOR,2019-11-08,122,@,NOP,W 122-104,240,41,93,.441,22,50,.440,19,43,.442,21,24,.875,122,40,99,.404,30,58,.517,10,41,.244,14,21,.667,104
446,DET,2019-11-06,122,,NYK,W 122-102,240,44,79,.557,29,49,.592,15,30,.500,19,24,.792,122,39,80,.488,28,55,.509,11,25,.440,13,21,.619,102
447,CHO,2019-11-05,122,,IND,W 122-120 (OT),265,42,88,.477,32,57,.561,10,31,.323,28,42,.667,122,51,94,.543,39,64,.609,12,30,.400,6,7,.857,120
448,NOP,2019-10-31,122,,DEN,W 122-107,240,41,77,.532,26,44,.591,15,33,.455,25,32,.781,122,43,89,.483,36,63,.571,7,26,.269,14,16,.875,107
449,WAS,2019-10-26,122,@,SAS,L 122-124,240,47,95,.495,31,61,.508,16,34,.471,12,17,.706,122,50,108,.463,40,80,.500,10,28,.357,14,17,.824,124
450,LAC,2019-10-26,122,@,PHO,L 122-130,240,40,87,.460,29,55,.527,11,32,.344,31,39,.795,122,43,86,.500,26,43,.605,17,43,.395,27,34,.794,130
451,POR,2019-10-25,122,@,SAC,W 122-112,240,46,85,.541,35,55,.636,11,30,.367,19,22,.864,122,37,87,.425,22,50,.440,15,37,.405,23,27,.852,112
452,GSW,2019-10-24,122,,LAC,L 122-141,240,39,99,.394,24,57,.421,15,42,.357,29,30,.967,122,50,80,.625,32,48,.667,18,32,.563,23,30,.767,141
453,NOP,2019-10-22,122,@,TOR,L 122-130 (OT),265,43,102,.422,24,57,.421,19,45,.422,17,20,.850,122,42,103,.408,28,63,.444,14,40,.350,32,38,.842,130
454,PHI,2020-08-12,121,,TOR,L 121-125,240,39,84,.464,22,44,.500,17,40,.425,26,33,.788,121,40,90,.444,22,47,.468,18,43,.419,27,40,.675,125
455,DEN,2020-08-10,121,@,LAL,L 121-124,240,45,77,.584,32,54,.593,13,23,.565,18,23,.783,121,44,81,.543,30,52,.577,14,29,.483,22,32,.688,124
456,PHI,2020-08-09,121,@,POR,L 121-124,240,47,97,.485,33,67,.493,14,30,.467,13,17,.765,121,43,91,.473,32,56,.571,11,35,.314,27,29,.931,124
457,OKC,2020-08-09,121,,WAS,W 121-103,240,43,84,.512,25,45,.556,18,39,.462,17,22,.773,121,38,92,.413,29,56,.518,9,36,.250,18,22,.818,103
458,MEM,2020-08-07,121,,OKC,W 121-92,240,46,83,.554,35,52,.673,11,31,.355,18,20,.900,121,34,97,.351,21,54,.389,13,43,.302,11,15,.733,92
459,DEN,2020-08-03,121,@,OKC,W 121-113 (OT),265,42,87,.483,35,62,.565,7,25,.280,30,39,.769,121,37,87,.425,22,51,.431,15,36,.417,24,31,.774,113
460,PHI,2020-08-01,121,@,IND,L 121-127,240,46,93,.495,37,68,.544,9,25,.360,20,25,.800,121,48,95,.505,34,61,.557,14,34,.412,17,23,.739,127
461,POR,2020-03-10,121,,PHO,W 121-105,240,45,89,.506,28,54,.519,17,35,.486,14,17,.824,121,35,87,.402,24,55,.436,11,32,.344,24,25,.960,105
462,DAL,2020-03-06,121,,MEM,W 121-96,240,45,95,.474,27,48,.563,18,47,.383,13,17,.765,121,39,84,.464,30,54,.556,9,30,.300,9,13,.692,96
463,TOR,2020-03-05,121,@,GSW,W 121-113,240,40,84,.476,27,43,.628,13,41,.317,28,31,.903,121,40,98,.408,26,46,.565,14,52,.269,19,25,.760,113
464,HOU,2020-02-06,121,@,LAL,W 121-111,240,43,85,.506,24,43,.558,19,42,.452,16,18,.889,121,45,91,.495,36,60,.600,9,31,.290,12,16,.750,111
465,MEM,2020-02-05,121,@,DAL,W 121-107,240,47,89,.528,35,64,.547,12,25,.480,15,20,.750,121,34,94,.362,17,51,.333,17,43,.395,22,24,.917,107
466,DAL,2020-01-31,121,@,HOU,L 121-128,240,43,90,.478,29,54,.537,14,36,.389,21,27,.778,121,45,98,.459,24,53,.453,21,45,.467,17,20,.850,128
467,WAS,2020-01-30,121,,CHO,W 121-107,240,41,86,.477,27,49,.551,14,37,.378,25,27,.926,121,43,99,.434,34,69,.493,9,30,.300,12,19,.632,107
468,BRK,2020-01-25,121,@,DET,W 121-111 (OT),265,42,94,.447,27,52,.519,15,42,.357,22,25,.880,121,43,104,.413,30,69,.435,13,35,.371,12,18,.667,111
469,HOU,2020-01-22,121,,DEN,W 121-105,240,42,89,.472,29,60,.483,13,29,.448,24,28,.857,121,42,92,.457,32,64,.500,10,28,.357,11,15,.733,105
470,SAS,2020-01-22,121,@,NOP,W 121-117,240,45,89,.506,34,62,.548,11,27,.407,20,25,.800,121,39,84,.464,25,48,.521,14,36,.389,25,32,.781,117
471,ATL,2020-01-17,121,@,SAS,W 121-120,240,41,82,.500,22,42,.524,19,40,.475,20,27,.741,121,45,98,.459,37,69,.536,8,29,.276,22,23,.957,120
472,PHO,2020-01-16,121,@,NYK,W 121-98,240,47,92,.511,35,62,.565,12,30,.400,15,18,.833,121,37,90,.411,29,64,.453,8,26,.308,16,24,.667,98
473,OKC,2020-01-15,121,,TOR,L 121-130,240,43,85,.506,27,43,.628,16,42,.381,19,20,.950,121,52,85,.612,37,58,.638,15,27,.556,11,15,.733,130
474,MEM,2020-01-14,121,,HOU,W 121-110,240,46,91,.505,33,54,.611,13,37,.351,16,19,.842,121,37,86,.430,23,41,.561,14,45,.311,22,24,.917,110
475,MIA,2020-01-12,121,@,NYK,L 121-124,240,42,78,.538,28,43,.651,14,35,.400,23,28,.821,121,46,90,.511,37,59,.627,9,31,.290,23,28,.821,124
476,SAS,2020-01-10,121,@,MEM,L 121-134,240,42,87,.483,25,47,.532,17,40,.425,20,23,.870,121,52,100,.520,36,62,.581,16,38,.421,14,16,.875,134
477,MEM,2020-01-05,121,@,PHO,W 121-114,240,45,83,.542,27,41,.659,18,42,.429,13,17,.765,121,43,95,.453,37,69,.536,6,26,.231,22,26,.846,114
478,TOR,2020-01-04,121,@,BRK,W 121-102,240,44,97,.454,31,65,.477,13,32,.406,20,28,.714,121,32,67,.478,19,32,.594,13,35,.371,25,34,.735,102
479,OKC,2020-01-04,121,@,CLE,W 121-106,240,43,96,.448,29,59,.492,14,37,.378,21,26,.808,121,39,85,.459,25,55,.455,14,30,.467,14,17,.824,106
480,GSW,2019-12-28,121,,DAL,L 121-141,240,45,93,.484,27,54,.500,18,39,.462,13,17,.765,121,48,92,.522,24,41,.585,24,51,.471,21,21,1.000,141
481,UTA,2019-12-26,121,,POR,W 121-115,240,46,81,.568,32,45,.711,14,36,.389,15,22,.682,121,43,89,.483,28,55,.509,15,34,.441,14,19,.737,115
482,PHI,2019-12-25,121,,MIL,W 121-109,240,44,101,.436,23,57,.404,21,44,.477,12,15,.800,121,45,95,.474,32,62,.516,13,33,.394,6,8,.750,109
483,WAS,2019-12-23,121,@,NYK,W 121-115,240,47,100,.470,37,70,.529,10,30,.333,17,30,.567,121,44,93,.473,29,57,.509,15,36,.417,12,15,.800,115
484,CLE,2019-12-23,121,,ATL,W 121-118,240,50,96,.521,39,67,.582,11,29,.379,10,12,.833,121,45,95,.474,30,53,.566,15,42,.357,13,17,.765,118
485,SAS,2019-12-14,121,@,PHO,W 121-119 (OT),265,44,106,.415,36,76,.474,8,30,.267,25,34,.735,121,45,103,.437,35,63,.556,10,40,.250,19,26,.731,119
486,ATL,2019-12-10,121,@,MIA,L 121-135 (OT),265,45,95,.474,25,41,.610,20,54,.370,11,18,.611,121,53,103,.515,39,62,.629,14,41,.341,15,22,.682,135
487,DAL,2019-12-04,121,,MIN,W 121-114,240,46,92,.500,35,55,.636,11,37,.297,18,23,.783,121,37,89,.416,20,51,.392,17,38,.447,23,26,.885,114
488,LAL,2019-12-04,121,@,UTA,W 121-96,240,46,90,.511,32,61,.525,14,29,.483,15,25,.600,121,34,83,.410,20,52,.385,14,31,.452,14,19,.737,96
489,MIA,2019-12-03,121,@,TOR,W 121-110 (OT),265,45,99,.455,30,61,.492,15,38,.395,16,21,.762,121,35,91,.385,24,48,.500,11,43,.256,29,36,.806,110
490,IND,2019-11-27,121,,UTA,W 121-102,240,50,96,.521,42,74,.568,8,22,.364,13,16,.813,121,36,83,.434,26,51,.510,10,32,.313,20,25,.800,102
491,BOS,2019-11-27,121,,BRK,W 121-110,240,43,97,.443,30,63,.476,13,34,.382,22,24,.917,121,40,90,.444,19,34,.559,21,56,.375,9,19,.474,110
492,LAC,2019-11-27,121,@,MEM,W 121-119,240,44,95,.463,30,54,.556,14,41,.341,19,25,.760,121,43,92,.467,32,64,.500,11,28,.393,22,26,.846,119
493,PHO,2019-11-21,121,,NOP,L 121-124,240,40,86,.465,27,55,.491,13,31,.419,28,32,.875,121,47,88,.534,31,53,.585,16,35,.457,14,22,.636,124
494,WAS,2019-11-17,121,@,ORL,L 121-125,240,46,97,.474,27,56,.482,19,41,.463,10,12,.833,121,43,87,.494,28,49,.571,15,38,.395,24,26,.923,125
495,POR,2019-11-16,121,@,SAS,W 121-116,240,42,93,.452,29,54,.537,13,39,.333,24,26,.923,121,41,88,.466,36,70,.514,5,18,.278,29,34,.853,116
496,DEN,2019-11-12,121,,ATL,L 121-125,240,46,104,.442,35,63,.556,11,41,.268,18,22,.818,121,44,83,.530,29,49,.592,15,34,.441,22,34,.647,125
497,MIL,2019-11-10,121,@,OKC,W 121-119,240,47,83,.566,36,55,.655,11,28,.393,16,18,.889,121,45,91,.495,28,49,.571,17,42,.405,12,17,.706,119
498,SAC,2019-11-08,121,@,ATL,W 121-109,240,42,76,.553,24,45,.533,18,31,.581,19,22,.864,121,46,87,.529,37,59,.627,9,28,.321,8,14,.571,109
499,SAS,2019-11-07,121,,OKC,W 121-112,240,51,94,.543,42,74,.568,9,20,.450,10,11,.909,121,42,80,.525,32,59,.542,10,21,.476,18,24,.750,112
500,IND,2019-11-06,121,,WAS,W 121-106,240,44,94,.468,32,64,.500,12,30,.400,21,26,.808,121,37,95,.389,24,55,.436,13,40,.325,19,19,1.000,106
501,MIN,2019-11-06,121,@,MEM,L 121-137,240,43,96,.448,27,51,.529,16,45,.356,19,26,.731,121,50,88,.568,38,65,.585,12,23,.522,25,30,.833,137
502,PHO,2019-10-30,121,@,GSW,W 121-110,240,44,96,.458,29,60,.483,15,36,.417,18,21,.857,121,36,82,.439,28,54,.519,8,28,.286,30,36,.833,110
503,POR,2019-10-27,121,@,DAL,W 121-119,240,45,87,.517,36,65,.554,9,22,.409,22,26,.846,121,37,94,.394,24,44,.545,13,50,.260,32,41,.780,119
504,MIN,2019-10-25,121,@,CHO,W 121-99,240,43,91,.473,31,53,.585,12,38,.316,23,31,.742,121,37,84,.440,25,55,.455,12,29,.414,13,26,.500,99
505,LAC,2020-08-09,120,,BRK,L 120-129,240,45,93,.484,32,57,.561,13,36,.361,17,20,.850,120,47,85,.553,27,42,.643,20,43,.465,15,19,.789,129
506,IND,2020-08-04,120,,ORL,W 120-109,240,46,84,.548,33,51,.647,13,33,.394,15,19,.789,120,39,82,.476,27,48,.563,12,34,.353,19,23,.826,109
507,HOU,2020-08-02,120,,MIL,W 120-116,240,36,91,.396,15,30,.500,21,61,.344,27,31,.871,120,45,92,.489,36,57,.632,9,35,.257,17,23,.739,116
508,SAC,2020-07-31,120,@,SAS,L 120-129,240,46,95,.484,34,57,.596,12,38,.316,16,20,.800,120,48,90,.533,37,65,.569,11,25,.440,22,27,.815,129
509,ORL,2020-03-10,120,@,MEM,W 120-115,240,43,92,.467,29,59,.492,14,33,.424,20,22,.909,120,38,76,.500,27,47,.574,11,29,.379,28,38,.737,115
510,NOP,2020-03-08,120,@,MIN,W 120-107,240,44,90,.489,33,55,.600,11,35,.314,21,31,.677,120,37,94,.394,29,61,.475,8,33,.242,25,31,.806,107
511,SAS,2020-03-06,120,@,BRK,L 120-139,240,43,92,.467,33,58,.569,10,34,.294,24,27,.889,120,51,96,.531,36,60,.600,15,36,.417,22,31,.710,139
512,LAC,2020-03-05,120,@,HOU,W 120-105,240,39,84,.464,26,44,.591,13,40,.325,29,39,.744,120,35,97,.361,28,55,.509,7,42,.167,28,36,.778,105
513,BOS,2020-03-03,120,,BRK,L 120-129 (OT),265,44,103,.427,29,54,.537,15,49,.306,17,23,.739,120,43,100,.430,29,51,.569,14,49,.286,29,38,.763,129
514,LAL,2020-03-03,120,,PHI,W 120-107,240,46,86,.535,33,53,.623,13,33,.394,15,18,.833,120,38,85,.447,22,45,.489,16,40,.400,15,20,.750,107
515,ATL,2020-02-26,120,,ORL,L 120-130,240,42,94,.447,29,58,.500,13,36,.361,23,25,.920,120,49,100,.490,35,68,.515,14,32,.438,18,25,.720,130
516,HOU,2020-02-22,120,@,UTA,W 120-110,240,45,92,.489,25,44,.568,20,48,.417,10,14,.714,120,42,90,.467,35,59,.593,7,31,.226,19,24,.792,110
517,LAL,2020-02-12,120,@,DEN,W 120-116 (OT),265,47,93,.505,35,60,.583,12,33,.364,14,27,.519,120,44,88,.500,33,63,.524,11,25,.440,17,22,.773,116
518,SAS,2020-02-10,120,@,DEN,L 120-127,240,41,85,.482,25,53,.472,16,32,.500,22,25,.880,120,45,80,.563,27,45,.600,18,35,.514,19,23,.826,127
519,GSW,2020-02-08,120,,LAL,L 120-125,240,46,89,.517,33,57,.579,13,32,.406,15,23,.652,120,43,82,.524,29,53,.547,14,29,.483,25,34,.735,125
520,MIN,2020-02-05,120,,ATL,L 120-127,240,45,91,.495,36,56,.643,9,35,.257,21,28,.750,120,43,82,.524,30,50,.600,13,32,.406,28,30,.933,127
521,MIL,2020-02-04,120,@,NOP,W 120-108,240,48,102,.471,37,66,.561,11,36,.306,13,17,.765,120,38,99,.384,24,50,.480,14,49,.286,18,24,.750,108
522,UTA,2020-01-29,120,@,SAS,L 120-127,240,37,84,.440,23,46,.500,14,38,.368,32,46,.696,120,46,82,.561,38,51,.745,8,31,.258,27,30,.900,127
523,OKC,2020-01-29,120,@,SAC,W 120-100,240,44,88,.500,29,54,.537,15,34,.441,17,20,.850,120,42,91,.462,33,52,.635,9,39,.231,7,11,.636,100
524,OKC,2020-01-22,120,@,ORL,W 120-114,240,46,76,.605,37,57,.649,9,19,.474,19,23,.826,120,44,92,.478,30,57,.526,14,35,.400,12,16,.750,114
525,SAS,2020-01-20,120,@,PHO,W 120-118,240,43,87,.494,26,56,.464,17,31,.548,17,22,.773,120,42,80,.525,34,58,.586,8,22,.364,26,30,.867,118
526,DAL,2020-01-17,120,,POR,W 120-112,240,39,89,.438,19,42,.452,20,47,.426,22,28,.786,120,44,85,.518,35,55,.636,9,30,.300,15,22,.682,112
527,SAS,2020-01-17,120,,ATL,L 120-121,240,45,98,.459,37,69,.536,8,29,.276,22,23,.957,120,41,82,.500,22,42,.524,19,40,.475,20,27,.741,121
528,PHI,2020-01-06,120,,OKC,W 120-113,240,46,90,.511,33,64,.516,13,26,.500,15,18,.833,120,40,89,.449,28,60,.467,12,29,.414,21,31,.677,113
529,DAL,2020-01-04,120,,CHO,L 120-123 (OT),265,47,100,.470,32,50,.640,15,50,.300,11,13,.846,120,42,85,.494,31,60,.517,11,25,.440,28,31,.903,123
530,PHO,2020-01-03,120,,NYK,W 120-112,240,42,90,.467,32,62,.516,10,28,.357,26,33,.788,120,41,92,.446,31,55,.564,10,37,.270,20,30,.667,112
531,DEN,2019-12-29,120,,SAC,W 120-115,240,42,81,.519,34,52,.654,8,29,.276,28,31,.903,120,45,85,.529,32,51,.627,13,34,.382,12,17,.706,115
532,UTA,2019-12-28,120,@,LAC,W 120-107,240,45,86,.523,28,51,.549,17,35,.486,13,17,.765,120,35,95,.368,23,55,.418,12,40,.300,25,27,.926,107
533,POR,2019-12-28,120,,LAL,L 120-128,240,41,86,.477,26,51,.510,15,35,.429,23,27,.852,120,47,91,.516,36,59,.610,11,32,.344,23,28,.821,128
534,NOP,2019-12-28,120,,IND,W 120-98,240,43,93,.462,25,51,.490,18,42,.429,16,20,.800,120,33,85,.388,27,57,.474,6,28,.214,26,29,.897,98
535,IND,2019-12-23,120,,TOR,W 120-115 (OT),265,45,95,.474,27,53,.509,18,42,.429,12,20,.600,120,43,94,.457,32,54,.593,11,40,.275,18,24,.750,115
536,LAC,2019-12-17,120,,PHO,W 120-99,240,45,89,.506,31,57,.544,14,32,.438,16,22,.727,120,41,102,.402,31,67,.463,10,35,.286,7,10,.700,99
537,ATL,2019-12-17,120,@,NYK,L 120-143,240,45,99,.455,30,56,.536,15,43,.349,15,20,.750,120,53,95,.558,40,67,.597,13,28,.464,24,31,.774,143
538,DAL,2019-12-16,120,@,MIL,W 120-116,240,41,88,.466,25,47,.532,16,41,.390,22,27,.815,120,44,105,.419,33,64,.516,11,41,.268,17,24,.708,116
539,WAS,2019-12-03,120,,ORL,L 120-127,240,45,89,.506,33,54,.611,12,35,.343,18,23,.783,120,46,90,.511,31,59,.525,15,31,.484,20,27,.741,127
540,DAL,2019-11-29,120,@,PHO,W 120-113,240,35,85,.412,18,38,.474,17,47,.362,33,38,.868,120,41,93,.441,28,55,.509,13,38,.342,18,25,.720,113
541,NOP,2019-11-23,120,@,UTA,L 120-128,240,42,101,.416,25,60,.417,17,41,.415,19,20,.950,120,42,82,.512,27,46,.587,15,36,.417,29,33,.879,128
542,SAC,2019-11-19,120,,PHO,W 120-116,240,42,79,.532,29,48,.604,13,31,.419,23,25,.920,120,38,89,.427,26,53,.491,12,36,.333,28,34,.824,116
543,LAL,2019-11-13,120,,GSW,W 120-94,240,48,89,.539,39,69,.565,9,20,.450,15,18,.833,120,36,89,.404,27,54,.500,9,35,.257,13,17,.765,94
544,CHI,2019-11-12,120,,NYK,W 120-102,240,41,81,.506,27,48,.563,14,33,.424,24,31,.774,120,36,88,.409,26,56,.464,10,32,.313,20,31,.645,102
545,MIN,2019-11-11,120,@,DET,W 120-114,240,45,89,.506,30,55,.545,15,34,.441,15,19,.789,120,39,87,.448,23,55,.418,16,32,.500,20,25,.800,114
546,SAC,2019-11-06,120,@,TOR,L 120-124,240,42,95,.442,22,51,.431,20,44,.455,16,21,.762,120,43,78,.551,29,49,.592,14,29,.483,24,29,.828,124
547,IND,2019-11-05,120,@,CHO,L 120-122 (OT),265,51,94,.543,39,64,.609,12,30,.400,6,7,.857,120,42,88,.477,32,57,.561,10,31,.323,28,42,.667,122
548,LAL,2019-10-29,120,,MEM,W 120-91,240,40,86,.465,33,60,.550,7,26,.269,33,39,.846,120,31,95,.326,24,61,.393,7,34,.206,22,23,.957,91
549,LAL,2019-10-27,120,,CHO,W 120-101,240,49,93,.527,38,62,.613,11,31,.355,11,14,.786,120,35,91,.385,25,56,.446,10,35,.286,21,23,.913,101
550,OKC,2019-10-27,120,,GSW,W 120-92,240,44,78,.564,29,46,.630,15,32,.469,17,22,.773,120,30,92,.326,25,59,.424,5,33,.152,27,31,.871,92
551,MIA,2019-10-23,120,,MEM,W 120-101,240,40,85,.471,33,67,.493,7,18,.389,33,39,.846,120,38,89,.427,33,57,.579,5,32,.156,20,30,.667,101
552,SAS,2019-10-23,120,,NYK,W 120-111,240,42,83,.506,35,62,.565,7,21,.333,29,36,.806,120,44,94,.468,34,64,.531,10,30,.333,13,18,.722,111
553,MEM,2020-08-13,119,,MIL,W 119-106,240,45,90,.500,32,57,.561,13,33,.394,16,23,.696,119,39,98,.398,26,57,.456,13,41,.317,15,23,.652,106
554,ORL,2020-08-09,119,@,BOS,L 119-122 (OT),265,41,102,.402,26,55,.473,15,47,.319,22,26,.846,119,45,102,.441,33,62,.532,12,40,.300,20,24,.833,122
555,PHO,2020-08-08,119,@,MIA,W 119-112,240,44,92,.478,32,60,.533,12,32,.375,19,20,.950,119,41,84,.488,30,48,.625,11,36,.306,19,22,.864,112
556,SAS,2020-08-07,119,,UTA,W 119-111,240,45,89,.506,36,67,.537,9,22,.409,20,26,.769,119,38,91,.418,22,54,.407,16,37,.432,19,24,.792,111
557,BRK,2020-08-07,119,,SAC,W 119-106,240,42,86,.488,25,46,.543,17,40,.425,18,28,.643,119,38,89,.427,26,49,.531,12,40,.300,18,24,.750,106
558,BRK,2020-08-04,119,@,MIL,W 119-116,240,43,103,.417,22,46,.478,21,57,.368,12,16,.750,119,42,88,.477,25,37,.676,17,51,.333,15,23,.652,116
559,MIL,2020-07-31,119,,BOS,W 119-112,240,39,84,.464,26,43,.605,13,41,.317,28,34,.824,119,37,91,.407,26,54,.481,11,37,.297,27,34,.794,112
560,SAS,2020-03-10,119,,DAL,W 119-109,240,46,89,.517,31,57,.544,15,32,.469,12,15,.800,119,42,92,.457,25,48,.521,17,44,.386,8,11,.727,109
561,MIL,2020-03-04,119,,IND,W 119-100,240,43,94,.457,30,48,.625,13,46,.283,20,22,.909,119,42,97,.433,35,70,.500,7,27,.259,9,11,.818,100
562,WAS,2020-02-28,119,@,UTA,L 119-129,240,45,98,.459,31,61,.508,14,37,.378,15,21,.714,119,44,89,.494,25,52,.481,19,37,.514,22,30,.733,129
563,IND,2020-02-25,119,,CHO,W 119-80,240,49,86,.570,39,63,.619,10,23,.435,11,13,.846,119,31,93,.333,21,60,.350,10,33,.303,8,18,.444,80
564,MIA,2020-02-24,119,@,CLE,L 119-125 (OT),265,44,96,.458,28,54,.519,16,42,.381,15,20,.750,119,43,97,.443,29,60,.483,14,37,.378,25,34,.735,125
565,MIL,2020-02-22,119,,PHI,W 119-98,240,48,91,.527,34,50,.680,14,41,.341,9,13,.692,119,35,99,.354,22,61,.361,13,38,.342,15,18,.833,98
566,DAL,2020-02-10,119,,UTA,L 119-123,240,39,83,.470,24,40,.600,15,43,.349,26,31,.839,119,46,78,.590,31,43,.721,15,35,.429,16,21,.762,123
567,TOR,2020-02-08,119,,BRK,W 119-118,240,45,95,.474,31,60,.517,14,35,.400,15,21,.714,119,41,92,.446,25,48,.521,16,44,.364,20,24,.833,118
568,WAS,2020-02-07,119,,DAL,W 119-118,240,45,90,.500,26,52,.500,19,38,.500,10,13,.769,119,42,91,.462,26,51,.510,16,40,.400,18,21,.857,118
569,PHI,2020-02-07,119,,MEM,W 119-107,240,48,90,.533,34,65,.523,14,25,.560,9,15,.600,119,38,93,.409,33,72,.458,5,21,.238,26,31,.839,107
570,CHI,2020-02-06,119,,NOP,L 119-125,240,46,93,.495,33,64,.516,13,29,.448,14,23,.609,119,49,87,.563,33,49,.673,16,38,.421,11,19,.579,125
571,TOR,2020-02-05,119,,IND,W 119-118,240,43,86,.500,31,54,.574,12,32,.375,21,24,.875,119,43,82,.524,24,43,.558,19,39,.487,13,16,.813,118
572,BRK,2020-02-03,119,,PHO,W 119-97,240,43,89,.483,28,55,.509,15,34,.441,18,21,.857,119,39,90,.433,33,73,.452,6,17,.353,13,18,.722,97
573,LAL,2020-01-31,119,,POR,L 119-127,240,45,96,.469,34,64,.531,11,32,.344,18,28,.643,119,49,97,.505,36,61,.590,13,36,.361,16,21,.762,127
574,BOS,2020-01-30,119,,GSW,W 119-104,240,42,88,.477,27,53,.509,15,35,.429,20,22,.909,119,33,77,.429,21,38,.553,12,39,.308,26,30,.867,104
575,BOS,2020-01-22,119,,MEM,W 119-95,240,45,89,.506,31,57,.544,14,32,.438,15,20,.750,119,36,85,.424,25,53,.472,11,32,.344,12,15,.800,95
576,BOS,2020-01-18,119,,PHO,L 119-123,240,42,96,.438,27,54,.500,15,42,.357,20,22,.909,119,42,89,.472,29,58,.500,13,31,.419,26,30,.867,123
577,OKC,2020-01-18,119,,POR,W 119-106,240,43,83,.518,36,61,.590,7,22,.318,26,36,.722,119,39,91,.429,27,59,.458,12,32,.375,16,21,.762,106
578,ORL,2020-01-15,119,@,LAL,W 119-118,240,43,94,.457,33,68,.485,10,26,.385,23,29,.793,119,48,97,.495,33,59,.559,15,38,.395,7,11,.636,118
579,MEM,2020-01-07,119,,MIN,W 119-112,240,46,89,.517,38,61,.623,8,28,.286,19,21,.905,119,40,90,.444,25,43,.581,15,47,.319,17,21,.810,112
580,DEN,2019-12-28,119,,MEM,W 119-110,240,45,93,.484,36,64,.563,9,29,.310,20,27,.741,119,41,84,.488,32,54,.593,9,30,.300,19,25,.760,110
581,BOS,2019-12-22,119,,CHO,W 119-93,240,46,88,.523,32,56,.571,14,32,.438,13,16,.813,119,33,82,.402,23,48,.479,10,34,.294,17,23,.739,93
582,CHI,2019-12-21,119,@,DET,W 119-107,240,40,77,.519,22,42,.524,18,35,.514,21,25,.840,119,40,87,.460,24,52,.462,16,35,.457,11,12,.917,107
583,MEM,2019-12-21,119,,SAC,W 119-115,240,40,83,.482,25,48,.521,15,35,.429,24,29,.828,119,43,100,.430,32,64,.500,11,36,.306,18,24,.750,115
584,IND,2019-12-20,119,,SAC,W 119-105,240,45,86,.523,31,55,.564,14,31,.452,15,18,.833,119,41,91,.451,31,59,.525,10,32,.313,13,15,.867,105
585,DET,2019-12-16,119,,WAS,L 119-133,240,41,86,.477,28,47,.596,13,39,.333,24,34,.706,119,49,88,.557,31,54,.574,18,34,.529,17,21,.810,133
586,NOP,2019-12-15,119,,ORL,L 119-130,240,47,88,.534,28,45,.622,19,43,.442,6,12,.500,119,46,89,.517,29,55,.527,17,34,.500,21,26,.808,130
587,PHO,2019-12-14,119,,SAS,L 119-121 (OT),265,45,103,.437,35,63,.556,10,40,.250,19,26,.731,119,44,106,.415,36,76,.474,8,30,.267,25,34,.735,121
588,SAC,2019-12-09,119,@,HOU,W 119-118,240,40,88,.455,20,43,.465,20,45,.444,19,22,.864,119,41,84,.488,24,34,.706,17,50,.340,19,23,.826,118
589,WAS,2019-12-08,119,,LAC,L 119-135,240,40,88,.455,26,55,.473,14,33,.424,25,30,.833,119,50,96,.521,35,56,.625,15,40,.375,20,27,.741,135
590,MIL,2019-12-06,119,,LAC,W 119-91,240,44,94,.468,30,58,.517,14,36,.389,17,21,.810,119,33,94,.351,25,62,.403,8,32,.250,17,19,.895,91
591,WAS,2019-12-05,119,,PHI,W 119-113,240,41,90,.456,30,63,.476,11,27,.407,26,32,.813,119,41,77,.532,28,49,.571,13,28,.464,18,24,.750,113
592,HOU,2019-12-05,119,@,TOR,W 119-109,240,40,98,.408,18,43,.419,22,55,.400,17,19,.895,119,38,88,.432,26,49,.531,12,39,.308,21,24,.875,109
593,PHI,2019-11-30,119,,IND,W 119-116,240,38,77,.494,27,54,.500,11,23,.478,32,36,.889,119,42,76,.553,31,54,.574,11,22,.500,21,25,.840,116
594,MIL,2019-11-29,119,@,CLE,W 119-110,240,45,88,.511,33,54,.611,12,34,.353,17,23,.739,119,44,88,.500,27,54,.500,17,34,.500,5,10,.500,110
595,MEM,2019-11-27,119,,LAC,L 119-121,240,43,92,.467,32,64,.500,11,28,.393,22,26,.846,119,44,95,.463,30,54,.556,14,41,.341,19,25,.760,121
596,OKC,2019-11-27,119,@,POR,L 119-136,240,39,88,.443,28,53,.528,11,35,.314,30,38,.789,119,49,94,.521,35,64,.547,14,30,.467,24,24,1.000,136
597,TOR,2019-11-23,119,@,ATL,W 119-116,240,40,88,.455,27,51,.529,13,37,.351,26,30,.867,119,47,90,.522,33,56,.589,14,34,.412,8,11,.727,116
598,HOU,2019-11-22,119,@,LAC,L 119-122,240,39,84,.464,24,41,.585,15,43,.349,26,38,.684,119,45,87,.517,32,54,.593,13,33,.394,19,24,.792,122
599,PHI,2019-11-15,119,@,OKC,L 119-127 (OT),265,45,90,.500,31,58,.534,14,32,.438,15,22,.682,119,41,76,.539,31,52,.596,10,24,.417,35,41,.854,127
600,MEM,2019-11-13,119,@,CHO,W 119-117,240,48,89,.539,31,54,.574,17,35,.486,6,9,.667,119,43,87,.494,27,51,.529,16,36,.444,15,19,.789,117
601,UTA,2019-11-12,119,,BRK,W 119-114,240,43,92,.467,37,66,.561,6,26,.231,27,35,.771,119,41,90,.456,30,53,.566,11,37,.297,21,25,.840,114
602,OKC,2019-11-10,119,,MIL,L 119-121,240,45,91,.495,28,49,.571,17,42,.405,12,17,.706,119,47,83,.566,36,55,.655,11,28,.393,16,18,.889,121
603,GSW,2019-11-08,119,@,MIN,L 119-125 (OT),265,43,103,.417,33,68,.485,10,35,.286,23,24,.958,119,48,111,.432,39,75,.520,9,36,.250,20,29,.690,125
604,BRK,2019-11-08,119,@,POR,W 119-115,240,41,99,.414,25,62,.403,16,37,.432,21,30,.700,119,40,97,.412,29,67,.433,11,30,.367,24,25,.960,115
605,BOS,2019-11-05,119,@,CLE,W 119-113,240,48,85,.565,36,55,.655,12,30,.400,11,15,.733,119,40,95,.421,27,62,.435,13,33,.394,20,22,.909,113
606,LAL,2019-11-01,119,@,DAL,W 119-110 (OT),265,47,96,.490,38,64,.594,9,32,.281,16,21,.762,119,40,102,.392,26,66,.394,14,36,.389,16,23,.696,110
607,DAL,2019-10-27,119,,POR,L 119-121,240,37,94,.394,24,44,.545,13,50,.260,32,41,.780,119,45,87,.517,36,65,.554,9,22,.409,22,26,.846,121
608,DET,2019-10-23,119,@,IND,W 119-110,240,41,78,.526,30,54,.556,11,24,.458,26,33,.788,119,41,89,.461,33,68,.485,8,21,.381,20,24,.833,110
609,UTA,2020-08-13,118,,SAS,W 118-112,240,47,101,.465,32,55,.582,15,46,.326,9,10,.900,118,39,79,.494,29,59,.492,10,20,.500,24,36,.667,112
610,NOP,2020-08-07,118,,WAS,W 118-107,240,42,88,.477,30,53,.566,12,35,.343,22,26,.846,118,38,90,.422,28,63,.444,10,27,.370,21,23,.913,107
611,BRK,2020-08-02,118,,WAS,W 118-110,240,38,90,.422,27,57,.474,11,33,.333,31,37,.838,118,40,88,.455,31,57,.544,9,31,.290,21,27,.778,110
612,BRK,2020-07-31,118,,ORL,L 118-128,240,44,91,.484,31,49,.633,13,42,.310,17,23,.739,118,46,87,.529,35,56,.625,11,31,.355,25,28,.893,128
613,TOR,2020-03-08,118,@,SAC,W 118-113,240,39,82,.476,20,34,.588,19,48,.396,21,27,.778,118,42,90,.467,34,59,.576,8,31,.258,21,23,.913,113
614,GSW,2020-03-07,118,,PHI,W 118-114,240,44,80,.550,35,55,.636,9,25,.360,21,28,.750,118,41,84,.488,28,50,.560,13,34,.382,19,22,.864,114
615,MEM,2020-03-07,118,,ATL,W 118-101,240,43,87,.494,31,54,.574,12,33,.364,20,33,.606,118,32,95,.337,19,46,.413,13,49,.265,24,28,.857,101
616,WAS,2020-03-06,118,,ATL,W 118-112,240,36,76,.474,21,45,.467,15,31,.484,31,35,.886,118,46,86,.535,34,54,.630,12,32,.375,8,12,.667,112
617,MIN,2020-03-06,118,,ORL,L 118-132,240,46,98,.469,36,61,.590,10,37,.270,16,20,.800,118,51,84,.607,44,63,.698,7,21,.333,23,31,.742,132
618,MEM,2020-03-04,118,@,BRK,W 118-79,240,43,100,.430,23,56,.411,20,44,.455,12,14,.857,118,30,90,.333,23,48,.479,7,42,.167,12,17,.706,79
619,TOR,2020-03-01,118,@,DEN,L 118-133,240,41,89,.461,31,51,.608,10,38,.263,26,29,.897,118,47,83,.566,29,47,.617,18,36,.500,21,30,.700,133
620,BRK,2020-02-28,118,@,ATL,L 118-141,240,42,92,.457,24,46,.522,18,46,.391,16,21,.762,118,50,97,.515,31,58,.534,19,39,.487,22,30,.733,141
621,DAL,2020-02-28,118,@,MIA,L 118-126,240,40,84,.476,19,34,.559,21,50,.420,17,19,.895,118,41,79,.519,24,44,.545,17,35,.486,27,36,.750,126
622,LAL,2020-02-25,118,,NOP,W 118-109,240,45,102,.441,32,58,.552,13,44,.295,15,21,.714,118,39,86,.453,31,59,.525,8,27,.296,23,30,.767,109
623,BOS,2020-02-25,118,@,POR,W 118-106,240,43,90,.478,24,51,.471,19,39,.487,13,14,.929,118,38,85,.447,25,54,.463,13,31,.419,17,23,.739,106
624,TOR,2020-02-21,118,,PHO,W 118-101,240,42,80,.525,28,43,.651,14,37,.378,20,22,.909,118,38,92,.413,32,58,.552,6,34,.176,19,23,.826,101
625,NOP,2020-02-13,118,,OKC,L 118-123,240,42,86,.488,28,51,.549,14,35,.400,20,27,.741,118,46,92,.500,33,65,.508,13,27,.481,18,22,.818,123
626,IND,2020-02-12,118,,MIL,W 118-111,240,45,86,.523,36,59,.610,9,27,.333,19,24,.792,118,37,91,.407,24,54,.444,13,37,.351,24,25,.960,111
627,PHI,2020-02-09,118,,CHI,W 118-111,240,42,84,.500,31,57,.544,11,27,.407,23,32,.719,118,43,88,.489,31,56,.554,12,32,.375,13,17,.765,111
628,BRK,2020-02-08,118,@,TOR,L 118-119,240,41,92,.446,25,48,.521,16,44,.364,20,24,.833,118,45,95,.474,31,60,.517,14,35,.400,15,21,.714,119
629,DAL,2020-02-07,118,@,WAS,L 118-119,240,42,91,.462,26,51,.510,16,40,.400,18,21,.857,118,45,90,.500,26,52,.500,19,38,.500,10,13,.769,119
630,IND,2020-02-05,118,@,TOR,L 118-119,240,43,82,.524,24,43,.558,19,39,.487,13,16,.813,118,43,86,.500,31,54,.574,12,32,.375,21,24,.875,119
631,LAC,2020-02-01,118,,MIN,W 118-106,240,45,98,.459,33,64,.516,12,34,.353,16,18,.889,118,34,84,.405,27,45,.600,7,39,.179,31,37,.838,106
632,CHI,2020-01-31,118,@,BRK,L 118-133,240,42,86,.488,30,52,.577,12,34,.353,22,26,.846,118,50,80,.625,35,49,.714,15,31,.484,18,25,.720,133
633,CHI,2020-01-25,118,@,CLE,W 118-106,240,44,85,.518,32,52,.615,12,33,.364,18,24,.750,118,42,84,.500,29,54,.537,13,30,.433,9,11,.818,106
634,TOR,2020-01-24,118,@,NYK,W 118-112,240,41,81,.506,24,46,.522,17,35,.486,19,23,.826,118,42,85,.494,29,49,.592,13,36,.361,15,21,.714,112
635,GSW,2020-01-24,118,,IND,L 118-129,240,40,82,.488,21,43,.488,19,39,.487,19,23,.826,118,50,87,.575,33,59,.559,17,28,.607,12,13,.923,129
636,PHO,2020-01-20,118,,SAS,L 118-120,240,42,80,.525,34,58,.586,8,22,.364,26,30,.867,118,43,87,.494,26,56,.464,17,31,.548,17,22,.773,120
637,UTA,2020-01-20,118,,IND,W 118-88,240,47,87,.540,35,56,.625,12,31,.387,12,12,1.000,118,39,93,.419,32,67,.478,7,26,.269,3,7,.429,88
638,MIA,2020-01-20,118,,SAC,W 118-113 (OT),265,42,83,.506,26,41,.634,16,42,.381,18,22,.818,118,44,106,.415,31,55,.564,13,51,.255,12,15,.800,113
639,CHI,2020-01-18,118,,CLE,W 118-116,240,48,87,.552,39,62,.629,9,25,.360,13,17,.765,118,40,73,.548,25,44,.568,15,29,.517,21,23,.913,116
640,LAL,2020-01-15,118,,ORL,L 118-119,240,48,97,.495,33,59,.559,15,38,.395,7,11,.636,118,43,94,.457,33,68,.485,10,26,.385,23,29,.793,119
641,UTA,2020-01-14,118,@,BRK,W 118-107,240,46,92,.500,33,56,.589,13,36,.361,13,15,.867,118,45,90,.500,37,64,.578,8,26,.308,9,15,.600,107
642,DAL,2020-01-06,118,,CHI,W 118-110,240,44,84,.524,28,43,.651,16,41,.390,14,19,.737,118,46,98,.469,37,67,.552,9,31,.290,9,11,.818,110
643,MIN,2020-01-05,118,@,CLE,W 118-103,240,47,95,.495,33,57,.579,14,38,.368,10,13,.769,118,40,84,.476,32,59,.542,8,25,.320,15,19,.789,103
644,SAS,2020-01-04,118,@,MIL,L 118-127,240,38,92,.413,27,60,.450,11,32,.344,31,34,.912,118,43,87,.494,26,42,.619,17,45,.378,24,33,.727,127
645,HOU,2020-01-03,118,,PHI,W 118-108,240,41,86,.477,29,54,.537,12,32,.375,24,32,.750,118,42,92,.457,36,65,.554,6,27,.222,18,25,.720,108
646,BOS,2019-12-25,118,@,TOR,W 118-102,240,46,92,.500,32,59,.542,14,33,.424,12,14,.857,118,38,80,.475,30,57,.526,8,23,.348,18,22,.818,102
647,ATL,2019-12-23,118,@,CLE,L 118-121,240,45,95,.474,30,53,.566,15,42,.357,13,17,.765,118,50,96,.521,39,67,.582,11,29,.379,10,12,.833,121
648,OKC,2019-12-22,118,,LAC,W 118-112,240,46,97,.474,37,70,.529,9,27,.333,17,20,.850,118,40,86,.465,29,59,.492,11,27,.407,21,24,.875,112
649,WAS,2019-12-20,118,@,TOR,L 118-122,240,40,87,.460,26,48,.542,14,39,.359,24,32,.750,118,38,78,.487,26,48,.542,12,30,.400,34,44,.773,122
650,POR,2019-12-20,118,,ORL,W 118-103,240,42,84,.500,25,48,.521,17,36,.472,17,19,.895,118,39,106,.368,32,78,.410,7,28,.250,18,26,.692,103
651,SAS,2019-12-19,118,,BRK,W 118-105,240,43,96,.448,30,63,.476,13,33,.394,19,23,.826,118,35,83,.422,28,47,.596,7,36,.194,28,30,.933,105
652,MEM,2019-12-16,118,,MIA,W 118-111,240,42,86,.488,29,50,.580,13,36,.361,21,30,.700,118,37,81,.457,26,57,.456,11,24,.458,26,31,.839,111
653,DAL,2019-12-14,118,,MIA,L 118-122 (OT),265,45,101,.446,28,57,.491,17,44,.386,11,17,.647,118,39,91,.429,23,51,.451,16,40,.400,28,34,.824,122
654,HOU,2019-12-09,118,,SAC,L 118-119,240,41,84,.488,24,34,.706,17,50,.340,19,23,.826,118,40,88,.455,20,43,.465,20,45,.444,19,22,.864,119
655,ATL,2019-12-04,118,,BRK,L 118-130,240,48,90,.533,39,64,.609,9,26,.346,13,21,.619,118,50,101,.495,36,70,.514,14,31,.452,16,18,.889,130
656,DAL,2019-12-03,118,@,NOP,W 118-97,240,38,88,.432,19,43,.442,19,45,.422,23,27,.852,118,38,94,.404,27,53,.509,11,41,.268,10,15,.667,97
657,UTA,2019-11-25,118,@,MIL,L 118-122,240,43,85,.506,22,40,.550,21,45,.467,11,12,.917,118,43,97,.443,30,56,.536,13,41,.317,23,29,.793,122
658,CHO,2019-11-22,118,@,WAS,L 118-125,240,48,93,.516,34,59,.576,14,34,.412,8,8,1.000,118,48,91,.527,34,57,.596,14,34,.412,15,20,.750,125
659,ORL,2019-11-08,118,,MEM,W 118-86,240,44,93,.473,37,65,.569,7,28,.250,23,27,.852,118,32,86,.372,21,57,.368,11,29,.379,11,13,.846,86
660,LAL,2019-11-05,118,@,CHI,W 118-112,240,45,92,.489,34,59,.576,11,33,.333,17,24,.708,118,43,85,.506,29,53,.547,14,32,.438,12,23,.522,112
661,POR,2019-11-04,118,@,GSW,L 118-127,240,47,105,.448,34,65,.523,13,40,.325,11,14,.786,118,42,86,.488,32,60,.533,10,26,.385,33,36,.917,127
662,IND,2019-10-30,118,@,BRK,W 118-108,240,45,96,.469,34,70,.486,11,26,.423,17,20,.850,118,41,93,.441,31,62,.500,10,31,.323,16,26,.615,108
663,CHO,2019-10-30,118,@,SAC,W 118-111,240,46,84,.548,30,52,.577,16,32,.500,10,14,.714,118,44,96,.458,30,50,.600,14,46,.304,9,12,.750,111
664,BOS,2019-10-26,118,@,NYK,W 118-95,240,42,93,.452,27,52,.519,15,41,.366,19,29,.655,118,31,82,.378,24,55,.436,7,27,.259,26,34,.765,95
665,TOR,2020-08-14,117,,DEN,W 117-109,240,45,90,.500,27,55,.491,18,35,.514,9,14,.643,117,36,87,.414,20,49,.408,16,38,.421,21,23,.913,109
666,PHI,2020-08-11,117,,PHO,L 117-130,240,46,93,.495,31,60,.517,15,33,.455,10,14,.714,117,49,89,.551,37,61,.607,12,28,.429,20,21,.952,130
667,POR,2020-08-08,117,,LAC,L 117-122,240,44,90,.489,27,47,.574,17,43,.395,12,17,.706,117,42,85,.494,27,51,.529,15,34,.441,23,28,.821,122
668,PHO,2020-08-04,117,@,LAC,W 117-115,240,45,96,.469,28,64,.438,17,32,.531,10,14,.714,117,42,85,.494,34,56,.607,8,29,.276,23,27,.852,115
669,PHO,2020-08-02,117,,DAL,W 117-115,240,42,93,.452,30,60,.500,12,33,.364,21,23,.913,117,38,93,.409,32,62,.516,6,31,.194,33,37,.892,115
670,HOU,2020-03-10,117,,MIN,W 117-111,240,41,80,.513,26,42,.619,15,38,.395,20,26,.769,117,40,83,.482,26,48,.542,14,35,.400,17,23,.739,111
671,POR,2020-03-06,117,@,PHO,L 117-127,240,43,87,.494,30,55,.545,13,32,.406,18,24,.750,117,45,91,.495,26,49,.531,19,42,.452,18,19,.947,127
672,POR,2020-02-29,117,@,ATL,L 117-129,240,47,94,.500,39,66,.591,8,28,.286,15,21,.714,117,46,84,.548,28,42,.667,18,42,.429,19,22,.864,129
673,WAS,2020-02-23,117,@,CHI,L 117-126,240,37,73,.507,25,43,.581,12,30,.400,31,36,.861,117,45,81,.556,27,44,.614,18,37,.486,18,28,.643,126
674,LAL,2020-02-21,117,,MEM,W 117-105,240,41,86,.477,32,57,.561,9,29,.310,26,40,.650,117,42,92,.457,37,77,.481,5,15,.333,16,31,.516,105
675,MIN,2020-02-21,117,,BOS,L 117-127,240,36,89,.404,21,47,.447,15,42,.357,30,35,.857,117,44,95,.463,34,66,.515,10,29,.345,29,37,.784,127
676,POR,2020-02-11,117,@,NOP,L 117-138,240,44,93,.473,37,64,.578,7,29,.241,22,28,.786,117,49,92,.533,35,58,.603,14,34,.412,26,32,.813,138
677,IND,2020-02-08,117,,NOP,L 117-124,240,44,83,.530,35,57,.614,9,26,.346,20,27,.741,117,44,95,.463,29,57,.509,15,38,.395,21,25,.840,124
678,DEN,2020-02-08,117,@,PHO,W 117-108,240,45,82,.549,34,54,.630,11,28,.393,16,21,.762,117,38,87,.437,29,55,.527,9,32,.281,23,23,1.000,108
679,UTA,2020-02-07,117,,POR,W 117-114,240,45,91,.495,35,61,.574,10,30,.333,17,24,.708,117,44,97,.454,27,57,.474,17,40,.425,9,14,.643,114
680,SAS,2020-02-06,117,@,POR,L 117-125,240,41,92,.446,31,64,.484,10,28,.357,25,28,.893,117,49,92,.533,31,55,.564,18,37,.486,9,12,.750,125
681,WAS,2020-02-03,117,,GSW,L 117-125,240,42,83,.506,33,61,.541,9,22,.409,24,29,.828,117,43,87,.494,28,57,.491,15,30,.500,24,31,.774,125
682,HOU,2020-02-02,117,,NOP,W 117-109,240,41,105,.390,25,54,.463,16,51,.314,19,22,.864,117,42,94,.447,32,61,.525,10,33,.303,15,20,.750,109
683,PHI,2020-01-30,117,@,ATL,L 117-127,240,38,82,.463,29,51,.569,9,31,.290,32,45,.711,117,42,87,.483,31,52,.596,11,35,.314,32,37,.865,127
684,UTA,2020-01-27,117,,HOU,L 117-126,240,43,85,.506,31,43,.721,12,42,.286,19,26,.731,117,38,81,.469,23,41,.561,15,40,.375,35,49,.714,126
685,DEN,2020-01-26,117,,HOU,W 117-110,240,44,93,.473,33,65,.508,11,28,.393,18,20,.900,117,40,88,.455,29,55,.527,11,33,.333,19,27,.704,110
686,MIA,2020-01-24,117,,LAC,L 117-122,240,40,93,.430,27,49,.551,13,44,.295,24,29,.828,117,43,94,.457,27,59,.458,16,35,.457,20,23,.870,122
687,CHI,2020-01-22,117,,MIN,W 117-110,240,39,84,.464,30,54,.556,9,30,.300,30,37,.811,117,41,86,.477,26,42,.619,15,44,.341,13,24,.542,110
688,NOP,2020-01-22,117,,SAS,L 117-121,240,39,84,.464,25,48,.521,14,36,.389,25,32,.781,117,45,89,.506,34,62,.548,11,27,.407,20,25,.800,121
689,ATL,2020-01-20,117,,TOR,L 117-122,240,41,83,.494,29,50,.580,12,33,.364,23,33,.697,117,38,92,.413,25,50,.500,13,42,.310,33,43,.767,122
690,PHI,2020-01-20,117,@,BRK,W 117-111,240,42,94,.447,29,55,.527,13,39,.333,20,27,.741,117,39,81,.481,28,52,.538,11,29,.379,22,34,.647,111
691,MIL,2020-01-18,117,@,BRK,W 117-97,240,45,89,.506,28,52,.538,17,37,.459,10,16,.625,117,33,99,.333,18,50,.360,15,49,.306,16,17,.941,97
692,POR,2020-01-15,117,@,HOU,W 117-107,240,41,95,.432,30,59,.508,11,36,.306,24,29,.828,117,38,96,.396,22,47,.468,16,49,.327,15,23,.652,107
693,PHI,2020-01-15,117,,BRK,W 117-106,240,45,88,.511,34,58,.586,11,30,.367,16,25,.640,117,38,87,.437,26,62,.419,12,25,.480,18,30,.600,106
694,NOP,2020-01-13,117,@,DET,W 117-110 (OT),265,43,103,.417,34,77,.442,9,26,.346,22,27,.815,117,40,99,.404,29,67,.433,11,32,.344,19,24,.792,110
695,OKC,2020-01-13,117,@,MIN,W 117-104,240,41,82,.500,29,52,.558,12,30,.400,23,26,.885,117,38,91,.418,26,56,.464,12,35,.343,16,21,.762,104
696,BRK,2020-01-10,117,,MIA,W 117-113,240,45,93,.484,30,49,.612,15,44,.341,12,19,.632,117,44,85,.518,37,56,.661,7,29,.241,18,21,.857,113
697,LAL,2020-01-07,117,,NYK,W 117-87,240,41,82,.500,24,46,.522,17,36,.472,18,21,.857,117,37,95,.389,33,75,.440,4,20,.200,9,16,.563,87
698,NOP,2020-01-04,117,@,SAC,W 117-115,240,38,87,.437,22,42,.524,16,45,.356,25,33,.758,117,38,85,.447,26,64,.406,12,21,.571,27,36,.750,115
699,LAL,2020-01-01,117,,PHO,W 117-107,240,43,90,.478,36,62,.581,7,28,.250,24,34,.706,117,42,86,.488,36,63,.571,6,23,.261,17,23,.739,107
700,NYK,2020-01-01,117,,POR,W 117-93,240,47,98,.480,33,62,.532,14,36,.389,9,14,.643,117,37,94,.394,27,62,.435,10,32,.313,9,15,.600,93
701,TOR,2019-12-31,117,,CLE,W 117-97,240,40,84,.476,23,45,.511,17,39,.436,20,25,.800,117,37,87,.425,27,49,.551,10,38,.263,13,16,.813,97
702,SAS,2019-12-31,117,,GSW,W 117-113 (OT),265,45,96,.469,31,65,.477,14,31,.452,13,17,.765,117,44,96,.458,32,69,.464,12,27,.444,13,18,.722,113
703,MEM,2019-12-29,117,,CHO,W 117-104,240,45,93,.484,35,58,.603,10,35,.286,17,17,1.000,117,37,86,.430,28,55,.509,9,31,.290,21,32,.656,104
704,MIA,2019-12-28,117,,PHI,W 117-116 (OT),265,42,94,.447,32,66,.485,10,28,.357,23,29,.793,117,42,89,.472,32,59,.542,10,30,.333,22,29,.759,116
705,CLE,2019-12-27,117,@,BOS,L 117-129,240,44,85,.518,35,62,.565,9,23,.391,20,29,.690,117,49,95,.516,35,55,.636,14,40,.350,17,19,.895,129
706,MIL,2019-12-22,117,,IND,W 117-89,240,44,104,.423,29,60,.483,15,44,.341,14,17,.824,117,37,100,.370,25,60,.417,12,40,.300,3,5,.600,89
707,DAL,2019-12-20,117,@,PHI,W 117-98,240,43,83,.518,29,50,.580,14,33,.424,17,22,.773,117,38,90,.422,28,56,.500,10,34,.294,12,18,.667,98
708,LAC,2019-12-19,117,,HOU,L 117-122,240,43,86,.500,27,49,.551,16,37,.432,15,19,.789,117,43,86,.500,29,49,.592,14,37,.378,22,29,.759,122
709,MIN,2019-12-13,117,,LAC,L 117-124,240,38,85,.447,28,44,.636,10,41,.244,31,37,.838,117,39,79,.494,28,54,.519,11,25,.440,35,39,.897,124
710,CLE,2019-12-12,117,@,SAS,W 117-109 (OT),265,44,96,.458,29,51,.569,15,45,.333,14,20,.700,117,42,86,.488,37,70,.529,5,16,.313,20,25,.800,109
711,BOS,2019-12-11,117,@,IND,L 117-122,240,43,87,.494,29,51,.569,14,36,.389,17,22,.773,117,41,85,.482,31,60,.517,10,25,.400,30,36,.833,122
712,LAC,2019-12-03,117,,POR,W 117-97,240,43,94,.457,26,60,.433,17,34,.500,14,25,.560,117,39,91,.429,32,64,.500,7,27,.259,12,15,.800,97
713,IND,2019-12-02,117,@,MEM,W 117-104,240,44,88,.500,28,50,.560,16,38,.421,13,15,.867,117,38,89,.427,28,51,.549,10,38,.263,18,19,.947,104
714,HOU,2019-11-27,117,,MIA,W 117-108,240,38,83,.458,23,39,.590,15,44,.341,26,33,.788,117,37,80,.463,23,43,.535,14,37,.378,20,27,.741,108
715,DEN,2019-11-26,117,,WAS,W 117-104,240,47,90,.522,41,66,.621,6,24,.250,17,23,.739,117,40,95,.421,30,55,.545,10,40,.250,14,21,.667,104
716,POR,2019-11-25,117,@,CHI,W 117-94,240,46,89,.517,38,62,.613,8,27,.296,17,22,.773,117,36,86,.419,27,47,.574,9,39,.231,13,20,.650,94
717,MIA,2019-11-25,117,,CHO,W 117-100,240,40,77,.519,27,46,.587,13,31,.419,24,28,.857,117,36,87,.414,27,54,.500,9,33,.273,19,25,.760,100
718,DAL,2019-11-18,117,,SAS,W 117-110,240,42,84,.500,25,43,.581,17,41,.415,16,23,.696,117,44,96,.458,36,72,.500,8,24,.333,14,16,.875,110
719,BRK,2019-11-16,117,@,CHI,W 117-111,240,40,88,.455,30,45,.667,10,43,.233,27,31,.871,117,32,91,.352,23,52,.442,9,39,.231,38,41,.927,111
720,CHO,2019-11-13,117,,MEM,L 117-119,240,43,87,.494,27,51,.529,16,36,.444,15,19,.789,117,48,89,.539,31,54,.574,17,35,.486,6,9,.667,119
721,MIA,2019-11-12,117,,DET,W 117-108,240,41,77,.532,27,45,.600,14,32,.438,21,27,.778,117,34,78,.436,19,37,.514,15,41,.366,25,37,.676,108
722,HOU,2019-11-09,117,@,CHI,W 117-94,240,39,83,.470,20,39,.513,19,44,.432,20,28,.714,117,37,98,.378,33,66,.500,4,32,.125,16,18,.889,94
723,CLE,2019-10-30,117,,CHI,W 117-111,240,41,78,.526,31,54,.574,10,24,.417,25,31,.806,117,39,90,.433,25,51,.490,14,39,.359,19,23,.826,111
724,PHI,2019-10-30,117,,MIN,W 117-95,240,43,92,.467,34,67,.507,9,25,.360,22,28,.786,117,32,81,.395,22,46,.478,10,35,.286,21,28,.750,95
725,PHI,2019-10-26,117,@,DET,W 117-111,240,42,87,.483,29,53,.547,13,34,.382,20,30,.667,117,41,76,.539,33,57,.579,8,19,.421,21,36,.583,111
726,MIL,2019-10-24,117,@,HOU,W 117-111,240,46,99,.465,30,53,.566,16,46,.348,9,18,.500,117,33,90,.367,17,42,.405,16,48,.333,29,39,.744,111
727,ATL,2019-10-24,117,@,DET,W 117-100,240,44,86,.512,33,55,.600,11,31,.355,18,21,.857,117,35,85,.412,25,48,.521,10,37,.270,20,22,.909,100
728,OKC,2020-08-12,116,,MIA,W 116-115,240,39,89,.438,23,47,.489,16,42,.381,22,27,.815,116,42,86,.488,28,44,.636,14,42,.333,17,20,.850,115
729,IND,2020-08-08,116,,LAL,W 116-111,240,44,84,.524,29,51,.569,15,33,.455,13,14,.929,116,42,100,.420,29,61,.475,13,39,.333,14,19,.737,111
730,MIA,2020-08-06,116,@,MIL,L 116-130,240,35,83,.422,14,37,.378,21,46,.457,25,27,.926,116,41,78,.526,26,41,.634,15,37,.405,33,38,.868,130
731,MIL,2020-08-04,116,,BRK,L 116-119,240,42,88,.477,25,37,.676,17,51,.333,15,23,.652,116,43,103,.417,22,46,.478,21,57,.368,12,16,.750,119
732,LAL,2020-08-03,116,@,UTA,W 116-108,240,41,82,.500,32,56,.571,9,26,.346,25,31,.806,116,37,83,.446,25,40,.625,12,43,.279,22,25,.880,108
733,SAC,2020-08-02,116,@,ORL,L 116-132,240,45,91,.495,37,63,.587,8,28,.286,18,22,.818,116,43,82,.524,25,44,.568,18,38,.474,28,35,.800,132
734,MIL,2020-08-02,116,@,HOU,L 116-120,240,45,92,.489,36,57,.632,9,35,.257,17,23,.739,116,36,91,.396,15,30,.500,21,61,.344,27,31,.871,120
735,MIA,2020-03-04,116,,ORL,W 116-113,240,41,79,.519,19,35,.543,22,44,.500,12,15,.800,116,44,84,.524,31,54,.574,13,30,.433,12,14,.857,113
736,GSW,2020-03-03,116,@,DEN,W 116-100,240,42,82,.512,24,41,.585,18,41,.439,14,22,.636,116,39,87,.448,36,67,.537,3,20,.150,19,26,.731,100
737,IND,2020-03-02,116,@,SAS,W 116-111,240,39,78,.500,24,47,.511,15,31,.484,23,26,.885,116,40,77,.519,24,45,.533,16,32,.500,15,19,.789,111
738,MIA,2020-02-29,116,,BRK,W 116-113,240,41,91,.451,27,53,.509,14,38,.368,20,24,.833,116,40,86,.465,24,42,.571,16,44,.364,17,23,.739,113
739,NOP,2020-02-28,116,,CLE,W 116-104,240,48,88,.545,39,65,.600,9,23,.391,11,15,.733,116,43,95,.453,32,64,.500,11,31,.355,7,12,.583,104
740,LAL,2020-02-27,116,@,GSW,W 116-86,240,45,88,.511,37,64,.578,8,24,.333,18,27,.667,116,34,80,.425,25,48,.521,9,32,.281,9,10,.900,86
741,MIN,2020-02-23,116,@,DEN,L 116-128,240,40,90,.444,26,50,.520,14,40,.350,22,29,.759,116,53,90,.589,42,60,.700,11,30,.367,11,17,.647,128
742,DEN,2020-02-12,116,,LAL,L 116-120 (OT),265,44,88,.500,33,63,.524,11,25,.440,17,22,.773,116,47,93,.505,35,60,.583,12,33,.364,14,27,.519,120
743,UTA,2020-02-12,116,,MIA,W 116-101,240,41,85,.482,27,49,.551,14,36,.389,20,23,.870,116,38,88,.432,25,49,.510,13,39,.333,12,16,.750,101
744,ORL,2020-02-12,116,,DET,W 116-112 (OT),265,44,96,.458,32,60,.533,12,36,.333,16,18,.889,116,40,92,.435,22,47,.468,18,45,.400,14,15,.933,112
745,HOU,2020-02-11,116,,BOS,W 116-105,240,33,77,.429,20,32,.625,13,45,.289,37,42,.881,116,37,85,.435,26,53,.491,11,32,.344,20,25,.800,105
746,DAL,2020-02-08,116,@,CHO,W 116-100,240,44,87,.506,27,52,.519,17,35,.486,11,11,1.000,116,38,87,.437,27,51,.529,11,36,.306,13,18,.722,100
747,DET,2020-02-05,116,,PHO,W 116-108,240,46,95,.484,34,67,.507,12,28,.429,12,16,.750,116,42,77,.545,30,51,.588,12,26,.462,12,15,.800,108
748,BOS,2020-02-05,116,,ORL,W 116-100,240,46,86,.535,33,63,.524,13,23,.565,11,16,.688,116,32,75,.427,19,44,.432,13,31,.419,23,30,.767,100
749,BOS,2020-02-01,116,,PHI,W 116-95,240,38,80,.475,30,50,.600,8,30,.267,32,41,.780,116,31,84,.369,24,51,.471,7,33,.212,26,31,.839,95
750,MIL,2020-01-24,116,@,CHO,W 116-103,240,44,87,.506,34,51,.667,10,36,.278,18,24,.750,116,32,86,.372,18,47,.383,14,39,.359,25,30,.833,103
751,MEM,2020-01-20,116,,NOP,L 116-126,240,46,103,.447,37,70,.529,9,33,.273,15,21,.714,116,42,88,.477,21,40,.525,21,48,.438,21,24,.875,126
752,CLE,2020-01-18,116,@,CHI,L 116-118,240,40,73,.548,25,44,.568,15,29,.517,21,23,.913,116,48,87,.552,39,62,.629,9,25,.360,13,17,.765,118
753,IND,2020-01-17,116,,MIN,W 116-114,240,46,82,.561,38,58,.655,8,24,.333,16,20,.800,116,40,88,.455,23,49,.469,17,39,.436,17,21,.810,114
754,DET,2020-01-15,116,@,BOS,W 116-103,240,47,78,.603,35,46,.761,12,32,.375,10,19,.526,116,41,83,.494,32,55,.582,9,28,.321,12,20,.600,103
755,WAS,2020-01-12,116,,UTA,L 116-127,240,47,93,.505,40,71,.563,7,22,.318,15,17,.882,116,48,90,.533,38,60,.633,10,30,.333,21,25,.840,127
756,IND,2020-01-10,116,@,CHI,W 116-105,240,48,84,.571,37,54,.685,11,30,.367,9,14,.643,116,37,80,.463,19,39,.487,18,41,.439,13,16,.813,105
757,MIN,2020-01-09,116,,POR,W 116-102,240,44,89,.494,31,57,.544,13,32,.406,15,21,.714,116,35,96,.365,24,59,.407,11,37,.297,21,31,.677,102
758,ATL,2020-01-04,116,,IND,W 116-111,240,42,82,.512,32,50,.640,10,32,.313,22,24,.917,116,36,87,.414,26,60,.433,10,27,.370,29,35,.829,111
759,IND,2020-01-02,116,,DEN,L 116-124,240,43,82,.524,31,56,.554,12,26,.462,18,25,.720,116,46,87,.529,38,60,.633,8,27,.296,24,27,.889,124
760,POR,2019-12-30,116,,PHO,L 116-122,240,44,96,.458,30,62,.484,14,34,.412,14,18,.778,116,44,92,.478,31,69,.449,13,23,.565,21,22,.955,122
761,PHI,2019-12-28,116,@,MIA,L 116-117 (OT),265,42,89,.472,32,59,.542,10,30,.333,22,29,.759,116,42,94,.447,32,66,.485,10,28,.357,23,29,.793,117
762,CHI,2019-12-28,116,,ATL,W 116-81,240,43,87,.494,28,56,.500,15,31,.484,15,19,.789,116,32,86,.372,23,52,.442,9,34,.265,8,11,.727,81
763,GSW,2019-12-25,116,,HOU,W 116-104,240,41,87,.471,32,59,.542,9,28,.321,25,28,.893,116,37,100,.370,21,49,.429,16,51,.314,14,16,.875,104
764,MIL,2019-12-16,116,,DAL,L 116-120,240,44,105,.419,33,64,.516,11,41,.268,17,24,.708,116,41,88,.466,25,47,.532,16,41,.390,22,27,.815,120
765,PHI,2019-12-13,116,,NOP,W 116-109,240,43,87,.494,36,67,.537,7,20,.350,23,34,.676,116,38,88,.432,29,64,.453,9,24,.375,24,35,.686,109
766,MIN,2019-12-11,116,,UTA,L 116-127,240,40,91,.440,25,50,.500,15,41,.366,21,26,.808,116,47,83,.566,31,48,.646,16,35,.457,17,22,.773,127
767,HOU,2019-12-11,116,@,CLE,W 116-110,240,43,87,.494,26,45,.578,17,42,.405,13,13,1.000,116,46,89,.517,33,57,.579,13,32,.406,5,8,.625,110
768,SAC,2019-12-04,116,@,POR,L 116-127,240,44,95,.463,33,61,.541,11,34,.324,17,23,.739,116,47,84,.560,31,52,.596,16,32,.500,17,21,.810,127
769,IND,2019-11-30,116,@,PHI,L 116-119,240,42,76,.553,31,54,.574,11,22,.500,21,25,.840,116,38,77,.494,27,54,.500,11,23,.478,32,36,.889,119
770,ORL,2019-11-27,116,@,CLE,W 116-104,240,45,93,.484,33,60,.550,12,33,.364,14,17,.824,116,37,81,.457,26,47,.553,11,34,.324,19,22,.864,104
771,DEN,2019-11-24,116,,PHO,W 116-104,240,43,91,.473,29,60,.483,14,31,.452,16,23,.696,116,41,82,.500,29,47,.617,12,35,.343,10,12,.833,104
772,CHI,2019-11-23,116,@,CHO,W 116-115,240,43,95,.453,21,48,.438,22,47,.468,8,12,.667,116,44,80,.550,32,52,.615,12,28,.429,15,22,.682,115
773,ATL,2019-11-23,116,,TOR,L 116-119,240,47,90,.522,33,56,.589,14,34,.412,8,11,.727,116,40,88,.455,27,51,.529,13,37,.351,26,30,.867,119
774,MIA,2019-11-22,116,@,CHI,W 116-108,240,39,79,.494,25,41,.610,14,38,.368,24,28,.857,116,41,90,.456,31,60,.517,10,30,.333,16,20,.800,108
775,BRK,2019-11-22,116,,SAC,W 116-97,240,41,81,.506,29,47,.617,12,34,.353,22,31,.710,116,39,86,.453,35,60,.583,4,26,.154,15,19,.789,97
776,PHO,2019-11-19,116,@,SAC,L 116-120,240,38,89,.427,26,53,.491,12,36,.333,28,34,.824,116,42,79,.532,29,48,.604,13,31,.419,23,25,.920,120
777,SAS,2019-11-16,116,,POR,L 116-121,240,41,88,.466,36,70,.514,5,18,.278,29,34,.853,116,42,93,.452,29,54,.537,13,39,.333,24,26,.923,121
778,MIN,2019-11-15,116,,WAS,L 116-137,240,42,89,.472,31,52,.596,11,37,.297,21,29,.724,116,54,100,.540,44,72,.611,10,28,.357,19,25,.760,137
779,BOS,2019-11-11,116,,DAL,W 116-106,240,41,86,.477,26,51,.510,15,35,.429,19,25,.760,116,37,89,.416,26,47,.553,11,42,.262,21,28,.750,106
780,NOP,2019-11-11,116,,HOU,L 116-122,240,41,95,.432,27,50,.540,14,45,.311,20,27,.741,116,44,85,.518,32,44,.727,12,41,.293,22,32,.688,122
781,HOU,2019-11-01,116,@,BRK,L 116-123,240,41,99,.414,29,51,.569,12,48,.250,22,27,.815,116,42,85,.494,23,53,.434,19,32,.594,20,28,.714,123
782,BOS,2019-10-30,116,,MIL,W 116-105,240,41,92,.446,24,51,.471,17,41,.415,17,21,.810,116,38,82,.463,24,37,.649,14,45,.311,15,24,.625,105
783,HOU,2019-10-28,116,,OKC,W 116-112,240,39,90,.433,29,46,.630,10,44,.227,28,33,.848,116,41,94,.436,28,59,.475,13,35,.371,17,24,.708,112
784,MIN,2019-10-27,116,,MIA,W 116-109,240,39,91,.429,26,46,.565,13,45,.289,25,33,.758,116,42,85,.494,27,49,.551,15,36,.417,10,15,.667,109
785,NOP,2019-10-25,116,,DAL,L 116-123,240,45,98,.459,30,57,.526,15,41,.366,11,15,.733,116,45,93,.484,31,53,.585,14,40,.350,19,26,.731,123
786,MIA,2020-08-12,115,@,OKC,L 115-116,240,42,86,.488,28,44,.636,14,42,.333,17,20,.850,115,39,89,.438,23,47,.489,16,42,.381,22,27,.815,116
787,DEN,2020-08-06,115,,POR,L 115-125,240,44,84,.524,30,56,.536,14,28,.500,13,17,.765,115,43,92,.467,20,53,.377,23,39,.590,16,20,.800,125
788,BRK,2020-08-05,115,@,BOS,L 115-149,240,45,95,.474,37,63,.587,8,32,.250,17,21,.810,115,50,88,.568,30,49,.612,20,39,.513,29,35,.829,149
789,MEM,2020-08-05,115,@,UTA,L 115-124,240,43,91,.473,32,62,.516,11,29,.379,18,25,.720,115,38,84,.452,20,39,.513,18,45,.400,30,33,.909,124
790,LAC,2020-08-04,115,,PHO,L 115-117,240,42,85,.494,34,56,.607,8,29,.276,23,27,.852,115,45,96,.469,28,64,.438,17,32,.531,10,14,.714,117
791,DAL,2020-08-02,115,@,PHO,L 115-117,240,38,93,.409,32,62,.516,6,31,.194,33,37,.892,115,42,93,.452,30,60,.500,12,33,.364,21,23,.913,117
792,MEM,2020-03-10,115,,ORL,L 115-120,240,38,76,.500,27,47,.574,11,29,.379,28,38,.737,115,43,92,.467,29,59,.492,14,33,.424,20,22,.909,120
793,NYK,2020-03-10,115,@,WAS,L 115-122,240,42,81,.519,34,60,.567,8,21,.381,23,31,.742,115,35,74,.473,21,39,.538,14,35,.400,38,45,.844,122
794,MIN,2020-03-04,115,,CHI,W 115-108,240,40,81,.494,21,38,.553,19,43,.442,16,25,.640,115,45,94,.479,34,64,.531,11,30,.367,7,11,.636,108
795,CHI,2020-02-29,115,@,NYK,L 115-125,240,41,89,.461,24,54,.444,17,35,.486,16,23,.696,115,47,85,.553,39,65,.600,8,20,.400,23,33,.697,125
796,GSW,2020-02-29,115,@,PHO,W 115-99,240,41,87,.471,32,57,.561,9,30,.300,24,32,.750,115,34,83,.410,22,54,.407,12,29,.414,19,23,.826,99
797,PHI,2020-02-27,115,,NYK,W 115-106,240,45,91,.495,30,60,.500,15,31,.484,10,13,.769,115,42,83,.506,34,60,.567,8,23,.348,14,24,.583,106
798,DEN,2020-02-25,115,,DET,W 115-98,240,44,76,.579,35,57,.614,9,19,.474,18,22,.818,115,33,81,.407,18,40,.450,15,41,.366,17,21,.810,98
799,ORL,2020-02-24,115,@,BRK,W 115-113,240,44,89,.494,31,55,.564,13,34,.382,14,17,.824,115,46,96,.479,30,59,.508,16,37,.432,5,8,.625,113
800,NOP,2020-02-23,115,@,GSW,W 115-101,240,46,98,.469,29,56,.518,17,42,.405,6,13,.462,115,40,92,.435,29,57,.509,11,35,.314,10,15,.667,101
801,BRK,2020-02-22,115,@,CHO,W 115-86,240,42,87,.483,25,40,.625,17,47,.362,14,19,.737,115,31,88,.352,19,53,.358,12,35,.343,12,21,.571,86
802,POR,2020-02-21,115,,NOP,L 115-128,240,43,94,.457,33,67,.493,10,27,.370,19,25,.760,115,45,84,.536,27,50,.540,18,34,.529,20,33,.606,128
803,CHO,2020-02-12,115,@,MIN,W 115-108,240,43,92,.467,29,58,.500,14,34,.412,15,23,.652,115,39,101,.386,25,52,.481,14,49,.286,16,20,.800,108
804,POR,2020-02-09,115,,MIA,W 115-109,240,40,85,.471,21,43,.488,19,42,.452,16,22,.727,115,39,98,.398,19,49,.388,20,49,.408,11,14,.786,109
805,LAC,2020-02-08,115,@,MIN,L 115-142,240,41,86,.477,32,60,.533,9,26,.346,24,29,.828,115,52,95,.547,26,51,.510,26,44,.591,12,18,.667,142
806,TOR,2020-02-07,115,@,IND,W 115-106,240,42,88,.477,25,50,.500,17,38,.447,14,17,.824,115,39,86,.453,29,52,.558,10,34,.294,18,22,.818,106
807,ATL,2020-02-03,115,,BOS,L 115-123,240,42,84,.500,30,54,.556,12,30,.400,19,21,.905,115,48,90,.533,36,61,.590,12,29,.414,15,17,.882,123
808,MIL,2020-01-31,115,,DEN,L 115-127,240,43,95,.453,31,55,.564,12,40,.300,17,26,.654,115,48,100,.480,26,54,.481,22,46,.478,9,9,1.000,127
809,TOR,2020-01-30,115,@,CLE,W 115-109,240,41,84,.488,29,52,.558,12,32,.375,21,28,.750,115,42,90,.467,29,54,.537,13,36,.361,12,14,.857,109
810,IND,2020-01-29,115,,CHI,W 115-106 (OT),265,46,89,.517,39,62,.629,7,27,.259,16,22,.727,115,45,85,.529,39,52,.750,6,33,.182,10,15,.667,106
811,DET,2020-01-29,115,@,BRK,L 115-125,240,42,83,.506,32,57,.561,10,26,.385,21,28,.750,115,43,85,.506,28,46,.609,15,39,.385,24,30,.800,125
812,PHI,2020-01-28,115,,GSW,W 115-104,240,42,82,.512,31,50,.620,11,32,.344,20,26,.769,115,37,87,.425,22,47,.468,15,40,.375,15,21,.714,104
813,CLE,2020-01-27,115,@,DET,W 115-100,240,48,96,.500,39,72,.542,9,24,.375,10,13,.769,115,38,84,.452,26,49,.531,12,35,.343,12,17,.706,100
814,IND,2020-01-19,115,@,DEN,W 115-107,240,43,86,.500,30,57,.526,13,29,.448,16,19,.842,115,41,88,.466,38,65,.585,3,23,.130,22,32,.688,107
815,HOU,2020-01-18,115,,LAL,L 115-124,240,40,90,.444,28,53,.528,12,37,.324,23,29,.793,115,45,93,.484,34,60,.567,11,33,.333,23,32,.719,124
816,MIA,2020-01-17,115,@,OKC,W 115-108,240,41,84,.488,27,48,.563,14,36,.389,19,24,.792,115,37,84,.440,19,38,.500,18,46,.391,16,18,.889,108
817,CHI,2020-01-15,115,,WAS,W 115-106,240,43,85,.506,29,47,.617,14,38,.368,15,22,.682,115,37,79,.468,26,52,.500,11,27,.407,21,26,.808,106
818,POR,2020-01-13,115,,CHO,W 115-112,240,42,83,.506,26,46,.565,16,37,.432,15,19,.789,115,40,90,.444,22,52,.423,18,38,.474,14,18,.778,112
819,CLE,2020-01-09,115,@,DET,W 115-112 (OT),265,48,91,.527,43,71,.606,5,20,.250,14,20,.700,115,48,98,.490,42,78,.538,6,20,.300,10,16,.625,112
820,ATL,2020-01-08,115,,HOU,L 115-122,240,39,106,.368,26,62,.419,13,44,.295,24,27,.889,115,39,92,.424,26,47,.553,13,45,.289,31,41,.756,122
821,DET,2020-01-07,115,@,CLE,W 115-113,240,42,91,.462,29,58,.500,13,33,.394,18,21,.857,115,42,85,.494,28,54,.519,14,31,.452,15,16,.938,113
822,IND,2020-01-06,115,@,CHO,W 115-104,240,47,89,.528,37,63,.587,10,26,.385,11,14,.786,115,37,81,.457,27,51,.529,10,30,.333,20,22,.909,104
823,ATL,2020-01-06,115,,DEN,L 115-123,240,35,77,.455,17,38,.447,18,39,.462,27,32,.844,115,47,92,.511,38,65,.585,9,27,.333,20,27,.741,123
824,SAC,2020-01-04,115,,NOP,L 115-117,240,38,85,.447,26,64,.406,12,21,.571,27,36,.750,115,38,87,.437,22,42,.524,16,45,.356,25,33,.758,117
825,IND,2019-12-31,115,,PHI,W 115-97,240,42,86,.488,31,61,.508,11,25,.440,20,26,.769,115,37,91,.407,31,62,.500,6,29,.207,17,20,.850,97
826,BRK,2019-12-30,115,@,MIN,L 115-122 (OT),265,40,99,.404,25,58,.431,15,41,.366,20,27,.741,115,42,104,.404,25,60,.417,17,44,.386,21,29,.724,122
827,SAC,2019-12-29,115,@,DEN,L 115-120,240,45,85,.529,32,51,.627,13,34,.382,12,17,.706,115,42,81,.519,34,52,.654,8,29,.276,28,31,.903,120
828,POR,2019-12-26,115,@,UTA,L 115-121,240,43,89,.483,28,55,.509,15,34,.441,14,19,.737,115,46,81,.568,32,45,.711,14,36,.389,15,22,.682,121
829,MEM,2019-12-23,115,,SAS,L 115-145,240,45,96,.469,30,59,.508,15,37,.405,10,16,.625,115,60,89,.674,45,65,.692,15,24,.625,10,14,.714,145
830,TOR,2019-12-23,115,@,IND,L 115-120 (OT),265,43,94,.457,32,54,.593,11,40,.275,18,24,.750,115,45,95,.474,27,53,.509,18,42,.429,12,20,.600,120
831,NYK,2019-12-23,115,,WAS,L 115-121,240,44,93,.473,29,57,.509,15,36,.417,12,15,.800,115,47,100,.470,37,70,.529,10,30,.333,17,30,.567,121
832,SAC,2019-12-21,115,@,MEM,L 115-119,240,43,100,.430,32,64,.500,11,36,.306,18,24,.750,115,40,83,.482,25,48,.521,15,35,.429,24,29,.828,119
833,DET,2019-12-14,115,@,HOU,W 115-107,240,41,92,.446,29,55,.527,12,37,.324,21,25,.840,115,41,102,.402,28,57,.491,13,45,.289,12,18,.667,107
834,PHI,2019-12-12,115,@,BOS,W 115-109,240,41,82,.500,27,54,.500,14,28,.500,19,23,.826,115,42,91,.462,31,60,.517,11,31,.355,14,17,.824,109
835,MEM,2019-12-11,115,@,PHO,W 115-108,240,42,87,.483,32,63,.508,10,24,.417,21,26,.808,115,37,93,.398,28,59,.475,9,34,.265,25,30,.833,108
836,POR,2019-12-10,115,,NYK,W 115-87,240,39,90,.433,22,49,.449,17,41,.415,20,24,.833,115,32,91,.352,25,53,.472,7,38,.184,16,26,.615,87
837,HOU,2019-12-07,115,,PHO,W 115-109,240,41,91,.451,30,51,.588,11,40,.275,22,30,.733,115,40,96,.417,29,61,.475,11,35,.314,18,28,.643,109
838,MEM,2019-12-01,115,@,MIN,W 115-107,240,41,100,.410,25,60,.417,16,40,.400,17,21,.810,115,33,85,.388,22,49,.449,11,36,.306,30,35,.857,107
839,CHO,2019-11-23,115,,CHI,L 115-116,240,44,80,.550,32,52,.615,12,28,.429,15,22,.682,115,43,95,.453,21,48,.438,22,47,.468,8,12,.667,116
840,PHI,2019-11-22,115,,SAS,W 115-104,240,46,89,.517,36,63,.571,10,26,.385,13,19,.684,115,43,85,.506,37,67,.552,6,18,.333,12,16,.750,104
841,NOP,2019-11-19,115,,POR,W 115-104,240,41,93,.441,28,57,.491,13,36,.361,20,24,.833,115,40,92,.435,24,63,.381,16,29,.552,8,13,.615,104
842,MIL,2019-11-18,115,@,CHI,W 115-101,240,38,82,.463,23,41,.561,15,41,.366,24,35,.686,115,39,97,.402,27,63,.429,12,34,.353,11,14,.786,101
843,IND,2019-11-18,115,@,BRK,W 115-86,240,44,101,.436,30,68,.441,14,33,.424,13,17,.765,115,30,84,.357,19,50,.380,11,34,.324,15,24,.625,86
844,CHI,2019-11-14,115,@,MIL,L 115-124,240,38,93,.409,20,50,.400,18,43,.419,21,25,.840,115,42,88,.477,36,55,.655,6,33,.182,34,47,.723,124
845,PHO,2019-11-12,115,,LAL,L 115-123,240,43,91,.473,27,53,.509,16,38,.421,13,17,.765,115,51,95,.537,41,70,.586,10,25,.400,11,21,.524,123
846,SAS,2019-11-09,115,,BOS,L 115-135,240,39,99,.394,25,69,.362,14,30,.467,23,30,.767,115,48,94,.511,34,57,.596,14,37,.378,25,28,.893,135
847,NOP,2019-11-09,115,@,CHO,W 115-110,240,40,75,.533,26,42,.619,14,33,.424,21,30,.700,115,36,88,.409,24,53,.453,12,35,.343,26,34,.765,110
848,POR,2019-11-08,115,,BRK,L 115-119,240,40,97,.412,29,67,.433,11,30,.367,24,25,.960,115,41,99,.414,25,62,.403,16,37,.432,21,30,.700,119
849,WAS,2019-11-04,115,,DET,W 115-99,240,43,93,.462,35,64,.547,8,29,.276,21,25,.840,115,34,82,.415,21,55,.382,13,27,.481,18,23,.783,99
850,MIL,2019-11-02,115,,TOR,W 115-105,240,41,89,.461,28,51,.549,13,38,.342,20,25,.800,115,34,84,.405,19,48,.396,15,36,.417,22,25,.880,105
851,OKC,2019-11-02,115,,NOP,W 115-104,240,41,90,.456,26,53,.491,15,37,.405,18,23,.783,115,40,94,.426,29,62,.468,11,32,.344,13,22,.591,104
852,UTA,2020-08-10,114,,DAL,L 114-122,240,39,82,.476,18,36,.500,21,46,.457,15,20,.750,114,48,85,.565,36,61,.590,12,24,.500,14,16,.875,122
853,MIA,2020-08-10,114,,IND,W 114-92,240,44,98,.449,31,58,.534,13,40,.325,13,19,.684,114,33,84,.393,23,49,.469,10,35,.286,16,25,.640,92
854,TOR,2020-08-10,114,@,MIL,W 114-106,240,42,97,.433,30,57,.526,12,40,.300,18,26,.692,114,33,84,.393,19,41,.463,14,43,.326,26,35,.743,106
855,PHO,2020-08-06,114,,IND,W 114-99,240,43,92,.467,34,58,.586,9,34,.265,19,20,.950,114,37,85,.435,27,56,.482,10,29,.345,15,19,.789,99
856,DAL,2020-08-04,114,@,SAC,W 114-110 (OT),265,33,90,.367,24,49,.490,9,41,.220,39,50,.780,114,43,104,.413,27,61,.443,16,43,.372,8,12,.667,110
857,BOS,2020-03-10,114,@,IND,W 114-111,240,41,93,.441,28,56,.500,13,37,.351,19,22,.864,114,46,93,.495,37,69,.536,9,24,.375,10,11,.909,111
858,PHI,2020-03-07,114,@,GSW,L 114-118,240,41,84,.488,28,50,.560,13,34,.382,19,22,.864,114,44,80,.550,35,55,.636,9,25,.360,21,28,.750,118
859,DEN,2020-03-05,114,@,CHO,W 114-112,240,44,83,.530,36,57,.632,8,26,.308,18,20,.900,114,38,77,.494,25,44,.568,13,33,.394,23,28,.821,112
860,OKC,2020-03-04,114,@,DET,W 114-107,240,46,75,.613,36,51,.706,10,24,.417,12,17,.706,114,40,86,.465,22,43,.512,18,43,.419,9,15,.600,107
861,PHO,2020-03-03,114,,TOR,L 114-123,240,39,85,.459,24,46,.522,15,39,.385,21,25,.840,114,40,86,.465,26,52,.500,14,34,.412,29,35,.829,123
862,NOP,2020-03-01,114,,LAL,L 114-122,240,40,95,.421,33,63,.524,7,32,.219,27,33,.818,114,50,97,.515,37,62,.597,13,35,.371,9,10,.900,122
863,SAS,2020-02-29,114,,ORL,W 114-113,240,44,84,.524,30,53,.566,14,31,.452,12,16,.750,114,41,84,.488,26,47,.553,15,37,.405,16,23,.696,113
864,BOS,2020-02-26,114,@,UTA,W 114-103,240,45,84,.536,34,58,.586,11,26,.423,13,16,.813,114,40,89,.449,28,49,.571,12,40,.300,11,15,.733,103
865,LAL,2020-02-23,114,,BOS,W 114-112,240,39,86,.453,28,52,.538,11,34,.324,25,37,.676,114,38,83,.458,25,49,.510,13,34,.382,23,30,.767,112
866,WAS,2020-02-12,114,@,NYK,W 114-96,240,40,84,.476,30,56,.536,10,28,.357,24,33,.727,114,36,88,.409,33,65,.508,3,23,.130,21,29,.724,96
867,SAS,2020-02-11,114,@,OKC,W 114-106,240,41,84,.488,34,59,.576,7,25,.280,25,27,.926,114,39,85,.459,28,54,.519,11,31,.355,17,21,.810,106
868,CHI,2020-02-11,114,@,WAS,L 114-126,240,44,92,.478,28,53,.528,16,39,.410,10,14,.714,114,48,89,.539,37,57,.649,11,32,.344,19,24,.792,126
869,UTA,2020-02-09,114,@,HOU,W 114-113,240,42,86,.488,27,48,.563,15,38,.395,15,18,.833,114,44,95,.463,29,53,.547,15,42,.357,10,14,.714,113
870,POR,2020-02-07,114,@,UTA,L 114-117,240,44,97,.454,27,57,.474,17,40,.425,9,14,.643,114,45,91,.495,35,61,.574,10,30,.333,17,24,.708,117
871,SAS,2020-02-01,114,,CHO,W 114-90,240,45,87,.517,35,59,.593,10,28,.357,14,21,.667,114,35,83,.422,25,47,.532,10,36,.278,10,12,.833,90
872,ATL,2020-01-28,114,@,TOR,L 114-130,240,41,92,.446,29,45,.644,12,47,.255,20,25,.800,114,48,97,.495,35,54,.648,13,43,.302,21,27,.778,130
873,MEM,2020-01-26,114,,PHO,W 114-109,240,44,84,.524,36,65,.554,8,19,.421,18,26,.692,114,35,92,.380,24,63,.381,11,29,.379,28,35,.800,109
874,ORL,2020-01-22,114,,OKC,L 114-120,240,44,92,.478,30,57,.526,14,35,.400,12,16,.750,114,46,76,.605,37,57,.649,9,19,.474,19,23,.826,120
875,MIN,2020-01-17,114,@,IND,L 114-116,240,40,88,.455,23,49,.469,17,39,.436,17,21,.810,114,46,82,.561,38,58,.655,8,24,.333,16,20,.800,116
876,ORL,2020-01-13,114,@,SAC,W 114-112,240,40,92,.435,31,63,.492,9,29,.310,25,30,.833,114,45,87,.517,33,56,.589,12,31,.387,10,11,.909,112
877,DEN,2020-01-12,114,,LAC,W 114-104,240,37,77,.481,26,52,.500,11,25,.440,29,37,.784,114,38,84,.452,30,51,.588,8,33,.242,20,26,.769,104
878,DAL,2020-01-10,114,,LAL,L 114-129,240,39,96,.406,28,58,.483,11,38,.289,25,37,.676,114,47,89,.528,37,65,.569,10,24,.417,25,32,.781,129
879,BOS,2020-01-08,114,,SAS,L 114-129,240,37,89,.416,24,51,.471,13,38,.342,27,30,.900,114,48,87,.552,39,58,.672,9,29,.310,24,26,.923,129
880,SAC,2020-01-07,114,@,PHO,W 114-103,240,37,84,.440,22,48,.458,15,36,.417,25,28,.893,114,37,77,.481,26,42,.619,11,35,.314,18,22,.818,103
881,PHO,2020-01-05,114,,MEM,L 114-121,240,43,95,.453,37,69,.536,6,26,.231,22,26,.846,114,45,83,.542,27,41,.659,18,42,.429,13,17,.765,121
882,DEN,2020-01-04,114,@,WAS,L 114-128,240,40,87,.460,34,58,.586,6,29,.207,28,34,.824,114,50,91,.549,44,75,.587,6,16,.375,22,27,.815,128
883,LAC,2020-01-04,114,,MEM,L 114-140,240,45,101,.446,38,71,.535,7,30,.233,17,22,.773,114,49,96,.510,31,57,.544,18,39,.462,24,28,.857,140
884,UTA,2019-12-21,114,@,CHO,W 114-107,240,39,75,.520,22,41,.537,17,34,.500,19,20,.950,114,39,85,.459,27,56,.482,12,29,.414,17,22,.773,107
885,CLE,2019-12-20,114,,MEM,W 114-107,240,40,92,.435,23,55,.418,17,37,.459,17,23,.739,114,44,102,.431,30,61,.492,14,41,.341,5,7,.714,107
886,BOS,2019-12-20,114,,DET,W 114-93,240,45,86,.523,36,59,.610,9,27,.333,15,21,.714,114,34,85,.400,23,54,.426,11,31,.355,14,19,.737,93
887,NYK,2019-12-20,114,@,MIA,L 114-129,240,41,94,.436,31,60,.517,10,34,.294,22,33,.667,114,43,77,.558,25,39,.641,18,38,.474,25,34,.735,129
888,UTA,2019-12-13,114,,GSW,W 114-106,240,37,79,.468,21,41,.512,16,38,.421,24,31,.774,114,41,91,.451,32,62,.516,9,29,.310,15,22,.682,106
889,MEM,2019-12-13,114,,MIL,L 114-127,240,38,98,.388,18,49,.367,20,49,.408,18,23,.783,114,44,87,.506,33,57,.579,11,30,.367,28,33,.848,127
890,DEN,2019-12-12,114,,POR,W 114-99,240,42,88,.477,24,52,.462,18,36,.500,12,19,.632,114,41,86,.477,32,56,.571,9,30,.300,8,11,.727,99
891,CHO,2019-12-10,114,,WAS,W 114-107,240,38,85,.447,22,44,.500,16,41,.390,22,28,.786,114,38,90,.422,27,55,.491,11,35,.314,20,25,.800,107
892,MIN,2019-12-04,114,@,DAL,L 114-121,240,37,89,.416,20,51,.392,17,38,.447,23,26,.885,114,46,92,.500,35,55,.636,11,37,.297,18,23,.783,121
893,PHO,2019-12-04,114,@,ORL,L 114-128,240,43,88,.489,28,55,.509,15,33,.455,13,20,.650,114,49,85,.576,35,60,.583,14,25,.560,16,20,.800,128
894,DAL,2019-12-01,114,@,LAL,W 114-100,240,42,97,.433,25,48,.521,17,49,.347,13,18,.722,114,40,87,.460,33,60,.550,7,27,.259,13,16,.813,100
895,LAL,2019-11-27,114,@,NOP,W 114-110,240,44,85,.518,36,61,.590,8,24,.333,18,25,.720,114,34,84,.405,17,44,.386,17,40,.425,25,30,.833,110
896,LAC,2019-11-26,114,@,DAL,W 114-99,240,41,97,.423,30,64,.469,11,33,.333,21,30,.700,114,30,79,.380,19,41,.463,11,38,.289,28,35,.800,99
897,LAL,2019-11-25,114,@,SAS,W 114-104,240,44,89,.494,30,56,.536,14,33,.424,12,18,.667,114,41,88,.466,31,63,.492,10,25,.400,12,15,.800,104
898,MEM,2019-11-25,114,@,IND,L 114-126,240,46,96,.479,33,67,.493,13,29,.448,9,13,.692,114,51,94,.543,33,61,.541,18,33,.545,6,10,.600,126
899,GSW,2019-11-19,114,@,MEM,W 114-95,240,43,90,.478,34,61,.557,9,29,.310,19,22,.864,114,36,88,.409,27,63,.429,9,25,.360,14,19,.737,95
900,MEM,2019-11-17,114,,DEN,L 114-131,240,39,84,.464,23,48,.479,16,36,.444,20,24,.833,114,49,89,.551,31,57,.544,18,32,.563,15,23,.652,131
901,PHI,2019-11-17,114,@,CLE,W 114-95,240,46,84,.548,37,61,.607,9,23,.391,13,17,.765,114,34,90,.378,28,65,.431,6,25,.240,21,24,.875,95
902,SAS,2019-11-13,114,@,MIN,L 114-129,240,44,90,.489,41,73,.562,3,17,.176,23,29,.793,114,45,91,.495,34,57,.596,11,34,.324,28,34,.824,129
903,TOR,2019-11-13,114,@,POR,W 114-106,240,42,92,.457,28,60,.467,14,32,.438,16,17,.941,114,38,96,.396,21,48,.438,17,48,.354,13,16,.813,106
904,BRK,2019-11-12,114,@,UTA,L 114-119,240,41,90,.456,30,53,.566,11,37,.297,21,25,.840,114,43,92,.467,37,66,.561,6,26,.231,27,35,.771,119
905,DET,2019-11-11,114,,MIN,L 114-120,240,39,87,.448,23,55,.418,16,32,.500,20,25,.800,114,45,89,.506,30,55,.545,15,34,.441,15,19,.789,120
906,PHI,2019-11-10,114,,CHO,W 114-106,240,46,84,.548,36,56,.643,10,28,.357,12,16,.750,114,38,84,.452,24,51,.471,14,33,.424,16,22,.727,106
907,OKC,2019-11-09,114,,GSW,W 114-108,240,43,79,.544,29,49,.592,14,30,.467,14,17,.824,114,42,85,.494,35,63,.556,7,22,.318,17,17,1.000,108
908,PHO,2019-11-04,114,,PHI,W 114-109,240,41,77,.532,30,49,.612,11,28,.393,21,27,.778,114,42,89,.472,29,60,.483,13,29,.448,12,20,.600,109
909,PHO,2019-11-02,114,@,MEM,W 114-105,240,44,88,.500,30,54,.556,14,34,.412,12,16,.750,114,42,86,.488,33,58,.569,9,28,.321,12,19,.632,105
910,WAS,2020-08-11,113,,MIL,L 113-126,240,39,95,.411,27,60,.450,12,35,.343,23,30,.767,113,44,87,.506,26,49,.531,18,38,.474,20,28,.714,126
911,NOP,2020-08-09,113,,SAS,L 113-122,240,42,96,.438,30,66,.455,12,30,.400,17,22,.773,113,40,89,.449,29,61,.475,11,28,.393,31,32,.969,122
912,HOU,2020-08-06,113,,LAL,W 113-97,240,36,84,.429,15,27,.556,21,57,.368,20,23,.870,113,35,77,.455,33,58,.569,2,19,.105,25,36,.694,97
913,OKC,2020-08-03,113,,DEN,L 113-121 (OT),265,37,87,.425,22,51,.431,15,36,.417,24,31,.774,113,42,87,.483,35,62,.565,7,25,.280,30,39,.769,121
914,DAL,2020-03-11,113,,DEN,W 113-97,240,42,92,.457,30,57,.526,12,35,.343,17,23,.739,113,39,83,.470,25,44,.568,14,39,.359,5,8,.625,97
915,SAC,2020-03-08,113,,TOR,L 113-118,240,42,90,.467,34,59,.576,8,31,.258,21,23,.913,113,39,82,.476,20,34,.588,19,48,.396,21,27,.778,118
916,LAL,2020-03-06,113,,MIL,W 113-103,240,38,91,.418,32,59,.542,6,32,.188,31,38,.816,113,37,89,.416,25,46,.543,12,43,.279,17,23,.739,103
917,GSW,2020-03-05,113,,TOR,L 113-121,240,40,98,.408,26,46,.565,14,52,.269,19,25,.760,113,40,84,.476,27,43,.628,13,41,.317,28,31,.903,121
918,ORL,2020-03-04,113,@,MIA,L 113-116,240,44,84,.524,31,54,.574,13,30,.433,12,14,.857,113,41,79,.519,19,35,.543,22,44,.500,12,15,.800,116
919,CLE,2020-03-02,113,,UTA,L 113-126,240,42,91,.462,25,50,.500,17,41,.415,12,18,.667,113,47,83,.566,27,42,.643,20,41,.488,12,14,.857,126
920,BRK,2020-02-29,113,@,MIA,L 113-116,240,40,86,.465,24,42,.571,16,44,.364,17,23,.739,113,41,91,.451,27,53,.509,14,38,.368,20,24,.833,116
921,IND,2020-02-29,113,@,CLE,W 113-104,240,47,87,.540,39,64,.609,8,23,.348,11,14,.786,113,41,85,.482,36,63,.571,5,22,.227,17,20,.850,104
922,ORL,2020-02-29,113,@,SAS,L 113-114,240,41,84,.488,26,47,.553,15,37,.405,16,23,.696,113,44,84,.524,30,53,.566,14,31,.452,12,16,.750,114
923,DET,2020-02-28,113,@,PHO,W 113-111,240,44,90,.489,31,58,.534,13,32,.406,12,16,.750,113,45,75,.600,36,52,.692,9,23,.391,12,17,.706,111
924,BRK,2020-02-24,113,,ORL,L 113-115,240,46,96,.479,30,59,.508,16,37,.432,5,8,.625,113,44,89,.494,31,55,.564,13,34,.382,14,17,.824,115
925,CLE,2020-02-21,113,@,WAS,W 113-108,240,43,81,.531,32,54,.593,11,27,.407,16,25,.640,113,41,106,.387,32,69,.464,9,37,.243,17,23,.739,108
926,OKC,2020-02-21,113,,DEN,W 113-101,240,40,87,.460,31,61,.508,9,26,.346,24,27,.889,113,37,77,.481,31,50,.620,6,27,.222,21,23,.913,101
927,SAS,2020-02-21,113,@,UTA,W 113-104,240,40,91,.440,30,71,.423,10,20,.500,23,26,.885,113,35,82,.427,23,49,.469,12,33,.364,22,26,.846,104
928,MIA,2020-02-10,113,@,GSW,W 113-101,240,43,87,.494,31,54,.574,12,33,.364,15,21,.714,113,30,77,.390,19,43,.442,11,34,.324,30,34,.882,101
929,HOU,2020-02-09,113,,UTA,L 113-114,240,44,95,.463,29,53,.547,15,42,.357,10,14,.714,113,42,86,.488,27,48,.563,15,38,.395,15,18,.833,114
930,SAC,2020-02-03,113,,MIN,W 113-109,240,38,75,.507,24,48,.500,14,27,.519,23,31,.742,113,37,85,.435,24,47,.511,13,38,.342,22,28,.786,109
931,SAC,2020-02-01,113,,LAL,L 113-129,240,39,91,.429,25,47,.532,14,44,.318,21,26,.808,113,44,86,.512,25,43,.581,19,43,.442,22,27,.815,129
932,WAS,2020-02-01,113,,BRK,W 113-107,240,44,100,.440,35,68,.515,9,32,.281,16,26,.615,113,39,94,.415,23,47,.489,16,47,.340,13,21,.619,107
933,MIA,2020-01-27,113,,ORL,W 113-92,240,42,79,.532,28,51,.549,14,28,.500,15,16,.938,113,33,89,.371,22,52,.423,11,37,.297,15,19,.789,92
934,OKC,2020-01-25,113,@,MIN,W 113-104,240,39,80,.488,28,56,.500,11,24,.458,24,25,.960,113,40,90,.444,28,47,.596,12,43,.279,12,18,.667,104
935,DEN,2020-01-24,113,@,NOP,W 113-106,240,40,106,.377,27,65,.415,13,41,.317,20,20,1.000,113,38,82,.463,26,55,.473,12,27,.444,18,30,.600,106
936,BRK,2020-01-23,113,,LAL,L 113-128,240,40,91,.440,19,45,.422,21,46,.457,12,15,.800,113,47,94,.500,28,56,.500,19,38,.500,15,20,.750,128
937,SAC,2020-01-20,113,@,MIA,L 113-118 (OT),265,44,106,.415,31,55,.564,13,51,.255,12,15,.800,113,42,83,.506,26,41,.634,16,42,.381,18,22,.818,118
938,MEM,2020-01-17,113,,CLE,W 113-109,240,45,89,.506,36,61,.590,9,28,.321,14,20,.700,113,41,92,.446,32,56,.571,9,36,.250,18,26,.692,109
939,BOS,2020-01-13,113,,CHI,W 113-101,240,39,83,.470,30,60,.500,9,23,.391,26,29,.897,113,37,81,.457,31,56,.554,6,25,.240,21,26,.808,101
940,MIA,2020-01-10,113,@,BRK,L 113-117,240,44,85,.518,37,56,.661,7,29,.241,18,21,.857,113,45,93,.484,30,49,.612,15,44,.341,12,19,.632,117
941,OKC,2020-01-09,113,,HOU,W 113-92,240,43,87,.494,32,55,.582,11,32,.344,16,20,.800,113,34,89,.382,23,49,.469,11,40,.275,13,14,.929,92
942,CLE,2020-01-07,113,,DET,L 113-115,240,42,85,.494,28,54,.519,14,31,.452,15,16,.938,113,42,91,.462,29,58,.500,13,33,.394,18,21,.857,115
943,OKC,2020-01-06,113,@,PHI,L 113-120,240,40,89,.449,28,60,.467,12,29,.414,21,31,.677,113,46,90,.511,33,64,.516,13,26,.500,15,18,.833,120
944,NOP,2020-01-03,113,@,LAL,L 113-123,240,48,102,.471,37,65,.569,11,37,.297,6,7,.857,113,43,86,.500,29,57,.509,14,29,.483,23,28,.821,123
945,GSW,2019-12-31,113,@,SAS,L 113-117 (OT),265,44,96,.458,32,69,.464,12,27,.444,13,18,.722,113,45,96,.469,31,65,.477,14,31,.452,13,17,.765,117
946,TOR,2019-12-28,113,@,BOS,W 113-97,240,44,84,.524,30,50,.600,14,34,.412,11,17,.647,113,31,78,.397,24,46,.522,7,32,.219,28,36,.778,97
947,MIA,2019-12-27,113,,IND,W 113-112,240,40,89,.449,24,51,.471,16,38,.421,17,19,.895,113,44,90,.489,30,59,.508,14,31,.452,10,12,.833,112
948,HOU,2019-12-23,113,@,SAC,W 113-104,240,39,87,.448,24,48,.500,15,39,.385,20,23,.870,113,41,87,.471,34,57,.596,7,30,.233,15,23,.652,104
949,DEN,2019-12-23,113,@,PHO,W 113-111,240,43,78,.551,28,50,.560,15,28,.536,12,15,.800,113,42,87,.483,29,50,.580,13,37,.351,14,18,.778,111
950,GSW,2019-12-23,113,,MIN,W 113-104,240,38,87,.437,26,57,.456,12,30,.400,25,30,.833,113,35,87,.402,24,53,.453,11,34,.324,23,29,.793,104
951,POR,2019-12-21,113,,MIN,W 113-106,240,40,94,.426,27,59,.458,13,35,.371,20,25,.800,113,38,87,.437,23,50,.460,15,37,.405,15,16,.938,106
952,DEN,2019-12-18,113,,ORL,W 113-104,240,40,84,.476,29,57,.509,11,27,.407,22,25,.880,113,37,87,.425,26,58,.448,11,29,.379,19,21,.905,104
953,CLE,2019-12-16,113,@,TOR,L 113-133,240,44,90,.489,32,55,.582,12,35,.343,13,17,.765,113,52,89,.584,36,57,.632,16,32,.500,13,17,.765,133
954,LAL,2019-12-13,113,@,MIA,W 113-110,240,43,87,.494,31,50,.620,12,37,.324,15,23,.652,113,39,85,.459,29,52,.558,10,33,.303,22,28,.786,110
955,CHO,2019-12-11,113,@,BRK,W 113-108,240,36,88,.409,21,53,.396,15,35,.429,26,32,.813,113,38,88,.432,28,50,.560,10,38,.263,22,33,.667,108
956,POR,2019-12-06,113,,LAL,L 113-136,240,39,86,.453,29,52,.558,10,34,.294,25,29,.862,113,46,85,.541,29,49,.592,17,36,.472,27,33,.818,136
957,PHI,2019-12-05,113,@,WAS,L 113-119,240,41,77,.532,28,49,.571,13,28,.464,18,24,.750,113,41,90,.456,30,63,.476,11,27,.407,26,32,.813,119
958,CHI,2019-12-02,113,@,SAC,W 113-106,240,36,75,.480,20,38,.526,16,37,.432,25,29,.862,113,40,83,.482,31,50,.620,9,33,.273,17,20,.850,106
959,BOS,2019-12-01,113,@,NYK,W 113-104,240,41,93,.441,26,52,.500,15,41,.366,16,22,.727,113,35,76,.461,27,50,.540,8,26,.308,26,37,.703,104
960,PHO,2019-11-29,113,,DAL,L 113-120,240,41,93,.441,28,55,.509,13,38,.342,18,25,.720,113,35,85,.412,18,38,.474,17,47,.362,33,38,.868,120
961,MIN,2019-11-27,113,@,SAS,W 113-101,240,37,85,.435,19,45,.422,18,40,.450,21,27,.778,113,41,97,.423,36,68,.529,5,29,.172,14,17,.824,101
962,ATL,2019-11-25,113,,MIN,L 113-125,240,41,94,.436,31,62,.500,10,32,.313,21,26,.808,113,41,90,.456,26,55,.473,15,35,.429,28,36,.778,125
963,SAC,2019-11-24,113,@,WAS,W 113-106,240,39,81,.481,28,50,.560,11,31,.355,24,28,.857,113,42,92,.457,29,58,.500,13,34,.382,9,12,.750,106
964,PHI,2019-11-23,113,,MIA,W 113-86,240,42,83,.506,28,54,.519,14,29,.483,15,17,.882,113,30,75,.400,24,51,.471,6,24,.250,20,27,.741,86
965,UTA,2019-11-22,113,,GSW,W 113-109,240,43,85,.506,29,53,.547,14,32,.438,13,16,.813,113,43,94,.457,31,66,.470,12,28,.429,11,12,.917,109
966,TOR,2019-11-20,113,,ORL,W 113-97,240,45,87,.517,36,60,.600,9,27,.333,14,19,.737,113,35,91,.385,26,59,.441,9,32,.281,18,28,.643,97
967,MEM,2019-11-11,113,@,SAS,W 113-109,240,44,87,.506,33,59,.559,11,28,.393,14,20,.700,113,42,90,.467,30,60,.500,12,30,.400,13,17,.765,109
968,ATL,2019-11-10,113,@,POR,L 113-124 (OT),265,42,104,.404,31,63,.492,11,41,.268,18,25,.720,113,45,104,.433,33,68,.485,12,36,.333,22,28,.786,124
969,TOR,2019-11-10,113,@,LAL,W 113-104,240,43,89,.483,31,53,.585,12,36,.333,15,22,.682,113,41,94,.436,31,64,.484,10,30,.333,12,19,.632,104
970,CLE,2019-11-08,113,@,WAS,W 113-100,240,41,90,.456,35,63,.556,6,27,.222,25,29,.862,113,45,96,.469,38,65,.585,7,31,.226,3,6,.500,100
971,CHI,2019-11-06,113,@,ATL,W 113-93,240,41,82,.500,28,49,.571,13,33,.394,18,27,.667,113,30,74,.405,24,44,.545,6,30,.200,27,35,.771,93
972,CLE,2019-11-05,113,,BOS,L 113-119,240,40,95,.421,27,62,.435,13,33,.394,20,22,.909,113,48,85,.565,36,55,.655,12,30,.400,11,15,.733,119
973,SAC,2019-11-03,113,@,NYK,W 113-92,240,41,85,.482,26,46,.565,15,39,.385,16,25,.640,113,32,80,.400,24,49,.490,8,31,.258,20,31,.645,92
974,DET,2019-11-02,113,,BRK,W 113-109,240,41,91,.451,33,64,.516,8,27,.296,23,29,.793,113,43,93,.462,33,61,.541,10,32,.313,13,17,.765,109
975,DET,2019-10-30,113,@,TOR,L 113-125,240,41,88,.466,27,58,.466,14,30,.467,17,23,.739,113,51,86,.593,38,59,.644,13,27,.481,10,12,.833,125
976,SAS,2019-10-28,113,,POR,W 113-110,240,41,85,.482,34,63,.540,7,22,.318,24,32,.750,113,39,100,.390,29,67,.433,10,33,.303,22,27,.815,110
977,UTA,2019-10-26,113,,SAC,W 113-81,240,44,78,.564,26,41,.634,18,37,.486,7,12,.583,113,30,81,.370,23,55,.418,7,26,.269,14,17,.824,81
978,BRK,2019-10-25,113,,NYK,W 113-109,240,37,78,.474,21,41,.512,16,37,.432,23,34,.676,113,38,81,.469,21,56,.375,17,25,.680,16,28,.571,109
979,SAS,2020-08-13,112,@,UTA,L 112-118,240,39,79,.494,29,59,.492,10,20,.500,24,36,.667,112,47,101,.465,32,55,.582,15,46,.326,9,10,.900,118
980,SAC,2020-08-11,112,,NOP,W 112-106,240,43,88,.489,32,62,.516,11,26,.423,15,16,.938,112,42,82,.512,35,58,.603,7,24,.292,15,19,.789,106
981,SAC,2020-08-09,112,,HOU,L 112-129,240,41,87,.471,31,50,.620,10,37,.270,20,23,.870,112,43,91,.473,25,34,.735,18,57,.316,25,30,.833,129
982,MIA,2020-08-08,112,,PHO,L 112-119,240,41,84,.488,30,48,.625,11,36,.306,19,22,.864,112,44,92,.478,32,60,.533,12,32,.375,19,20,.950,119
983,MIA,2020-08-04,112,,BOS,W 112-106,240,34,77,.442,19,34,.559,15,43,.349,29,39,.744,112,37,85,.435,27,52,.519,10,33,.303,22,27,.815,106
984,WAS,2020-07-31,112,,PHO,L 112-125,240,42,91,.462,34,69,.493,8,22,.364,20,23,.870,112,42,80,.525,31,48,.646,11,32,.344,30,32,.938,125
985,BOS,2020-07-31,112,@,MIL,L 112-119,240,37,91,.407,26,54,.481,11,37,.297,27,34,.794,112,39,84,.464,26,43,.605,13,41,.317,28,34,.824,119
986,LAL,2020-03-08,112,@,LAC,W 112-103,240,39,87,.448,29,52,.558,10,35,.286,24,28,.857,112,34,86,.395,27,55,.491,7,31,.226,28,37,.757,103
987,IND,2020-03-08,112,@,DAL,W 112-109,240,46,88,.523,38,65,.585,8,23,.348,12,18,.667,112,39,91,.429,25,48,.521,14,43,.326,17,25,.680,109
988,ATL,2020-03-06,112,@,WAS,L 112-118,240,46,86,.535,34,54,.630,12,32,.375,8,12,.667,112,36,76,.474,21,45,.467,15,31,.484,31,35,.886,118
989,CHO,2020-03-05,112,,DEN,L 112-114,240,38,77,.494,25,44,.568,13,33,.394,23,28,.821,112,44,83,.530,36,57,.632,8,26,.308,18,20,.900,114
990,BOS,2020-03-04,112,@,CLE,W 112-106,240,40,86,.465,29,56,.518,11,30,.367,21,26,.808,112,39,89,.438,26,51,.510,13,38,.342,15,20,.750,106
991,UTA,2020-03-04,112,@,NYK,W 112-104,240,41,81,.506,31,45,.689,10,36,.278,20,25,.800,112,41,85,.482,34,65,.523,7,20,.350,15,18,.833,104
992,OKC,2020-02-27,112,,SAC,W 112-108,240,41,84,.488,32,58,.552,9,26,.346,21,29,.724,112,41,91,.451,29,56,.518,12,35,.343,14,14,1.000,108
993,MEM,2020-02-26,112,@,HOU,L 112-140,240,43,108,.398,30,69,.435,13,39,.333,13,21,.619,112,52,93,.559,29,43,.674,23,50,.460,13,15,.867,140
994,SAC,2020-02-25,112,@,GSW,W 112-94,240,40,76,.526,27,46,.587,13,30,.433,19,34,.559,112,35,79,.443,31,51,.608,4,28,.143,20,24,.833,94
995,NYK,2020-02-24,112,@,HOU,L 112-123,240,40,91,.440,29,62,.468,11,29,.379,21,30,.700,112,43,86,.500,27,38,.711,16,48,.333,21,31,.677,123
996,ATL,2020-02-24,112,@,PHI,L 112-129,240,40,97,.412,32,59,.542,8,38,.211,24,27,.889,112,45,88,.511,33,58,.569,12,30,.400,27,30,.900,129
997,BOS,2020-02-23,112,@,LAL,L 112-114,240,38,83,.458,25,49,.510,13,34,.382,23,30,.767,112,39,86,.453,28,52,.538,11,34,.324,25,37,.676,114
998,SAC,2020-02-22,112,@,LAC,W 112-103,240,40,89,.449,28,58,.483,12,31,.387,20,26,.769,112,34,87,.391,24,57,.421,10,30,.333,25,29,.862,103
999,PHO,2020-02-22,112,@,CHI,W 112-104,240,38,86,.442,28,56,.500,10,30,.333,26,31,.839,112,36,83,.434,22,45,.489,14,38,.368,18,21,.857,104
1000,PHI,2020-02-20,112,,BRK,W 112-104 (OT),265,38,86,.442,34,64,.531,4,22,.182,32,35,.914,112,36,102,.353,26,68,.382,10,34,.294,22,28,.786,104
1001,PHO,2020-02-12,112,,GSW,W 112-106,240,42,91,.462,28,54,.519,14,37,.378,14,15,.933,112,39,77,.506,28,46,.609,11,31,.355,17,19,.895,106
1002,DET,2020-02-12,112,@,ORL,L 112-116 (OT),265,40,92,.435,22,47,.468,18,45,.400,14,15,.933,112,44,96,.458,32,60,.533,12,36,.333,16,18,.889,116
1003,BOS,2020-02-09,112,@,OKC,W 112-111,240,38,84,.452,22,48,.458,16,36,.444,20,27,.741,112,39,86,.453,28,59,.475,11,27,.407,22,29,.759,111
1004,BOS,2020-02-07,112,,ATL,W 112-107,240,37,86,.430,21,49,.429,16,37,.432,22,27,.815,112,35,86,.407,22,47,.468,13,39,.333,24,26,.923,107
1005,MIL,2020-02-06,112,,PHI,W 112-101,240,44,94,.468,32,57,.561,12,37,.324,12,18,.667,112,37,99,.374,18,54,.333,19,45,.422,8,14,.571,101
1006,DAL,2020-02-03,112,@,IND,W 112-103,240,36,86,.419,18,41,.439,18,45,.400,22,23,.957,112,44,96,.458,37,62,.597,7,34,.206,8,11,.727,103
1007,ORL,2020-02-03,112,@,CHO,W 112-100,240,43,80,.538,27,46,.587,16,34,.471,10,17,.588,112,41,89,.461,32,58,.552,9,31,.290,9,14,.643,100
1008,CLE,2020-02-01,112,,GSW,L 112-131,240,41,95,.432,25,51,.490,16,44,.364,14,14,1.000,112,48,90,.533,30,55,.545,18,35,.514,17,19,.895,131
1009,HOU,2020-01-29,112,@,POR,L 112-125,240,40,94,.426,23,47,.489,17,47,.362,15,18,.833,112,46,89,.517,33,53,.623,13,36,.361,20,27,.741,125
1010,LAC,2020-01-26,112,@,ORL,W 112-97,240,37,79,.468,24,49,.490,13,30,.433,25,29,.862,112,34,95,.358,27,63,.429,7,32,.219,22,32,.688,97
1011,UTA,2020-01-25,112,,DAL,W 112-107,240,40,91,.440,25,48,.521,15,43,.349,17,22,.773,112,42,97,.433,26,56,.464,16,41,.390,7,13,.538,107
1012,DET,2020-01-24,112,,MEM,L 112-125,240,39,91,.429,28,59,.475,11,32,.344,23,31,.742,112,43,79,.544,32,57,.561,11,22,.500,28,31,.903,125
1013,NYK,2020-01-24,112,,TOR,L 112-118,240,42,85,.494,29,49,.592,13,36,.361,15,21,.714,112,41,81,.506,24,46,.522,17,35,.486,19,23,.826,118
1014,CLE,2020-01-23,112,,WAS,L 112-124,240,44,96,.458,33,63,.524,11,33,.333,13,17,.765,112,47,85,.553,31,49,.633,16,36,.444,14,18,.778,124
1015,IND,2020-01-22,112,@,PHO,W 112-87,240,45,84,.536,36,64,.563,9,20,.450,13,20,.650,112,30,84,.357,26,64,.406,4,20,.200,23,26,.885,87
1016,OKC,2020-01-20,112,@,HOU,W 112-107,240,40,92,.435,28,60,.467,12,32,.375,20,26,.769,112,43,97,.443,34,52,.654,9,45,.200,12,17,.706,107
1017,MIN,2020-01-18,112,,TOR,L 112-122,240,38,94,.404,24,44,.545,14,50,.280,22,27,.815,112,47,91,.516,34,56,.607,13,35,.371,15,17,.882,122
1018,POR,2020-01-17,112,@,DAL,L 112-120,240,44,85,.518,35,55,.636,9,30,.300,15,22,.682,112,39,89,.438,19,42,.452,20,47,.426,22,28,.786,120
1019,CHO,2020-01-13,112,@,POR,L 112-115,240,40,90,.444,22,52,.423,18,38,.474,14,18,.778,112,42,83,.506,26,46,.565,16,37,.432,15,19,.789,115
1020,SAC,2020-01-13,112,,ORL,L 112-114,240,45,87,.517,33,56,.589,12,31,.387,10,11,.909,112,40,92,.435,31,63,.492,9,29,.310,25,30,.833,114
1021,DET,2020-01-09,112,,CLE,L 112-115 (OT),265,48,98,.490,42,78,.538,6,20,.300,10,16,.625,112,48,91,.527,43,71,.606,5,20,.250,14,20,.700,115
1022,TOR,2020-01-08,112,@,CHO,W 112-110 (OT),265,42,94,.447,28,58,.483,14,36,.389,14,20,.700,112,38,86,.442,23,49,.469,15,37,.405,19,26,.731,110
1023,MIN,2020-01-07,112,@,MEM,L 112-119,240,40,90,.444,25,43,.581,15,47,.319,17,21,.810,112,46,89,.517,38,61,.623,8,28,.286,19,21,.905,119
1024,NYK,2020-01-03,112,@,PHO,L 112-120,240,41,92,.446,31,55,.564,10,37,.270,20,30,.667,112,42,90,.467,32,62,.516,10,28,.357,26,33,.788,120
1025,DET,2020-01-02,112,@,LAC,L 112-126,240,40,94,.426,33,61,.541,7,33,.212,25,35,.714,112,50,92,.543,39,64,.609,11,28,.393,15,21,.714,126
1026,HOU,2019-12-29,112,@,NOP,L 112-127,240,42,81,.519,27,42,.643,15,39,.385,13,20,.650,112,50,102,.490,32,58,.552,18,44,.409,9,13,.692,127
1027,PHO,2019-12-28,112,@,SAC,W 112-110,240,45,86,.523,36,60,.600,9,26,.346,13,15,.867,112,41,84,.488,29,53,.547,12,31,.387,16,24,.667,110
1028,MIL,2019-12-27,112,@,ATL,W 112-86,240,46,91,.505,35,63,.556,11,28,.393,9,13,.692,112,33,91,.363,21,50,.420,12,41,.293,8,14,.571,86
1029,IND,2019-12-27,112,@,MIA,L 112-113,240,44,90,.489,30,59,.508,14,31,.452,10,12,.833,112,40,89,.449,24,51,.471,16,38,.421,17,19,.895,113
1030,NOP,2019-12-25,112,@,DEN,W 112-100,240,41,90,.456,23,47,.489,18,43,.419,12,12,1.000,112,37,92,.402,25,55,.455,12,37,.324,14,18,.778,100
1031,LAC,2019-12-22,112,@,OKC,L 112-118,240,40,86,.465,29,59,.492,11,27,.407,21,24,.875,112,46,97,.474,37,70,.529,9,27,.333,17,20,.850,118
1032,ATL,2019-12-21,112,@,BRK,L 112-122,240,39,105,.371,28,57,.491,11,48,.229,23,27,.852,112,46,100,.460,35,70,.500,11,30,.367,19,28,.679,122
1033,GSW,2019-12-18,112,@,POR,L 112-122,240,41,103,.398,25,65,.385,16,38,.421,14,23,.609,112,44,97,.454,35,66,.530,9,31,.290,25,28,.893,122
1034,TOR,2019-12-18,112,@,DET,W 112-99,240,39,91,.429,26,56,.464,13,35,.371,21,24,.875,112,39,87,.448,33,52,.635,6,35,.171,15,22,.682,99
1035,LAC,2019-12-11,112,@,TOR,W 112-92,240,38,86,.442,26,46,.565,12,40,.300,24,27,.889,112,31,88,.352,23,52,.442,8,36,.222,22,25,.880,92
1036,NOP,2019-12-11,112,@,MIL,L 112-127,240,39,88,.443,23,43,.535,16,45,.356,18,22,.818,112,50,93,.538,31,54,.574,19,39,.487,8,9,.889,127
1037,MEM,2019-12-07,112,@,UTA,L 112-126,240,43,81,.531,33,46,.717,10,35,.286,16,25,.640,112,45,80,.563,26,46,.565,19,34,.559,17,18,.944,126
1038,MIA,2019-12-06,112,,WAS,W 112-103,240,42,86,.488,32,58,.552,10,28,.357,18,24,.750,112,39,91,.429,27,52,.519,12,39,.308,13,14,.929,103
1039,BOS,2019-12-04,112,,MIA,W 112-93,240,35,79,.443,19,38,.500,16,41,.390,26,32,.813,112,34,77,.442,20,39,.513,14,38,.368,11,17,.647,93
1040,BRK,2019-11-29,112,,BOS,W 112-107,240,43,93,.462,26,52,.500,17,41,.415,9,13,.692,112,41,93,.441,32,65,.492,9,28,.321,16,21,.762,107
1041,LAL,2019-11-19,112,,OKC,W 112-107,240,43,89,.483,29,58,.500,14,31,.452,12,19,.632,112,38,80,.475,29,52,.558,9,28,.321,22,25,.880,107
1042,MIN,2019-11-18,112,@,UTA,W 112-102,240,41,89,.461,27,51,.529,14,38,.368,16,19,.842,112,35,96,.365,23,65,.354,12,31,.387,20,26,.769,102
1043,ATL,2019-11-14,112,@,PHO,L 112-128,240,40,91,.440,32,60,.533,8,31,.258,24,30,.800,112,41,85,.482,26,46,.565,15,39,.385,31,38,.816,128
1044,ORL,2019-11-13,112,,PHI,W 112-97,240,38,86,.442,28,54,.519,10,32,.313,26,34,.765,112,40,91,.440,32,61,.525,8,30,.267,9,13,.692,97
1045,BRK,2019-11-10,112,@,PHO,L 112-138,240,44,91,.484,36,57,.632,8,34,.235,16,17,.941,112,52,99,.525,33,57,.579,19,42,.452,15,19,.789,138
1046,IND,2019-11-08,112,,DET,W 112-106,240,43,83,.518,39,68,.574,4,15,.267,22,25,.880,112,39,86,.453,26,53,.491,13,33,.394,15,18,.833,106
1047,OKC,2019-11-07,112,@,SAS,L 112-121,240,42,80,.525,32,59,.542,10,21,.476,18,24,.750,112,51,94,.543,42,74,.568,9,20,.450,10,11,.909,121
1048,GSW,2019-11-06,112,@,HOU,L 112-129,240,38,96,.396,25,63,.397,13,33,.394,23,28,.821,112,48,97,.495,27,52,.519,21,45,.467,12,19,.632,129
1049,CHI,2019-11-05,112,,LAL,L 112-118,240,43,85,.506,29,53,.547,14,32,.438,12,23,.522,112,45,92,.489,34,59,.576,11,33,.333,17,24,.708,118
1050,CHI,2019-11-01,112,,DET,W 112-106,240,39,89,.438,23,49,.469,16,40,.400,18,23,.783,112,41,85,.482,35,56,.625,6,29,.207,18,24,.750,106
1051,MIA,2019-10-29,112,,ATL,W 112-97,240,33,73,.452,20,42,.476,13,31,.419,33,45,.733,112,35,83,.422,24,44,.545,11,39,.282,16,24,.667,97
1052,CLE,2019-10-28,112,@,MIL,L 112-129,240,45,100,.450,33,61,.541,12,39,.308,10,12,.833,112,48,92,.522,31,54,.574,17,38,.447,16,24,.667,129
1053,OKC,2019-10-28,112,@,HOU,L 112-116,240,41,94,.436,28,59,.475,13,35,.371,17,24,.708,112,39,90,.433,29,46,.630,10,44,.227,28,33,.848,116
1054,BOS,2019-10-25,112,,TOR,W 112-106,240,42,109,.385,29,71,.408,13,38,.342,15,16,.938,112,37,78,.474,19,42,.452,18,36,.500,14,17,.824,106
1055,SAC,2019-10-25,112,,POR,L 112-122,240,37,87,.425,22,50,.440,15,37,.405,23,27,.852,112,46,85,.541,35,55,.636,11,30,.367,19,22,.864,122
1056,LAC,2019-10-22,112,,LAL,W 112-102,240,42,81,.519,31,50,.620,11,31,.355,17,24,.708,112,37,85,.435,24,52,.462,13,33,.394,15,21,.714,102
1057,DEN,2020-08-12,111,,LAC,L 111-124,240,43,87,.494,30,52,.577,13,35,.371,12,19,.632,111,46,85,.541,32,48,.667,14,37,.378,18,23,.783,124
1058,LAL,2020-08-08,111,@,IND,L 111-116,240,42,100,.420,29,61,.475,13,39,.333,14,19,.737,111,44,84,.524,29,51,.569,15,33,.455,13,14,.929,116
1059,UTA,2020-08-07,111,@,SAS,L 111-119,240,38,91,.418,22,54,.407,16,37,.432,19,24,.792,111,45,89,.506,36,67,.537,9,22,.409,20,26,.769,119
1060,DAL,2020-08-06,111,,LAC,L 111-126,240,39,87,.448,22,39,.564,17,48,.354,16,21,.762,111,50,92,.543,36,61,.590,14,31,.452,12,15,.800,126
1061,IND,2020-08-03,111,@,WAS,W 111-100,240,44,92,.478,37,66,.561,7,26,.269,16,16,1.000,111,41,94,.436,30,64,.469,11,30,.367,7,13,.538,100
1062,IND,2020-03-10,111,,BOS,L 111-114,240,46,93,.495,37,69,.536,9,24,.375,10,11,.909,111,41,93,.441,28,56,.500,13,37,.351,19,22,.864,114
1063,MIN,2020-03-10,111,@,HOU,L 111-117,240,40,83,.482,26,48,.542,14,35,.400,17,23,.739,111,41,80,.513,26,42,.619,15,38,.395,20,26,.769,117
1064,UTA,2020-03-07,111,@,DET,W 111-105,240,40,77,.519,30,44,.682,10,33,.303,21,28,.750,111,40,86,.465,31,56,.554,9,30,.300,16,22,.727,105
1065,POR,2020-03-07,111,,SAC,L 111-123,240,42,89,.472,32,50,.640,10,39,.256,17,26,.654,111,41,85,.482,20,46,.435,21,39,.538,20,23,.870,123
1066,SAS,2020-03-02,111,,IND,L 111-116,240,40,77,.519,24,45,.533,16,32,.500,15,19,.789,111,39,78,.500,24,47,.511,15,31,.484,23,26,.885,116
1067,DAL,2020-03-01,111,@,MIN,W 111-91,240,44,94,.468,33,54,.611,11,40,.275,12,19,.632,111,36,99,.364,23,57,.404,13,42,.310,6,15,.400,91
1068,HOU,2020-02-29,111,@,BOS,W 111-110 (OT),265,41,98,.418,26,43,.605,15,55,.273,14,18,.778,111,39,100,.390,26,58,.448,13,42,.310,19,25,.760,110
1069,PHO,2020-02-28,111,,DET,L 111-113,240,45,75,.600,36,52,.692,9,23,.391,12,17,.706,111,44,90,.489,31,58,.534,13,32,.406,12,16,.750,113
1070,UTA,2020-02-24,111,,PHO,L 111-131,240,32,68,.471,22,42,.524,10,26,.385,37,43,.860,111,49,87,.563,37,67,.552,12,20,.600,21,24,.875,131
1071,ATL,2020-02-22,111,,DAL,W 111-107,240,43,98,.439,35,61,.574,8,37,.216,17,26,.654,111,40,89,.449,26,45,.578,14,44,.318,13,19,.684,107
1072,SAC,2020-02-12,111,@,DAL,L 111-130,240,41,99,.414,29,60,.483,12,39,.308,17,22,.773,111,48,85,.565,31,45,.689,17,40,.425,17,21,.810,130
1073,MIL,2020-02-12,111,@,IND,L 111-118,240,37,91,.407,24,54,.444,13,37,.351,24,25,.960,111,45,86,.523,36,59,.610,9,27,.333,19,24,.792,118
1074,MEM,2020-02-12,111,,POR,W 111-104,240,45,95,.474,39,72,.542,6,23,.261,15,22,.682,111,36,97,.371,23,60,.383,13,37,.351,19,24,.792,104
1075,SAC,2020-02-10,111,@,MIL,L 111-123,240,42,101,.416,28,58,.483,14,43,.326,13,18,.722,111,43,96,.448,25,54,.463,18,42,.429,19,23,.826,123
1076,CHI,2020-02-09,111,@,PHI,L 111-118,240,43,88,.489,31,56,.554,12,32,.375,13,17,.765,111,42,84,.500,31,57,.544,11,27,.407,23,32,.719,118
1077,OKC,2020-02-09,111,,BOS,L 111-112,240,39,86,.453,28,59,.475,11,27,.407,22,29,.759,111,38,84,.452,22,48,.458,16,36,.444,20,27,.741,112
1078,MIL,2020-02-08,111,@,ORL,W 111-95,240,42,93,.452,27,54,.500,15,39,.385,12,16,.750,111,37,98,.378,27,58,.466,10,40,.250,11,14,.786,95
1079,LAL,2020-02-06,111,,HOU,L 111-121,240,45,91,.495,36,60,.600,9,31,.290,12,16,.750,111,43,85,.506,24,43,.558,19,42,.452,16,18,.889,121
1080,MIA,2020-02-05,111,@,LAC,L 111-128,240,40,93,.430,24,51,.471,16,42,.381,15,21,.714,111,45,89,.506,21,35,.600,24,54,.444,14,19,.737,128
1081,MEM,2020-01-31,111,@,NOP,L 111-139,240,45,96,.469,39,65,.600,6,31,.194,15,26,.577,111,51,95,.537,36,61,.590,15,34,.441,22,26,.846,139
1082,OKC,2020-01-31,111,@,PHO,W 111-107,240,42,97,.433,35,66,.530,7,31,.226,20,22,.909,111,36,76,.474,27,52,.519,9,24,.375,26,29,.897,107
1083,CLE,2020-01-28,111,,NOP,L 111-125,240,42,97,.433,31,63,.492,11,34,.324,16,18,.889,111,47,88,.534,34,54,.630,13,34,.382,18,24,.750,125
1084,DET,2020-01-25,111,,BRK,L 111-121 (OT),265,43,104,.413,30,69,.435,13,35,.371,12,18,.667,111,42,94,.447,27,52,.519,15,42,.357,22,25,.880,121
1085,ATL,2020-01-24,111,@,OKC,L 111-140,240,42,92,.457,31,56,.554,11,36,.306,16,20,.800,111,50,86,.581,36,61,.590,14,25,.560,26,34,.765,140
1086,MIL,2020-01-20,111,,CHI,W 111-98,240,45,77,.584,34,51,.667,11,26,.423,10,23,.435,111,34,92,.370,20,44,.455,14,48,.292,16,18,.889,98
1087,BRK,2020-01-20,111,,PHI,L 111-117,240,39,81,.481,28,52,.538,11,29,.379,22,34,.647,111,42,94,.447,29,55,.527,13,39,.333,20,27,.741,117
1088,WAS,2020-01-17,111,@,TOR,L 111-140,240,40,89,.449,25,54,.463,15,35,.429,16,23,.696,111,52,91,.571,30,48,.625,22,43,.512,14,16,.875,140
1089,CLE,2020-01-11,111,@,DEN,W 111-103,240,44,89,.494,32,52,.615,12,37,.324,11,13,.846,111,41,95,.432,33,56,.589,8,39,.205,13,18,.722,103
1090,NYK,2020-01-10,111,,NOP,L 111-123,240,46,100,.460,41,73,.562,5,27,.185,14,20,.700,111,48,86,.558,30,48,.625,18,38,.474,9,17,.529,123
1091,WAS,2020-01-10,111,,ATL,W 111-101,240,42,112,.375,32,83,.386,10,29,.345,17,28,.607,111,41,89,.461,34,60,.567,7,29,.241,12,24,.500,101
1092,OKC,2020-01-07,111,@,BRK,W 111-103 (OT),265,38,92,.413,27,55,.491,11,37,.297,24,29,.828,111,40,98,.408,29,61,.475,11,37,.297,12,16,.750,103
1093,SAC,2020-01-06,111,,GSW,W 111-98,240,39,81,.481,24,51,.471,15,30,.500,18,23,.783,111,34,86,.395,29,60,.483,5,26,.192,25,32,.781,98
1094,POR,2020-01-05,111,@,MIA,L 111-122,240,40,87,.460,27,50,.540,13,37,.351,18,20,.900,111,47,90,.522,29,46,.630,18,44,.409,10,16,.625,122
1095,IND,2020-01-04,111,@,ATL,L 111-116,240,36,87,.414,26,60,.433,10,27,.370,29,35,.829,111,42,82,.512,32,50,.640,10,32,.313,22,24,.917,116
1096,DET,2020-01-04,111,@,GSW,W 111-104,240,43,83,.518,32,56,.571,11,27,.407,14,16,.875,111,33,82,.402,22,61,.361,11,21,.524,27,32,.844,104
1097,BOS,2020-01-04,111,@,CHI,W 111-104,240,43,82,.524,35,63,.556,8,19,.421,17,21,.810,111,34,80,.425,21,46,.457,13,34,.382,23,31,.742,104
1098,BRK,2020-01-02,111,@,DAL,L 111-123,240,42,91,.462,30,54,.556,12,37,.324,15,17,.882,111,45,89,.506,27,51,.529,18,38,.474,15,17,.882,123
1099,MIL,2019-12-28,111,,ORL,W 111-100,240,43,84,.512,30,47,.638,13,37,.351,12,18,.667,111,35,87,.402,21,52,.404,14,35,.400,16,19,.842,100
1100,LAC,2019-12-25,111,@,LAL,W 111-106,240,39,85,.459,30,60,.500,9,25,.360,24,32,.750,111,39,96,.406,27,51,.529,12,45,.267,16,21,.762,106
1101,PHO,2019-12-23,111,,DEN,L 111-113,240,42,87,.483,29,50,.580,13,37,.351,14,18,.778,111,43,78,.551,28,50,.560,15,28,.536,12,15,.800,113
1102,MIL,2019-12-19,111,,LAL,W 111-104,240,36,77,.468,20,38,.526,16,39,.410,23,32,.719,111,37,80,.463,25,45,.556,12,35,.343,18,23,.783,104
1103,UTA,2019-12-19,111,@,ATL,W 111-106,240,39,83,.470,33,59,.559,6,24,.250,27,38,.711,111,39,90,.433,28,61,.459,11,29,.379,17,19,.895,106
1104,POR,2019-12-16,111,@,PHO,W 111-110,240,40,84,.476,26,50,.520,14,34,.412,17,20,.850,111,41,90,.456,29,56,.518,12,34,.353,16,19,.842,110
1105,MIA,2019-12-16,111,@,MEM,L 111-118,240,37,81,.457,26,57,.456,11,24,.458,26,31,.839,111,42,86,.488,29,50,.580,13,36,.361,21,30,.700,118
1106,DEN,2019-12-15,111,,NYK,W 111-105,240,44,94,.468,34,66,.515,10,28,.357,13,19,.684,111,44,94,.468,36,62,.581,8,32,.250,9,10,.900,105
1107,WAS,2019-12-14,111,@,MEM,L 111-128,240,36,85,.424,22,47,.468,14,38,.368,25,32,.781,111,48,84,.571,37,57,.649,11,27,.407,21,24,.875,128
1108,DET,2019-12-12,111,,DAL,L 111-122,240,40,89,.449,25,47,.532,15,42,.357,16,23,.696,111,45,88,.511,29,44,.659,16,44,.364,16,23,.696,122
1109,BRK,2019-12-06,111,@,CHO,W 111-104,240,42,88,.477,27,50,.540,15,38,.395,12,15,.800,111,36,83,.434,19,43,.442,17,40,.425,15,17,.882,104
1110,ATL,2019-11-30,111,@,HOU,L 111-158,240,38,89,.427,23,43,.535,15,46,.326,20,25,.800,111,52,89,.584,27,38,.711,25,51,.490,29,34,.853,158
1111,MIL,2019-11-27,111,,ATL,W 111-102,240,42,88,.477,32,54,.593,10,34,.294,17,27,.630,111,38,94,.404,27,60,.450,11,34,.324,15,22,.682,102
1112,IND,2019-11-23,111,,ORL,W 111-106,240,43,79,.544,33,55,.600,10,24,.417,15,16,.938,111,43,92,.467,30,61,.492,13,31,.419,7,9,.778,106
1113,SAS,2019-11-23,111,@,NYK,W 111-104,240,40,75,.533,28,52,.538,12,23,.522,19,28,.679,111,40,93,.430,25,53,.472,15,40,.375,9,15,.600,104
1114,CHI,2019-11-16,111,,BRK,L 111-117,240,32,91,.352,23,52,.442,9,39,.231,38,41,.927,111,40,88,.455,30,45,.667,10,43,.233,27,31,.871,117
1115,HOU,2019-11-15,111,,IND,W 111-102,240,36,89,.404,22,43,.512,14,46,.304,25,29,.862,111,37,82,.451,29,49,.592,8,33,.242,20,26,.769,102
1116,ORL,2019-11-15,111,,SAS,W 111-109,240,36,87,.414,24,58,.414,12,29,.414,27,34,.794,111,45,89,.506,32,63,.508,13,26,.500,6,10,.600,109
1117,IND,2019-11-12,111,,OKC,W 111-85,240,46,94,.489,39,71,.549,7,23,.304,12,13,.923,111,29,82,.354,23,57,.404,6,25,.240,21,24,.875,85
1118,CLE,2019-11-03,111,,DAL,L 111-131,240,39,96,.406,21,48,.438,18,48,.375,15,22,.682,111,50,94,.532,30,53,.566,20,41,.488,11,13,.846,131
1119,CHI,2019-10-30,111,@,CLE,L 111-117,240,39,90,.433,25,51,.490,14,39,.359,19,23,.826,111,41,78,.526,31,54,.574,10,24,.417,25,31,.806,117
1120,SAC,2019-10-30,111,,CHO,L 111-118,240,44,96,.458,30,50,.600,14,46,.304,9,12,.750,111,46,84,.548,30,52,.577,16,32,.500,10,14,.714,118
1121,LAC,2019-10-28,111,,CHO,W 111-96,240,40,83,.482,28,50,.560,12,33,.364,19,21,.905,111,36,83,.434,22,44,.500,14,39,.359,10,14,.714,96
1122,DET,2019-10-26,111,,PHI,L 111-117,240,41,76,.539,33,57,.579,8,19,.421,21,36,.583,111,42,87,.483,29,53,.547,13,34,.382,20,30,.667,117
1123,HOU,2019-10-24,111,,MIL,L 111-117,240,33,90,.367,17,42,.405,16,48,.333,29,39,.744,111,46,99,.465,30,53,.566,16,46,.348,9,18,.500,117
1124,NYK,2019-10-23,111,@,SAS,L 111-120,240,44,94,.468,34,64,.531,10,30,.333,13,18,.722,111,42,83,.506,35,62,.565,7,21,.333,29,36,.806,120
1125,SAC,2020-08-04,110,,DAL,L 110-114 (OT),265,43,104,.413,27,61,.443,16,43,.372,8,12,.667,110,33,90,.367,24,49,.490,9,41,.220,39,50,.780,114
1126,POR,2020-08-04,110,,HOU,W 110-102,240,39,95,.411,27,64,.422,12,31,.387,20,29,.690,110,34,87,.391,15,34,.441,19,53,.358,15,24,.625,102
1127,WAS,2020-08-02,110,@,BRK,L 110-118,240,40,88,.455,31,57,.544,9,31,.290,21,27,.778,110,38,90,.422,27,57,.474,11,33,.333,31,37,.838,118
1128,OKC,2020-08-01,110,,UTA,W 110-94,240,41,77,.532,31,51,.608,10,26,.385,18,24,.750,110,34,87,.391,26,56,.464,8,31,.258,18,22,.818,94
1129,BRK,2020-03-08,110,,CHI,W 110-107,240,32,64,.500,21,34,.618,11,30,.367,35,41,.854,110,39,92,.424,27,58,.466,12,34,.353,17,25,.680,107
1130,NOP,2020-03-06,110,,MIA,W 110-104,240,38,91,.418,24,53,.453,14,38,.368,20,28,.714,110,37,86,.430,28,53,.528,9,33,.273,21,31,.677,104
1131,GSW,2020-03-01,110,,WAS,L 110-124,240,42,89,.472,33,61,.541,9,28,.321,17,24,.708,110,40,82,.488,20,52,.385,20,30,.667,24,27,.889,124
1132,BOS,2020-02-29,110,,HOU,L 110-111 (OT),265,39,100,.390,26,58,.448,13,42,.310,19,25,.760,110,41,98,.418,26,43,.605,15,55,.273,14,18,.778,111
1133,WAS,2020-02-26,110,,BRK,W 110-106,240,41,96,.427,26,57,.456,15,39,.385,13,16,.813,110,36,87,.414,26,51,.510,10,36,.278,24,35,.686,106
1134,UTA,2020-02-22,110,,HOU,L 110-120,240,42,90,.467,35,59,.593,7,31,.226,19,24,.792,110,45,92,.489,25,44,.568,20,48,.417,10,14,.714,120
1135,PHI,2020-02-11,110,,LAC,W 110-103,240,44,95,.463,36,68,.529,8,27,.296,14,21,.667,110,40,90,.444,26,59,.441,14,31,.452,9,13,.692,103
1136,CHO,2020-02-04,110,@,HOU,L 110-125,240,39,83,.470,26,50,.520,13,33,.394,19,24,.792,110,43,97,.443,23,37,.622,20,60,.333,19,23,.826,125
1137,CHI,2020-01-27,110,,SAS,W 110-109,240,42,93,.452,28,56,.500,14,37,.378,12,15,.800,110,38,82,.463,28,57,.491,10,25,.400,23,34,.676,109
1138,HOU,2020-01-26,110,@,DEN,L 110-117,240,40,88,.455,29,55,.527,11,33,.333,19,27,.704,110,44,93,.473,33,65,.508,11,28,.393,18,20,.900,117
1139,TOR,2020-01-26,110,@,SAS,W 110-106,240,41,99,.414,25,49,.510,16,50,.320,12,15,.800,110,34,82,.415,18,45,.400,16,37,.432,22,24,.917,106
1140,NYK,2020-01-26,110,,BRK,W 110-97,240,49,92,.533,43,73,.589,6,19,.316,6,13,.462,110,34,81,.420,21,42,.500,13,39,.333,16,23,.696,97
1141,MIN,2020-01-22,110,@,CHI,L 110-117,240,41,86,.477,26,42,.619,15,44,.341,13,24,.542,110,39,84,.464,30,54,.556,9,30,.300,30,37,.811,117
1142,LAC,2020-01-21,110,@,DAL,W 110-107,240,36,97,.371,24,59,.407,12,38,.316,26,33,.788,110,39,91,.429,27,48,.563,12,43,.279,17,24,.708,107
1143,HOU,2020-01-14,110,@,MEM,L 110-121,240,37,86,.430,23,41,.561,14,45,.311,22,24,.917,110,46,91,.505,33,54,.611,13,37,.351,16,19,.842,121
1144,PHO,2020-01-14,110,@,ATL,L 110-123,240,40,87,.460,36,67,.537,4,20,.200,26,32,.813,110,46,93,.495,32,62,.516,14,31,.452,17,20,.850,123
1145,DET,2020-01-13,110,,NOP,L 110-117 (OT),265,40,99,.404,29,67,.433,11,32,.344,19,24,.792,110,43,103,.417,34,77,.442,9,26,.346,22,27,.815,117
1146,OKC,2020-01-11,110,,LAL,L 110-125,240,43,92,.467,34,61,.557,9,31,.290,15,17,.882,110,51,99,.515,36,67,.537,15,32,.469,8,10,.800,125
1147,CHO,2020-01-08,110,,TOR,L 110-112 (OT),265,38,86,.442,23,49,.469,15,37,.405,19,26,.731,110,42,94,.447,28,58,.483,14,36,.389,14,20,.700,112
1148,CHI,2020-01-06,110,@,DAL,L 110-118,240,46,98,.469,37,67,.552,9,31,.290,9,11,.818,110,44,84,.524,28,43,.651,16,41,.390,14,19,.737,118
1149,SAC,2019-12-28,110,,PHO,L 110-112,240,41,84,.488,29,53,.547,12,31,.387,16,24,.667,110,45,86,.523,36,60,.600,9,26,.346,13,15,.867,112
1150,MEM,2019-12-28,110,@,DEN,L 110-119,240,41,84,.488,32,54,.593,9,30,.300,19,25,.760,110,45,93,.484,36,64,.563,9,29,.310,20,27,.741,119
1151,MEM,2019-12-26,110,@,OKC,W 110-97,240,46,84,.548,36,59,.610,10,25,.400,8,11,.727,110,38,92,.413,28,57,.491,10,35,.286,11,13,.846,97
1152,TOR,2019-12-22,110,,DAL,W 110-107,240,37,94,.394,27,60,.450,10,34,.294,26,31,.839,110,35,90,.389,20,44,.455,15,46,.326,22,27,.815,107
1153,CHI,2019-12-18,110,@,WAS,W 110-109 (OT),265,39,97,.402,28,60,.467,11,37,.297,21,24,.875,110,34,95,.358,20,50,.400,14,45,.311,27,32,.844,109
1154,CHO,2019-12-17,110,,SAC,W 110-102,240,39,81,.481,26,51,.510,13,30,.433,19,27,.704,110,38,91,.418,24,52,.462,14,39,.359,12,13,.923,102
1155,PHO,2019-12-16,110,,POR,L 110-111,240,41,90,.456,29,56,.518,12,34,.353,16,19,.842,110,40,84,.476,26,50,.520,14,34,.412,17,20,.850,111
1156,TOR,2019-12-14,110,,BRK,W 110-102,240,38,98,.388,24,58,.414,14,40,.350,20,25,.800,110,39,101,.386,27,55,.491,12,46,.261,12,17,.706,102
1157,DEN,2019-12-14,110,,OKC,W 110-102,240,43,85,.506,36,58,.621,7,27,.259,17,23,.739,110,38,81,.469,32,58,.552,6,23,.261,20,23,.870,102
1158,MIA,2019-12-13,110,,LAL,L 110-113,240,39,85,.459,29,52,.558,10,33,.303,22,28,.786,110,43,87,.494,31,50,.620,12,37,.324,15,23,.652,113
1159,IND,2019-12-13,110,@,ATL,W 110-100,240,46,92,.500,39,70,.557,7,22,.318,11,15,.733,110,39,94,.415,33,66,.500,6,28,.214,16,23,.696,100
1160,CLE,2019-12-11,110,,HOU,L 110-116,240,46,89,.517,33,57,.579,13,32,.406,5,8,.625,110,43,87,.494,26,45,.578,17,42,.405,13,13,1.000,116
1161,BOS,2019-12-09,110,,CLE,W 110-88,240,45,78,.577,30,51,.588,15,27,.556,5,8,.625,110,36,91,.396,29,60,.483,7,31,.226,9,19,.474,88
1162,LAC,2019-12-09,110,@,IND,W 110-99,240,40,97,.412,30,65,.462,10,32,.313,20,27,.741,110,34,97,.351,24,62,.387,10,35,.286,21,28,.750,99
1163,MIL,2019-12-09,110,,ORL,W 110-101,240,43,92,.467,27,51,.529,16,41,.390,8,15,.533,110,35,92,.380,25,61,.410,10,31,.323,21,26,.808,101
1164,MEM,2019-12-09,110,@,GSW,W 110-102,240,41,82,.500,26,42,.619,15,40,.375,13,17,.765,110,35,93,.376,24,66,.364,11,27,.407,21,25,.840,102
1165,MIA,2019-12-08,110,,CHI,W 110-105 (OT),265,32,77,.416,21,42,.500,11,35,.314,35,44,.795,110,35,80,.438,22,44,.500,13,36,.361,22,27,.815,105
1166,PHI,2019-12-08,110,,TOR,W 110-104,240,40,79,.506,26,47,.553,14,32,.438,16,21,.762,110,38,88,.432,27,55,.491,11,33,.333,17,20,.850,104
1167,SAC,2019-12-08,110,@,DAL,W 110-106,240,44,85,.518,31,51,.608,13,34,.382,9,11,.818,110,41,86,.477,24,42,.571,17,44,.386,7,8,.875,106
1168,TOR,2019-12-03,110,,MIA,L 110-121 (OT),265,35,91,.385,24,48,.500,11,43,.256,29,36,.806,110,45,99,.455,30,61,.492,15,38,.395,16,21,.762,121
1169,UTA,2019-12-01,110,@,TOR,L 110-130,240,38,90,.422,25,55,.455,13,35,.371,21,29,.724,110,47,90,.522,28,54,.519,19,36,.528,17,21,.810,130
1170,CHO,2019-11-29,110,@,DET,W 110-107,240,40,83,.482,21,45,.467,19,38,.500,11,15,.733,110,41,83,.494,26,48,.542,15,35,.429,10,20,.500,107
1171,CLE,2019-11-29,110,,MIL,L 110-119,240,44,88,.500,27,54,.500,17,34,.500,5,10,.500,110,45,88,.511,33,54,.611,12,34,.353,17,23,.739,119
1172,BRK,2019-11-27,110,@,BOS,L 110-121,240,40,90,.444,19,34,.559,21,56,.375,9,19,.474,110,43,97,.443,30,63,.476,13,34,.382,22,24,.917,121
1173,NOP,2019-11-27,110,,LAL,L 110-114,240,34,84,.405,17,44,.386,17,40,.425,25,30,.833,110,44,85,.518,36,61,.590,8,24,.333,18,25,.720,114
1174,CLE,2019-11-23,110,,POR,W 110-104,240,37,87,.425,27,56,.482,10,31,.323,26,32,.813,110,39,87,.448,25,47,.532,14,40,.350,12,16,.750,104
1175,SAS,2019-11-18,110,@,DAL,L 110-117,240,44,96,.458,36,72,.500,8,24,.333,14,16,.875,110,42,84,.500,25,43,.581,17,41,.415,16,23,.696,117
1176,DAL,2019-11-16,110,,TOR,W 110-102,240,37,88,.420,28,49,.571,9,39,.231,27,33,.818,110,37,89,.416,20,48,.417,17,41,.415,11,15,.733,102
1177,CHO,2019-11-09,110,,NOP,L 110-115,240,36,88,.409,24,53,.453,12,35,.343,26,34,.765,110,40,75,.533,26,42,.619,14,33,.424,21,30,.700,115
1178,GSW,2019-11-01,110,,SAS,L 110-127,240,39,84,.464,26,56,.464,13,28,.464,19,21,.905,110,44,93,.473,31,58,.534,13,35,.371,26,30,.867,127
1179,DAL,2019-11-01,110,,LAL,L 110-119 (OT),265,40,102,.392,26,66,.394,14,36,.389,16,23,.696,110,47,96,.490,38,64,.594,9,32,.281,16,21,.762,119
1180,UTA,2019-10-30,110,,LAC,W 110-96,240,44,80,.550,33,56,.589,11,24,.458,11,16,.688,110,39,82,.476,31,59,.525,8,23,.348,10,12,.833,96
1181,GSW,2019-10-30,110,,PHO,L 110-121,240,36,82,.439,28,54,.519,8,28,.286,30,36,.833,110,44,96,.458,29,60,.483,15,36,.417,18,21,.857,121
1182,POR,2019-10-28,110,@,SAS,L 110-113,240,39,100,.390,29,67,.433,10,33,.303,22,27,.815,110,41,85,.482,34,63,.540,7,22,.318,24,32,.750,113
1183,CLE,2019-10-26,110,,IND,W 110-99,240,40,80,.500,29,49,.592,11,31,.355,19,29,.655,110,39,87,.448,29,59,.492,10,28,.357,11,13,.846,99
1184,CHI,2019-10-25,110,@,MEM,W 110-102,240,40,93,.430,28,51,.549,12,42,.286,18,24,.750,110,39,94,.415,29,65,.446,10,29,.345,14,20,.700,102
1185,IND,2019-10-23,110,,DET,L 110-119,240,41,89,.461,33,68,.485,8,21,.381,20,24,.833,110,41,78,.526,30,54,.556,11,24,.458,26,33,.788,119
1186,IND,2020-08-14,109,,MIA,W 109-92,240,43,89,.483,28,51,.549,15,38,.395,8,11,.727,109,31,87,.356,21,49,.429,10,38,.263,20,27,.741,92
1187,DEN,2020-08-14,109,@,TOR,L 109-117,240,36,87,.414,20,49,.408,16,38,.421,21,23,.913,109,45,90,.500,27,55,.491,18,35,.514,9,14,.643,117
1188,TOR,2020-08-05,109,@,ORL,W 109-99,240,38,78,.487,26,45,.578,12,33,.364,21,30,.700,109,35,87,.402,24,46,.522,11,41,.268,18,26,.692,99
1189,ORL,2020-08-04,109,@,IND,L 109-120,240,39,82,.476,27,48,.563,12,34,.353,19,23,.826,109,46,84,.548,33,51,.647,13,33,.394,15,19,.789,120
1190,NOP,2020-08-03,109,,MEM,W 109-99,240,37,82,.451,26,53,.491,11,29,.379,24,39,.615,109,37,93,.398,25,50,.500,12,43,.279,13,15,.867,99
1191,CHO,2020-03-11,109,@,MIA,W 109-98,240,37,82,.451,20,48,.417,17,34,.500,18,22,.818,109,39,84,.464,24,40,.600,15,44,.341,5,6,.833,98
1192,DAL,2020-03-10,109,@,SAS,L 109-119,240,42,92,.457,25,48,.521,17,44,.386,8,11,.727,109,46,89,.517,31,57,.544,15,32,.469,12,15,.800,119
1193,DEN,2020-03-09,109,,MIL,W 109-95,240,41,94,.436,25,53,.472,16,41,.390,11,12,.917,109,34,90,.378,19,40,.475,15,50,.300,12,18,.667,95
1194,DAL,2020-03-08,109,,IND,L 109-112,240,39,91,.429,25,48,.521,14,43,.326,17,25,.680,109,46,88,.523,38,65,.585,8,23,.348,12,18,.667,112
1195,LAC,2020-03-03,109,@,OKC,W 109-94,240,38,84,.452,27,48,.563,11,36,.306,22,26,.846,109,34,81,.420,25,53,.472,9,28,.321,17,26,.654,94
1196,CHI,2020-03-02,109,,DAL,W 109-107,240,44,94,.468,34,58,.586,10,36,.278,11,17,.647,109,40,84,.476,28,42,.667,12,42,.286,15,20,.750,107
1197,DAL,2020-02-26,109,@,SAS,W 109-103,240,36,86,.419,19,41,.463,17,45,.378,20,30,.667,109,39,92,.424,28,59,.475,11,33,.333,14,19,.737,103
1198,NOP,2020-02-25,109,@,LAL,L 109-118,240,39,86,.453,31,59,.525,8,27,.296,23,30,.767,109,45,102,.441,32,58,.552,13,44,.295,15,21,.714,118
1199,MIA,2020-02-09,109,@,POR,L 109-115,240,39,98,.398,19,49,.388,20,49,.408,11,14,.786,109,40,85,.471,21,43,.488,19,42,.452,16,22,.727,115
1200,OKC,2020-02-05,109,,CLE,W 109-103,240,38,81,.469,29,55,.527,9,26,.346,24,30,.800,109,41,89,.461,26,51,.510,15,38,.395,6,11,.545,103
1201,MIN,2020-02-03,109,@,SAC,L 109-113,240,37,85,.435,24,47,.511,13,38,.342,22,28,.786,109,38,75,.507,24,48,.500,14,27,.519,23,31,.742,113
1202,NOP,2020-02-02,109,@,HOU,L 109-117,240,42,94,.447,32,61,.525,10,33,.303,15,20,.750,109,41,105,.390,25,54,.463,16,51,.314,19,22,.864,117
1203,CLE,2020-01-30,109,,TOR,L 109-115,240,42,90,.467,29,54,.537,13,36,.361,12,14,.857,109,41,84,.488,29,52,.558,12,32,.375,21,28,.750,115
1204,BOS,2020-01-28,109,@,MIA,W 109-101,240,39,83,.470,26,47,.553,13,36,.361,18,24,.750,109,33,89,.371,24,52,.462,9,37,.243,26,31,.839,101
1205,SAS,2020-01-27,109,@,CHI,L 109-110,240,38,82,.463,28,57,.491,10,25,.400,23,34,.676,109,42,93,.452,28,56,.500,14,37,.378,12,15,.800,110
1206,PHO,2020-01-26,109,@,MEM,L 109-114,240,35,92,.380,24,63,.381,11,29,.379,28,35,.800,109,44,84,.524,36,65,.554,8,19,.421,18,26,.692,114
1207,BOS,2020-01-24,109,@,ORL,W 109-98,240,40,86,.465,26,51,.510,14,35,.400,15,18,.833,109,36,90,.400,24,53,.453,12,37,.324,14,19,.737,98
1208,GSW,2020-01-18,109,,ORL,W 109-95,240,43,94,.457,31,54,.574,12,40,.300,11,11,1.000,109,39,86,.453,30,55,.545,9,31,.290,8,13,.615,95
1209,CLE,2020-01-17,109,@,MEM,L 109-113,240,41,92,.446,32,56,.571,9,36,.250,18,26,.692,109,45,89,.506,36,61,.590,9,28,.321,14,20,.700,113
1210,DAL,2020-01-11,109,,PHI,W 109-91,240,40,79,.506,29,52,.558,11,27,.407,18,27,.667,109,37,98,.378,28,61,.459,9,37,.243,8,12,.667,91
1211,MIN,2020-01-11,109,@,HOU,L 109-139,240,36,95,.379,23,47,.489,13,48,.271,24,36,.667,109,49,95,.516,31,50,.620,18,45,.400,23,29,.793,139
1212,LAC,2020-01-10,109,,GSW,W 109-100,240,41,84,.488,30,45,.667,11,39,.282,16,22,.727,109,37,96,.385,29,57,.509,8,39,.205,18,25,.720,100
1213,UTA,2020-01-10,109,,CHO,W 109-92,240,40,79,.506,22,37,.595,18,42,.429,11,14,.786,109,35,75,.467,27,49,.551,8,26,.308,14,19,.737,92
1214,PHI,2020-01-09,109,,BOS,W 109-98,240,43,88,.489,32,61,.525,11,27,.407,12,17,.706,109,38,88,.432,24,52,.462,14,36,.389,8,8,1.000,98
1215,UTA,2020-01-04,109,@,ORL,W 109-96,240,42,93,.452,26,53,.491,16,40,.400,9,14,.643,109,38,85,.447,27,48,.563,11,37,.297,9,12,.750,96
1216,BOS,2020-01-03,109,,ATL,W 109-106,240,41,93,.441,35,68,.515,6,25,.240,21,29,.724,109,39,93,.419,23,48,.479,16,45,.356,12,15,.800,106
1217,CHO,2020-01-02,109,@,CLE,W 109-106,240,37,83,.446,22,45,.489,15,38,.395,20,24,.833,109,41,81,.506,28,46,.609,13,35,.371,11,14,.786,106
1218,OKC,2020-01-02,109,@,SAS,W 109-103,240,43,89,.483,34,64,.531,9,25,.360,14,20,.700,109,40,92,.435,27,61,.443,13,31,.419,10,12,.833,103
1219,BOS,2019-12-31,109,@,CHO,W 109-92,240,44,97,.454,30,59,.508,14,38,.368,7,10,.700,109,34,86,.395,22,52,.423,12,34,.353,12,16,.750,92
1220,DET,2019-12-28,109,@,SAS,L 109-136,240,40,90,.444,28,54,.519,12,36,.333,17,30,.567,109,53,93,.570,35,58,.603,18,35,.514,12,15,.800,136
1221,MIL,2019-12-25,109,@,PHI,L 109-121,240,45,95,.474,32,62,.516,13,33,.394,6,8,.750,109,44,101,.436,23,57,.404,21,44,.477,12,15,.800,121
1222,DET,2019-12-23,109,,PHI,L 109-125,240,43,84,.512,33,54,.611,10,30,.333,13,18,.722,109,52,95,.547,40,65,.615,12,30,.400,9,11,.818,125
1223,SAS,2019-12-21,109,,LAC,L 109-134,240,42,82,.512,32,54,.593,10,28,.357,15,19,.789,109,54,99,.545,42,63,.667,12,36,.333,14,19,.737,134
1224,DEN,2019-12-20,109,,MIN,W 109-100,240,44,89,.494,34,61,.557,10,28,.357,11,12,.917,109,36,87,.414,26,45,.578,10,42,.238,18,27,.667,100
1225,BOS,2019-12-18,109,@,DAL,W 109-103,240,35,86,.407,23,48,.479,12,38,.316,27,30,.900,109,34,87,.391,19,44,.432,15,43,.349,20,25,.800,103
1226,WAS,2019-12-18,109,,CHI,L 109-110 (OT),265,34,95,.358,20,50,.400,14,45,.311,27,32,.844,109,39,97,.402,28,60,.467,11,37,.297,21,24,.875,110
1227,UTA,2019-12-17,109,,ORL,W 109-102,240,42,90,.467,27,54,.500,15,36,.417,10,16,.625,109,42,93,.452,35,58,.603,7,35,.200,11,15,.733,102
1228,OKC,2019-12-16,109,,CHI,W 109-106,240,35,69,.507,19,35,.543,16,34,.471,23,28,.821,109,43,87,.494,34,56,.607,9,31,.290,11,13,.846,106
1229,HOU,2019-12-16,109,,SAS,W 109-107,240,40,98,.408,29,55,.527,11,43,.256,18,27,.667,109,39,91,.429,27,58,.466,12,33,.364,17,20,.850,107
1230,BRK,2019-12-15,109,,PHI,W 109-89,240,43,94,.457,34,70,.486,9,24,.375,14,18,.778,109,37,86,.430,32,60,.533,5,26,.192,10,17,.588,89
1231,CHI,2019-12-14,109,,LAC,W 109-106,240,40,85,.471,26,54,.481,14,31,.452,15,18,.833,109,35,80,.438,25,58,.431,10,22,.455,26,36,.722,106
1232,NOP,2019-12-13,109,@,PHI,L 109-116,240,38,88,.432,29,64,.453,9,24,.375,24,35,.686,109,43,87,.494,36,67,.537,7,20,.350,23,34,.676,116
1233,SAS,2019-12-12,109,,CLE,L 109-117 (OT),265,42,86,.488,37,70,.529,5,16,.313,20,25,.800,109,44,96,.458,29,51,.569,15,45,.333,14,20,.700,117
1234,BOS,2019-12-12,109,,PHI,L 109-115,240,42,91,.462,31,60,.517,11,31,.355,14,17,.824,109,41,82,.500,27,54,.500,14,28,.500,19,23,.826,115
1235,MIN,2019-12-09,109,@,PHO,L 109-125,240,40,85,.471,34,63,.540,6,22,.273,23,29,.793,109,47,95,.495,31,55,.564,16,40,.400,15,19,.789,125
1236,PHO,2019-12-07,109,@,HOU,L 109-115,240,40,96,.417,29,61,.475,11,35,.314,18,28,.643,109,41,91,.451,30,51,.588,11,40,.275,22,30,.733,115
1237,TOR,2019-12-05,109,,HOU,L 109-119,240,38,88,.432,26,49,.531,12,39,.308,21,24,.875,109,40,98,.408,18,43,.419,22,55,.400,17,19,.895,119
1238,PHO,2019-12-02,109,@,CHO,W 109-104,240,39,88,.443,30,46,.652,9,42,.214,22,30,.733,109,38,84,.452,31,59,.525,7,25,.280,21,26,.808,104
1239,MIA,2019-12-01,109,@,BRK,W 109-106,240,37,95,.389,25,58,.431,12,37,.324,23,28,.821,109,40,91,.440,26,49,.531,14,42,.333,12,16,.750,106
1240,OKC,2019-11-29,109,,NOP,W 109-104,240,43,90,.478,30,56,.536,13,34,.382,10,16,.625,109,39,87,.448,28,49,.571,11,38,.289,15,21,.714,104
1241,NOP,2019-11-24,109,@,LAC,L 109-134,240,43,98,.439,30,57,.526,13,41,.317,10,18,.556,109,46,98,.469,30,55,.545,16,43,.372,26,33,.788,134
1242,LAL,2019-11-23,109,@,MEM,W 109-108,240,38,84,.452,25,45,.556,13,39,.333,20,29,.690,109,43,89,.483,29,59,.492,14,30,.467,8,13,.615,108
1243,GSW,2019-11-22,109,@,UTA,L 109-113,240,43,94,.457,31,66,.470,12,28,.429,11,12,.917,109,43,85,.506,29,53,.547,14,32,.438,13,16,.813,113
1244,CHI,2019-11-20,109,,DET,W 109-89,240,39,91,.429,25,64,.391,14,27,.519,17,26,.654,109,28,83,.337,20,50,.400,8,33,.242,25,32,.781,89
1245,PHI,2019-11-20,109,,NYK,W 109-104,240,39,89,.438,26,57,.456,13,32,.406,18,26,.692,109,40,84,.476,27,59,.458,13,25,.520,11,15,.733,104
1246,MIA,2019-11-16,109,,NOP,W 109-94,240,44,81,.543,35,57,.614,9,24,.375,12,13,.923,109,37,82,.451,21,47,.447,16,35,.457,4,6,.667,94
1247,SAS,2019-11-15,109,@,ORL,L 109-111,240,45,89,.506,32,63,.508,13,26,.500,6,10,.600,109,36,87,.414,24,58,.414,12,29,.414,27,34,.794,111
1248,CHO,2019-11-15,109,,DET,W 109-106,240,43,96,.448,30,61,.492,13,35,.371,10,16,.625,109,40,81,.494,25,46,.543,15,35,.429,11,11,1.000,106
1249,SAS,2019-11-11,109,,MEM,L 109-113,240,42,90,.467,30,60,.500,12,30,.400,13,17,.765,109,44,87,.506,33,59,.559,11,28,.393,14,20,.700,113
1250,IND,2019-11-10,109,@,ORL,W 109-102,240,48,91,.527,39,71,.549,9,20,.450,4,5,.800,109,41,89,.461,26,53,.491,15,36,.417,5,6,.833,102
1251,ATL,2019-11-08,109,,SAC,L 109-121,240,46,87,.529,37,59,.627,9,28,.321,8,14,.571,109,42,76,.553,24,45,.533,18,31,.581,19,22,.864,121
1252,DEN,2019-11-05,109,,MIA,W 109-89,240,45,86,.523,36,63,.571,9,23,.391,10,16,.625,109,32,88,.364,23,59,.390,9,29,.310,16,25,.640,89
1253,PHI,2019-11-04,109,@,PHO,L 109-114,240,42,89,.472,29,60,.483,13,29,.448,12,20,.600,109,41,77,.532,30,49,.612,11,28,.393,21,27,.778,114
1254,BRK,2019-11-02,109,@,DET,L 109-113,240,43,93,.462,33,61,.541,10,32,.313,13,17,.765,109,41,91,.451,33,64,.516,8,27,.296,23,29,.793,113
1255,WAS,2019-11-02,109,,MIN,L 109-131,240,37,95,.389,25,60,.417,12,35,.343,23,27,.852,109,51,94,.543,34,55,.618,17,39,.436,12,17,.706,131
1256,DAL,2019-10-29,109,@,DEN,W 109-106,240,41,84,.488,28,47,.596,13,37,.351,14,24,.583,109,43,91,.473,32,59,.542,11,32,.344,9,13,.692,106
1257,MIA,2019-10-27,109,@,MIN,L 109-116,240,42,85,.494,27,49,.551,15,36,.417,10,15,.667,109,39,91,.429,26,46,.565,13,45,.289,25,33,.758,116
1258,NYK,2019-10-25,109,@,BRK,L 109-113,240,38,81,.469,21,56,.375,17,25,.680,16,28,.571,109,37,78,.474,21,41,.512,16,37,.432,23,34,.676,113
1259,IND,2020-08-12,108,@,HOU,W 108-104,240,40,100,.400,29,69,.420,11,31,.355,17,22,.773,108,32,86,.372,16,29,.552,16,57,.281,24,28,.857,104
1260,BRK,2020-08-11,108,@,ORL,W 108-96,240,38,89,.427,25,46,.543,13,43,.302,19,24,.792,108,32,83,.386,25,60,.417,7,23,.304,25,29,.862,96
1261,TOR,2020-08-09,108,,MEM,W 108-99,240,34,71,.479,19,32,.594,15,39,.385,25,33,.758,108,37,91,.407,23,49,.469,14,42,.333,11,16,.688,99
1262,PHI,2020-08-07,108,,ORL,W 108-101,240,38,93,.409,30,64,.469,8,29,.276,24,33,.727,108,37,88,.420,29,56,.518,8,32,.250,19,25,.760,101
1263,UTA,2020-08-03,108,,LAL,L 108-116,240,37,83,.446,25,40,.625,12,43,.279,22,25,.880,108,41,82,.500,32,56,.571,9,26,.346,25,31,.806,116
1264,SAS,2020-08-02,108,@,MEM,W 108-106,240,36,86,.419,24,57,.421,12,29,.414,24,33,.727,108,42,91,.462,35,61,.574,7,30,.233,15,18,.833,106
1265,CHI,2020-03-10,108,,CLE,W 108-103,240,42,84,.500,30,50,.600,12,34,.353,12,15,.800,108,40,80,.500,34,56,.607,6,24,.250,17,23,.739,103
1266,CHO,2020-03-07,108,,HOU,W 108-99,240,37,70,.529,22,38,.579,15,32,.469,19,25,.760,108,35,76,.461,20,31,.645,15,45,.333,14,20,.700,99
1267,IND,2020-03-06,108,@,CHI,W 108-102,240,38,75,.507,30,53,.566,8,22,.364,24,33,.727,108,40,97,.412,31,59,.525,9,38,.237,13,15,.867,102
1268,SAC,2020-03-05,108,,PHI,L 108-125,240,42,79,.532,31,50,.620,11,29,.379,13,18,.722,108,47,96,.490,30,59,.508,17,37,.459,14,17,.824,125
1269,CHI,2020-03-04,108,@,MIN,L 108-115,240,45,94,.479,34,64,.531,11,30,.367,7,11,.636,108,40,81,.494,21,38,.553,19,43,.442,16,25,.640,115
1270,SAC,2020-02-27,108,@,OKC,L 108-112,240,41,91,.451,29,56,.518,12,35,.343,14,14,1.000,108,41,84,.488,32,58,.552,9,26,.346,21,29,.724,112
1271,CLE,2020-02-26,108,,PHI,W 108-94,240,41,78,.526,30,54,.556,11,24,.458,15,17,.882,108,36,89,.404,23,51,.451,13,38,.342,9,14,.643,94
1272,MIL,2020-02-25,108,@,TOR,W 108-97,240,32,84,.381,18,42,.429,14,42,.333,30,36,.833,108,32,91,.352,14,39,.359,18,52,.346,15,21,.714,97
1273,WAS,2020-02-21,108,,CLE,L 108-113,240,41,106,.387,32,69,.464,9,37,.243,17,23,.739,108,43,81,.531,32,54,.593,11,27,.407,16,25,.640,113
1274,MIN,2020-02-12,108,,CHO,L 108-115,240,39,101,.386,25,52,.481,14,49,.286,16,20,.800,108,43,92,.467,29,58,.500,14,34,.412,15,23,.652,115
1275,PHO,2020-02-08,108,,DEN,L 108-117,240,38,87,.437,29,55,.527,9,32,.281,23,23,1.000,108,45,82,.549,34,54,.630,11,28,.393,16,21,.762,117
1276,OKC,2020-02-07,108,,DET,W 108-101,240,39,76,.513,34,53,.642,5,23,.217,25,30,.833,108,38,89,.427,27,51,.529,11,38,.289,14,19,.737,101
1277,PHO,2020-02-05,108,@,DET,L 108-116,240,42,77,.545,30,51,.588,12,26,.462,12,15,.800,108,46,95,.484,34,67,.507,12,28,.429,12,16,.750,116
1278,NOP,2020-02-04,108,,MIL,L 108-120,240,38,99,.384,24,50,.480,14,49,.286,18,24,.750,108,48,102,.471,37,66,.561,11,36,.306,13,17,.765,120
1279,LAC,2020-02-03,108,,SAS,W 108-105,240,39,84,.464,28,57,.491,11,27,.407,19,24,.792,108,40,95,.421,28,58,.483,12,37,.324,13,16,.813,105
1280,PHO,2020-02-02,108,@,MIL,L 108-129,240,41,104,.394,35,81,.432,6,23,.261,20,23,.870,108,48,97,.495,33,59,.559,15,38,.395,18,27,.667,129
1281,BOS,2020-01-26,108,@,NOP,L 108-123,240,41,89,.461,33,56,.589,8,33,.242,18,22,.818,108,44,92,.478,28,56,.500,16,36,.444,19,29,.655,123
1282,PHI,2020-01-25,108,,LAL,W 108-91,240,41,78,.526,28,41,.683,13,37,.351,13,19,.684,108,35,76,.461,29,45,.644,6,31,.194,15,23,.652,91
1283,OKC,2020-01-17,108,,MIA,L 108-115,240,37,84,.440,19,38,.500,18,46,.391,16,18,.889,108,41,84,.488,27,48,.563,14,36,.389,19,24,.792,115
1284,BRK,2020-01-12,108,,ATL,W 108-86,240,41,77,.532,31,51,.608,10,26,.385,16,29,.552,108,32,97,.330,20,49,.408,12,48,.250,10,11,.909,86
1285,CHI,2020-01-11,108,@,DET,W 108-99,240,42,83,.506,31,48,.646,11,35,.314,13,14,.929,108,36,78,.462,27,50,.540,9,28,.321,18,27,.667,99
1286,CHI,2020-01-08,108,@,NOP,L 108-123,240,41,92,.446,27,57,.474,14,35,.400,12,21,.571,108,41,87,.471,26,43,.605,15,44,.341,26,32,.813,123
1287,IND,2020-01-08,108,,MIA,L 108-122,240,40,84,.476,31,57,.544,9,27,.333,19,25,.760,108,43,81,.531,27,43,.628,16,38,.421,20,25,.800,122
1288,PHI,2020-01-03,108,@,HOU,L 108-118,240,42,92,.457,36,65,.554,6,27,.222,18,25,.720,108,41,86,.477,29,54,.537,12,32,.375,24,32,.750,118
1289,LAL,2019-12-29,108,,DAL,W 108-95,240,38,78,.487,29,55,.527,9,23,.391,23,28,.821,108,32,89,.360,19,46,.413,13,43,.302,18,20,.900,95
1290,HOU,2019-12-28,108,,BRK,W 108-98,240,44,101,.436,31,59,.525,13,42,.310,7,16,.438,108,37,92,.402,26,53,.491,11,39,.282,13,21,.619,98
1291,WAS,2019-12-21,108,@,PHI,L 108-125,240,36,88,.409,29,57,.509,7,31,.226,29,34,.853,108,49,94,.521,35,61,.574,14,33,.424,13,21,.619,125
1292,PHO,2019-12-20,108,@,OKC,L 108-126,240,38,87,.437,27,55,.491,11,32,.344,21,23,.913,108,49,87,.563,39,63,.619,10,24,.417,18,21,.857,126
1293,MIA,2019-12-18,108,@,PHI,W 108-104,240,40,85,.471,28,54,.519,12,31,.387,16,20,.800,108,38,90,.422,26,51,.510,12,39,.308,16,18,.889,104
1294,BRK,2019-12-17,108,@,NOP,W 108-101 (OT),265,40,96,.417,29,57,.509,11,39,.282,17,23,.739,108,37,107,.346,26,67,.388,11,40,.275,16,24,.667,101
1295,CLE,2019-12-14,108,@,MIL,L 108-125,240,41,90,.456,26,55,.473,15,35,.429,11,15,.733,108,46,85,.541,32,48,.667,14,37,.378,19,26,.731,125
1296,BRK,2019-12-11,108,,CHO,L 108-113,240,38,88,.432,28,50,.560,10,38,.263,22,33,.667,108,36,88,.409,21,53,.396,15,35,.429,26,32,.813,113
1297,PHO,2019-12-11,108,,MEM,L 108-115,240,37,93,.398,28,59,.475,9,34,.265,25,30,.833,108,42,87,.483,32,63,.508,10,24,.417,21,26,.808,115
1298,OKC,2019-12-08,108,@,POR,W 108-96,240,35,85,.412,24,53,.453,11,32,.344,27,34,.794,108,36,100,.360,27,67,.403,9,33,.273,15,18,.833,96
1299,BOS,2019-12-06,108,,DEN,W 108-95,240,44,82,.537,31,47,.660,13,35,.371,7,8,.875,108,39,94,.415,34,64,.531,5,30,.167,12,15,.800,95
1300,DET,2019-12-06,108,,IND,W 108-101,240,39,87,.448,28,62,.452,11,25,.440,19,26,.731,108,38,83,.458,29,59,.492,9,24,.375,16,20,.800,101
1301,MIA,2019-11-27,108,@,HOU,L 108-117,240,37,80,.463,23,43,.535,14,37,.378,20,27,.741,108,38,83,.458,23,39,.590,15,44,.341,26,33,.788,117
1302,BRK,2019-11-25,108,@,CLE,W 108-106,240,44,94,.468,33,60,.550,11,34,.324,9,11,.818,108,40,94,.426,27,62,.435,13,32,.406,13,20,.650,106
1303,MEM,2019-11-23,108,,LAL,L 108-109,240,43,89,.483,29,59,.492,14,30,.467,8,13,.615,108,38,84,.452,25,45,.556,13,39,.333,20,29,.690,109
1304,CHI,2019-11-22,108,,MIA,L 108-116,240,41,90,.456,31,60,.517,10,30,.333,16,20,.800,108,39,79,.494,25,41,.610,14,38,.368,24,28,.857,116
1305,POR,2019-11-18,108,@,HOU,L 108-132,240,40,96,.417,29,60,.483,11,36,.306,17,23,.739,108,47,100,.470,30,55,.545,17,45,.378,21,26,.808,132
1306,NOP,2019-11-17,108,,GSW,W 108-100,240,37,89,.416,19,43,.442,18,46,.391,16,20,.800,108,37,91,.407,30,66,.455,7,25,.280,19,23,.826,100
1307,MIA,2019-11-14,108,@,CLE,W 108-97,240,43,79,.544,31,49,.633,12,30,.400,10,11,.909,108,36,85,.424,28,53,.528,8,32,.250,17,21,.810,97
1308,DET,2019-11-12,108,@,MIA,L 108-117,240,34,78,.436,19,37,.514,15,41,.366,25,37,.676,108,41,77,.532,27,45,.600,14,32,.438,21,27,.778,117
1309,GSW,2019-11-11,108,,UTA,L 108-122,240,45,94,.479,35,63,.556,10,31,.323,8,14,.571,108,40,81,.494,24,46,.522,16,35,.457,26,32,.813,122
1310,CLE,2019-11-10,108,@,NYK,W 108-87,240,36,82,.439,28,54,.519,8,28,.286,28,31,.903,108,31,86,.360,22,55,.400,9,31,.290,16,25,.640,87
1311,GSW,2019-11-09,108,@,OKC,L 108-114,240,42,85,.494,35,63,.556,7,22,.318,17,17,1.000,108,43,79,.544,29,49,.592,14,30,.467,14,17,.824,114
1312,BOS,2019-11-07,108,@,CHO,W 108-87,240,40,93,.430,30,60,.500,10,33,.303,18,23,.783,108,33,86,.384,27,55,.491,6,31,.194,15,21,.714,87
1313,PHO,2019-11-07,108,,MIA,L 108-124,240,37,84,.440,26,52,.500,11,32,.344,23,31,.742,108,45,82,.549,30,54,.556,15,28,.536,19,24,.792,124
1314,ATL,2019-11-05,108,,SAS,W 108-100,240,43,90,.478,32,60,.533,11,30,.367,11,16,.688,108,38,91,.418,30,58,.517,8,33,.242,16,23,.696,100
1315,IND,2019-11-03,108,,CHI,W 108-95,240,40,85,.471,32,59,.542,8,26,.308,20,27,.741,108,36,84,.429,27,55,.491,9,29,.310,14,25,.560,95
1316,BRK,2019-10-30,108,,IND,L 108-118,240,41,93,.441,31,62,.500,10,31,.323,16,26,.615,108,45,96,.469,34,70,.486,11,26,.423,17,20,.850,118
1317,TOR,2019-10-26,108,@,CHI,W 108-84,240,38,82,.463,23,40,.575,15,42,.357,17,18,.944,108,29,97,.299,20,62,.323,9,35,.257,17,25,.680,84
1318,DEN,2019-10-25,108,,PHO,W 108-107 (OT),265,36,92,.391,29,65,.446,7,27,.259,29,36,.806,108,34,86,.395,26,58,.448,8,28,.286,31,32,.969,107
1319,DAL,2019-10-23,108,,WAS,W 108-100,240,35,76,.461,24,40,.600,11,36,.306,27,33,.818,108,37,93,.398,26,52,.500,11,41,.268,15,18,.833,100
1320,DEN,2019-10-23,108,@,POR,W 108-100,240,34,81,.420,16,49,.327,18,32,.563,22,27,.815,108,36,87,.414,29,59,.492,7,28,.250,21,23,.913,100
1321,LAC,2020-08-14,107,,OKC,W 107-103 (OT),265,34,85,.400,22,48,.458,12,37,.324,27,39,.692,107,38,106,.358,24,62,.387,14,44,.318,13,22,.591,103
1322,MEM,2020-08-11,107,,BOS,L 107-122,240,35,89,.393,28,60,.467,7,29,.241,30,38,.789,107,44,86,.512,28,49,.571,16,37,.432,18,23,.783,122
1323,WAS,2020-08-07,107,@,NOP,L 107-118,240,38,90,.422,28,63,.444,10,27,.370,21,23,.913,107,42,88,.477,30,53,.566,12,35,.343,22,26,.846,118
1324,PHI,2020-08-05,107,@,WAS,W 107-98,240,38,82,.463,27,53,.509,11,29,.379,20,29,.690,107,36,85,.424,29,64,.453,7,21,.333,19,24,.792,98
1325,TOR,2020-08-03,107,@,MIA,W 107-103,240,29,67,.433,13,35,.371,16,32,.500,33,36,.917,107,37,87,.425,23,42,.548,14,45,.311,15,16,.938,103
1326,TOR,2020-08-01,107,,LAL,W 107-92,240,35,84,.417,21,50,.420,14,34,.412,23,26,.885,107,29,82,.354,19,42,.452,10,40,.250,24,33,.727,92
1327,GSW,2020-03-10,107,,LAC,L 107-131,240,37,79,.468,26,41,.634,11,38,.289,22,27,.815,107,46,92,.500,26,48,.542,20,44,.455,19,19,1.000,131
1328,CHI,2020-03-08,107,@,BRK,L 107-110,240,39,92,.424,27,58,.466,12,34,.353,17,25,.680,107,32,64,.500,21,34,.618,11,30,.367,35,41,.854,110
1329,MIN,2020-03-08,107,,NOP,L 107-120,240,37,94,.394,29,61,.475,8,33,.242,25,31,.806,107,44,90,.489,33,55,.600,11,35,.314,21,31,.677,120
1330,DET,2020-03-04,107,,OKC,L 107-114,240,40,86,.465,22,43,.512,18,43,.419,9,15,.600,107,46,75,.613,36,51,.706,10,24,.417,12,17,.706,114
1331,PHI,2020-03-03,107,@,LAL,L 107-120,240,38,85,.447,22,45,.489,16,40,.400,15,20,.750,107,46,86,.535,33,53,.623,13,33,.394,15,18,.833,120
1332,ORL,2020-03-02,107,,POR,L 107-130,240,37,96,.385,23,53,.434,14,43,.326,19,22,.864,107,49,88,.557,33,55,.600,16,33,.485,16,16,1.000,130
1333,DAL,2020-03-02,107,@,CHI,L 107-109,240,40,84,.476,28,42,.667,12,42,.286,15,20,.750,107,44,94,.468,34,58,.586,10,36,.278,11,17,.647,109
1334,CHO,2020-02-26,107,,NYK,W 107-101,240,39,83,.470,29,53,.547,10,30,.333,19,25,.760,107,43,85,.506,39,70,.557,4,15,.267,11,17,.647,101
1335,POR,2020-02-23,107,,DET,W 107-104,240,41,84,.488,28,54,.519,13,30,.433,12,19,.632,107,37,86,.430,26,51,.510,11,35,.314,19,20,.950,104
1336,DAL,2020-02-22,107,@,ATL,L 107-111,240,40,89,.449,26,45,.578,14,44,.318,13,19,.684,107,43,98,.439,35,61,.574,8,37,.216,17,26,.654,111
1337,ATL,2020-02-07,107,@,BOS,L 107-112,240,35,86,.407,22,47,.468,13,39,.333,24,26,.923,107,37,86,.430,21,49,.429,16,37,.432,22,27,.815,112
1338,MEM,2020-02-07,107,@,PHI,L 107-119,240,38,93,.409,33,72,.458,5,21,.238,26,31,.839,107,48,90,.533,34,65,.523,14,25,.560,9,15,.600,119
1339,DAL,2020-02-05,107,,MEM,L 107-121,240,34,94,.362,17,51,.333,17,43,.395,22,24,.917,107,47,89,.528,35,64,.547,12,25,.480,15,20,.750,121
1340,UTA,2020-02-01,107,@,POR,L 107-124,240,40,94,.426,22,53,.415,18,41,.439,9,9,1.000,107,47,92,.511,32,63,.508,15,29,.517,15,18,.833,124
1341,BRK,2020-02-01,107,@,WAS,L 107-113,240,39,94,.415,23,47,.489,16,47,.340,13,21,.619,107,44,100,.440,35,68,.515,9,32,.281,16,26,.615,113
1342,PHO,2020-01-31,107,,OKC,L 107-111,240,36,76,.474,27,52,.519,9,24,.375,26,29,.897,107,42,97,.433,35,66,.530,7,31,.226,20,22,.909,111
1343,CHO,2020-01-30,107,@,WAS,L 107-121,240,43,99,.434,34,69,.493,9,30,.300,12,19,.632,107,41,86,.477,27,49,.551,14,37,.378,25,27,.926,121
1344,DAL,2020-01-27,107,@,OKC,W 107-97,240,41,99,.414,22,48,.458,19,51,.373,6,9,.667,107,34,86,.395,22,56,.393,12,30,.400,17,19,.895,97
1345,DAL,2020-01-25,107,@,UTA,L 107-112,240,42,97,.433,26,56,.464,16,41,.390,7,13,.538,107,40,91,.440,25,48,.521,15,43,.349,17,22,.773,112
1346,TOR,2020-01-22,107,,PHI,W 107-95,240,40,86,.465,27,53,.509,13,33,.394,14,21,.667,107,32,84,.381,14,38,.368,18,46,.391,13,18,.722,95
1347,DAL,2020-01-21,107,,LAC,L 107-110,240,39,91,.429,27,48,.563,12,43,.279,17,24,.708,107,36,97,.371,24,59,.407,12,38,.316,26,33,.788,110
1348,DEN,2020-01-20,107,@,MIN,W 107-100,240,43,90,.478,32,59,.542,11,31,.355,10,12,.833,107,38,91,.418,25,49,.510,13,42,.310,11,14,.786,100
1349,HOU,2020-01-20,107,,OKC,L 107-112,240,43,97,.443,34,52,.654,9,45,.200,12,17,.706,107,40,92,.435,28,60,.467,12,32,.375,20,26,.769,112
1350,LAL,2020-01-20,107,@,BOS,L 107-139,240,39,89,.438,32,63,.508,7,26,.269,22,29,.759,107,52,93,.559,36,59,.610,16,34,.471,19,29,.655,139
1351,DEN,2020-01-19,107,,IND,L 107-115,240,41,88,.466,38,65,.585,3,23,.130,22,32,.688,107,43,86,.500,30,57,.526,13,29,.448,16,19,.842,115
1352,SAS,2020-01-19,107,,MIA,W 107-102,240,36,85,.424,24,52,.462,12,33,.364,23,24,.958,107,37,86,.430,27,52,.519,10,34,.294,18,20,.900,102
1353,HOU,2020-01-15,107,,POR,L 107-117,240,38,96,.396,22,47,.468,16,49,.327,15,23,.652,107,41,95,.432,30,59,.508,11,36,.306,24,29,.828,117
1354,BRK,2020-01-14,107,,UTA,L 107-118,240,45,90,.500,37,64,.578,8,26,.308,9,15,.600,107,46,92,.500,33,56,.589,13,36,.361,13,15,.867,118
1355,MIL,2020-01-08,107,@,GSW,W 107-98,240,35,87,.402,26,46,.565,9,41,.220,28,32,.875,107,33,87,.379,18,49,.367,15,38,.395,17,20,.850,98
1356,DEN,2020-01-08,107,@,DAL,W 107-106,240,41,85,.482,32,61,.525,9,24,.375,16,20,.800,107,39,77,.506,27,42,.643,12,35,.343,16,24,.667,106
1357,PHO,2020-01-01,107,@,LAL,L 107-117,240,42,86,.488,36,63,.571,6,23,.261,17,23,.739,107,43,90,.478,36,62,.581,7,28,.250,24,34,.706,117
1358,NYK,2019-12-28,107,@,WAS,W 107-100,240,38,85,.447,27,54,.500,11,31,.355,20,26,.769,107,33,96,.344,23,71,.324,10,25,.400,24,31,.774,100
1359,LAC,2019-12-28,107,,UTA,L 107-120,240,35,95,.368,23,55,.418,12,40,.300,25,27,.926,107,45,86,.523,28,51,.549,17,35,.486,13,17,.765,120
1360,MIA,2019-12-23,107,,UTA,W 107-104,240,37,90,.411,28,65,.431,9,25,.360,24,27,.889,107,39,90,.433,27,54,.500,12,36,.333,14,18,.778,104
1361,DAL,2019-12-22,107,@,TOR,L 107-110,240,35,90,.389,20,44,.455,15,46,.326,22,27,.815,107,37,94,.394,27,60,.450,10,34,.294,26,31,.839,110
1362,CHO,2019-12-21,107,,UTA,L 107-114,240,39,85,.459,27,56,.482,12,29,.414,17,22,.773,107,39,75,.520,22,41,.537,17,34,.500,19,20,.950,114
1363,DET,2019-12-21,107,,CHI,L 107-119,240,40,87,.460,24,52,.462,16,35,.457,11,12,.917,107,40,77,.519,22,42,.524,18,35,.514,21,25,.840,119
1364,MEM,2019-12-20,107,@,CLE,L 107-114,240,44,102,.431,30,61,.492,14,41,.341,5,7,.714,107,40,92,.435,23,55,.418,17,37,.459,17,23,.739,114
1365,NOP,2019-12-18,107,@,MIN,W 107-99,240,38,86,.442,24,53,.453,14,33,.424,17,21,.810,107,36,95,.379,26,56,.464,10,39,.256,17,27,.630,99
1366,SAS,2019-12-16,107,@,HOU,L 107-109,240,39,91,.429,27,58,.466,12,33,.364,17,20,.850,107,40,98,.408,29,55,.527,11,43,.256,18,27,.667,109
1367,IND,2019-12-15,107,,CHO,W 107-85,240,40,88,.455,30,53,.566,10,35,.286,17,20,.850,107,28,91,.308,23,59,.390,5,32,.156,24,35,.686,85
1368,HOU,2019-12-14,107,,DET,L 107-115,240,41,102,.402,28,57,.491,13,45,.289,12,18,.667,107,41,92,.446,29,55,.527,12,37,.324,21,25,.840,115
1369,ORL,2019-12-13,107,,HOU,L 107-130,240,40,91,.440,25,54,.463,15,37,.405,12,16,.750,107,48,86,.558,26,47,.553,22,39,.564,12,13,.923,130
1370,WAS,2019-12-10,107,@,CHO,L 107-114,240,38,90,.422,27,55,.491,11,35,.314,20,25,.800,107,38,85,.447,22,44,.500,16,41,.390,22,28,.786,114
1371,CHO,2019-12-08,107,,ATL,L 107-122,240,36,90,.400,25,59,.424,11,31,.355,24,29,.828,107,44,91,.484,26,46,.565,18,45,.400,16,17,.941,122
1372,IND,2019-12-04,107,@,OKC,W 107-100,240,42,87,.483,33,63,.524,9,24,.375,14,17,.824,107,41,84,.488,32,58,.552,9,26,.346,9,10,.900,100
1373,MIN,2019-12-01,107,,MEM,L 107-115,240,33,85,.388,22,49,.449,11,36,.306,30,35,.857,107,41,100,.410,25,60,.417,16,40,.400,17,21,.810,115
1374,OKC,2019-12-01,107,@,NOP,W 107-104,240,38,81,.469,27,48,.563,11,33,.333,20,26,.769,107,39,87,.448,22,49,.449,17,38,.447,9,10,.900,104
1375,POR,2019-11-29,107,,CHI,W 107-103,240,38,84,.452,28,54,.519,10,30,.333,21,28,.750,107,36,94,.383,22,56,.393,14,38,.368,17,25,.680,103
1376,SAS,2019-11-29,107,,LAC,W 107-97,240,40,93,.430,26,57,.456,14,36,.389,13,14,.929,107,36,92,.391,24,59,.407,12,33,.364,13,13,1.000,97
1377,BOS,2019-11-29,107,@,BRK,L 107-112,240,41,93,.441,32,65,.492,9,28,.321,16,21,.762,107,43,93,.462,26,52,.500,17,41,.415,9,13,.692,112
1378,DET,2019-11-29,107,,CHO,L 107-110,240,41,83,.494,26,48,.542,15,35,.429,10,20,.500,107,40,83,.482,21,45,.467,19,38,.500,11,15,.733,110
1379,LAC,2019-11-20,107,,BOS,W 107-104 (OT),265,39,93,.419,22,48,.458,17,45,.378,12,16,.750,107,41,104,.394,29,59,.492,12,45,.267,10,14,.714,104
1380,OKC,2019-11-19,107,@,LAL,L 107-112,240,38,80,.475,29,52,.558,9,28,.321,22,25,.880,107,43,89,.483,29,58,.500,14,31,.452,12,19,.632,112
1381,MEM,2019-11-15,107,,UTA,W 107-106,240,43,96,.448,33,61,.541,10,35,.286,11,13,.846,107,35,87,.402,26,53,.491,9,34,.265,27,32,.844,106
1382,SAC,2019-11-12,107,,POR,W 107-99,240,38,86,.442,27,54,.500,11,32,.344,20,26,.769,107,34,77,.442,26,47,.553,8,30,.267,23,30,.767,99
1383,LAC,2019-11-07,107,,POR,W 107-101,240,39,89,.438,35,66,.530,4,23,.174,25,30,.833,107,39,104,.375,28,65,.431,11,39,.282,12,16,.750,101
1384,DAL,2019-11-06,107,,ORL,W 107-106,240,36,84,.429,25,53,.472,11,31,.355,24,30,.800,107,39,80,.488,33,56,.589,6,24,.250,22,28,.786,106
1385,HOU,2019-11-04,107,@,MEM,W 107-100,240,35,93,.376,18,43,.419,17,50,.340,20,29,.690,107,40,94,.426,37,69,.536,3,25,.120,17,21,.810,100
1386,DEN,2019-10-31,107,@,NOP,L 107-122,240,43,89,.483,36,63,.571,7,26,.269,14,16,.875,107,41,77,.532,26,44,.591,15,33,.455,25,32,.781,122
1387,PHO,2019-10-25,107,@,DEN,L 107-108 (OT),265,34,86,.395,26,58,.448,8,28,.286,31,32,.969,107,36,92,.391,29,65,.446,7,27,.259,29,36,.806,108
1388,PHI,2019-10-23,107,,BOS,W 107-93,240,37,85,.435,30,56,.536,7,29,.241,26,36,.722,107,33,90,.367,26,64,.406,7,26,.269,20,34,.588,93
1389,MIL,2020-08-13,106,@,MEM,L 106-119,240,39,98,.398,26,57,.456,13,41,.317,15,23,.652,106,45,90,.500,32,57,.561,13,33,.394,16,23,.696,119
1390,NOP,2020-08-11,106,@,SAC,L 106-112,240,42,82,.512,35,58,.603,7,24,.292,15,19,.789,106,43,88,.489,32,62,.516,11,26,.423,15,16,.938,112
1391,MIL,2020-08-10,106,,TOR,L 106-114,240,33,84,.393,19,41,.463,14,43,.326,26,35,.743,106,42,97,.433,30,57,.526,12,40,.300,18,26,.692,114
1392,SAC,2020-08-07,106,@,BRK,L 106-119,240,38,89,.427,26,49,.531,12,40,.300,18,24,.750,106,42,86,.488,25,46,.543,17,40,.425,18,28,.643,119
1393,BOS,2020-08-04,106,@,MIA,L 106-112,240,37,85,.435,27,52,.519,10,33,.303,22,27,.815,106,34,77,.442,19,34,.559,15,43,.349,29,39,.744,112
1394,MEM,2020-08-02,106,,SAS,L 106-108,240,42,91,.462,35,61,.574,7,30,.233,15,18,.833,106,36,86,.419,24,57,.421,12,29,.414,24,33,.727,108
1395,UTA,2020-07-30,106,@,NOP,W 106-104,240,37,84,.440,29,50,.580,8,34,.235,24,28,.857,106,40,94,.426,29,63,.460,11,31,.355,13,18,.722,104
1396,DET,2020-03-11,106,@,PHI,L 106-124,240,39,84,.464,28,49,.571,11,35,.314,17,25,.680,106,42,83,.506,28,50,.560,14,33,.424,26,32,.813,124
1397,HOU,2020-03-08,106,,ORL,L 106-126,240,39,88,.443,30,56,.536,9,32,.281,19,25,.760,106,44,91,.484,31,62,.500,13,29,.448,25,31,.806,126
1398,CLE,2020-03-04,106,,BOS,L 106-112,240,39,89,.438,26,51,.510,13,38,.342,15,20,.750,106,40,86,.465,29,56,.518,11,30,.367,21,26,.808,112
1399,SAC,2020-03-01,106,,DET,W 106-100,240,37,91,.407,28,56,.500,9,35,.257,23,26,.885,106,33,80,.413,15,38,.395,18,42,.429,16,24,.667,100
1400,NYK,2020-02-27,106,@,PHI,L 106-115,240,42,83,.506,34,60,.567,8,23,.348,14,24,.583,106,45,91,.495,30,60,.500,15,31,.484,10,13,.769,115
1401,IND,2020-02-27,106,,POR,W 106-100,240,40,90,.444,32,65,.492,8,25,.320,18,23,.783,106,41,89,.461,32,59,.542,9,30,.300,9,14,.643,100
1402,BRK,2020-02-26,106,@,WAS,L 106-110,240,36,87,.414,26,51,.510,10,36,.278,24,35,.686,106,41,96,.427,26,57,.456,15,39,.385,13,16,.813,110
1403,POR,2020-02-25,106,,BOS,L 106-118,240,38,85,.447,25,54,.463,13,31,.419,17,23,.739,106,43,90,.478,24,51,.471,19,39,.487,13,14,.929,118
1404,ORL,2020-02-21,106,,DAL,L 106-122,240,41,104,.394,32,61,.525,9,43,.209,15,19,.789,106,43,84,.512,28,46,.609,15,38,.395,21,26,.808,122
1405,IND,2020-02-21,106,@,NYK,W 106-98,240,36,88,.409,28,60,.467,8,28,.286,26,33,.788,106,35,81,.432,24,56,.429,11,25,.440,17,25,.680,98
1406,DET,2020-02-20,106,,MIL,L 106-126,240,40,83,.482,27,46,.587,13,37,.351,13,16,.813,106,47,93,.505,37,60,.617,10,33,.303,22,27,.815,126
1407,GSW,2020-02-12,106,@,PHO,L 106-112,240,39,77,.506,28,46,.609,11,31,.355,17,19,.895,106,42,91,.462,28,54,.519,14,37,.378,14,15,.933,112
1408,OKC,2020-02-11,106,,SAS,L 106-114,240,39,85,.459,28,54,.519,11,31,.355,17,21,.810,106,41,84,.488,34,59,.576,7,25,.280,25,27,.926,114
1409,BRK,2020-02-10,106,@,IND,W 106-105,240,35,87,.402,23,50,.460,12,37,.324,24,32,.750,106,45,92,.489,38,62,.613,7,30,.233,8,11,.727,105
1410,MEM,2020-02-09,106,@,WAS,W 106-99,240,43,102,.422,38,70,.543,5,32,.156,15,25,.600,106,35,100,.350,28,67,.418,7,33,.212,22,29,.759,99
1411,IND,2020-02-07,106,,TOR,L 106-115,240,39,86,.453,29,52,.558,10,34,.294,18,22,.818,106,42,88,.477,25,50,.500,17,38,.447,14,17,.824,115
1412,PHI,2020-02-03,106,@,MIA,L 106-137,240,36,83,.434,23,45,.511,13,38,.342,21,25,.840,106,48,85,.565,32,53,.604,16,32,.500,25,30,.833,137
1413,MIN,2020-02-01,106,@,LAC,L 106-118,240,34,84,.405,27,45,.600,7,39,.179,31,37,.838,106,45,98,.459,33,64,.516,12,34,.353,16,18,.889,118
1414,DEN,2020-01-30,106,,UTA,W 106-100,240,40,85,.471,31,58,.534,9,27,.333,17,21,.810,106,36,78,.462,19,41,.463,17,37,.459,11,17,.647,100
1415,CHI,2020-01-29,106,@,IND,L 106-115 (OT),265,45,85,.529,39,52,.750,6,33,.182,10,15,.667,106,46,89,.517,39,62,.629,7,27,.259,16,22,.727,115
1416,NYK,2020-01-29,106,,MEM,L 106-127,240,39,91,.429,30,63,.476,9,28,.321,19,29,.655,106,43,86,.500,30,58,.517,13,28,.464,28,33,.848,127
1417,SAS,2020-01-26,106,,TOR,L 106-110,240,34,82,.415,18,45,.400,16,37,.432,22,24,.917,106,41,99,.414,25,49,.510,16,50,.320,12,15,.800,110
1418,CLE,2020-01-25,106,,CHI,L 106-118,240,42,84,.500,29,54,.537,13,30,.433,9,11,.818,106,44,85,.518,32,52,.615,12,33,.364,18,24,.750,118
1419,NOP,2020-01-24,106,,DEN,L 106-113,240,38,82,.463,26,55,.473,12,27,.444,18,30,.600,106,40,106,.377,27,65,.415,13,41,.317,20,20,1.000,113
1420,SAC,2020-01-22,106,@,DET,L 106-127,240,42,98,.429,32,63,.508,10,35,.286,12,23,.522,106,39,73,.534,27,44,.614,12,29,.414,37,44,.841,127
1421,NYK,2020-01-20,106,@,CLE,W 106-86,240,41,85,.482,32,62,.516,9,23,.391,15,17,.882,106,32,94,.340,21,61,.344,11,33,.333,11,17,.647,86
1422,ORL,2020-01-20,106,@,CHO,W 106-83,240,44,92,.478,30,64,.469,14,28,.500,4,9,.444,106,29,76,.382,19,43,.442,10,33,.303,15,20,.750,83
1423,WAS,2020-01-20,106,,DET,W 106-100,240,42,82,.512,33,58,.569,9,24,.375,13,16,.813,106,38,89,.427,28,57,.491,10,32,.313,14,20,.700,100
1424,POR,2020-01-18,106,@,OKC,L 106-119,240,39,91,.429,27,59,.458,12,32,.375,16,21,.762,106,43,83,.518,36,61,.590,7,22,.318,26,36,.722,119
1425,MIA,2020-01-15,106,,SAS,W 106-100,240,41,88,.466,24,48,.500,17,40,.425,7,13,.538,106,39,89,.438,29,56,.518,10,33,.303,12,15,.800,100
1426,BRK,2020-01-15,106,@,PHI,L 106-117,240,38,87,.437,26,62,.419,12,25,.480,18,30,.600,106,45,88,.511,34,58,.586,11,30,.367,16,25,.640,117
1427,WAS,2020-01-15,106,@,CHI,L 106-115,240,37,79,.468,26,52,.500,11,27,.407,21,26,.808,106,43,85,.506,29,47,.617,14,38,.368,15,22,.682,115
1428,SAC,2020-01-10,106,,MIL,L 106-127,240,44,96,.458,34,61,.557,10,35,.286,8,10,.800,106,47,95,.495,37,56,.661,10,39,.256,23,30,.767,127
1429,DAL,2020-01-08,106,,DEN,L 106-107,240,39,77,.506,27,42,.643,12,35,.343,16,24,.667,106,41,85,.482,32,61,.525,9,24,.375,16,20,.800,107
1430,LAL,2020-01-05,106,,DET,W 106-99,240,42,92,.457,36,72,.500,6,20,.300,16,23,.696,106,29,78,.372,18,52,.346,11,26,.423,30,35,.857,99
1431,CLE,2020-01-04,106,,OKC,L 106-121,240,39,85,.459,25,55,.455,14,30,.467,14,17,.824,106,43,96,.448,29,59,.492,14,37,.378,21,26,.808,121
1432,ATL,2020-01-03,106,@,BOS,L 106-109,240,39,93,.419,23,48,.479,16,45,.356,12,15,.800,106,41,93,.441,35,68,.515,6,25,.240,21,29,.724,109
1433,CLE,2020-01-02,106,,CHO,L 106-109,240,41,81,.506,28,46,.609,13,35,.371,11,14,.786,106,37,83,.446,22,45,.489,15,38,.395,20,24,.833,109
1434,MIL,2020-01-01,106,,MIN,W 106-104,240,40,94,.426,31,58,.534,9,36,.250,17,26,.654,106,34,91,.374,19,45,.422,15,46,.326,21,28,.750,104
1435,OKC,2019-12-31,106,,DAL,W 106-101,240,39,91,.429,33,64,.516,6,27,.222,22,28,.786,106,33,93,.355,18,42,.429,15,51,.294,20,27,.741,101
1436,LAL,2019-12-25,106,,LAC,L 106-111,240,39,96,.406,27,51,.529,12,45,.267,16,21,.762,106,39,85,.459,30,60,.500,9,25,.360,24,32,.750,111
1437,MIN,2019-12-21,106,@,POR,L 106-113,240,38,87,.437,23,50,.460,15,37,.405,15,16,.938,106,40,94,.426,27,59,.458,13,35,.371,20,25,.800,113
1438,GSW,2019-12-20,106,,NOP,W 106-102,240,36,83,.434,26,50,.520,10,33,.303,24,25,.960,106,39,93,.419,30,59,.508,9,34,.265,15,23,.652,102
1439,ATL,2019-12-19,106,,UTA,L 106-111,240,39,90,.433,28,61,.459,11,29,.379,17,19,.895,106,39,83,.470,33,59,.559,6,24,.250,27,38,.711,111
1440,CHI,2019-12-16,106,@,OKC,L 106-109,240,43,87,.494,34,56,.607,9,31,.290,11,13,.846,106,35,69,.507,19,35,.543,16,34,.471,23,28,.821,109
1441,LAC,2019-12-14,106,@,CHI,L 106-109,240,35,80,.438,25,58,.431,10,22,.455,26,36,.722,106,40,85,.471,26,54,.481,14,31,.452,15,18,.833,109
1442,GSW,2019-12-13,106,@,UTA,L 106-114,240,41,91,.451,32,62,.516,9,29,.310,15,22,.682,106,37,79,.468,21,41,.512,16,38,.421,24,31,.774,114
1443,DAL,2019-12-08,106,,SAC,L 106-110,240,41,86,.477,24,42,.571,17,44,.386,7,8,.875,106,44,85,.518,31,51,.608,13,34,.382,9,11,.818,110
1444,CHO,2019-12-04,106,,GSW,W 106-91,240,40,87,.460,19,39,.487,21,48,.438,5,8,.625,106,36,78,.462,27,55,.491,9,23,.391,10,15,.667,91
1445,CHI,2019-12-04,106,,MEM,W 106-99,240,33,77,.429,20,44,.455,13,33,.394,27,37,.730,106,37,96,.385,30,66,.455,7,30,.233,18,21,.857,99
1446,SAC,2019-12-02,106,,CHI,L 106-113,240,40,83,.482,31,50,.620,9,33,.273,17,20,.850,106,36,75,.480,20,38,.526,16,37,.432,25,29,.862,113
1447,BRK,2019-12-01,106,,MIA,L 106-109,240,40,91,.440,26,49,.531,14,42,.333,12,16,.750,106,37,95,.389,25,58,.431,12,37,.324,23,28,.821,109
1448,CLE,2019-11-25,106,,BRK,L 106-108,240,40,94,.426,27,62,.435,13,32,.406,13,20,.650,106,44,94,.468,33,60,.550,11,34,.324,9,11,.818,108
1449,WAS,2019-11-24,106,,SAC,L 106-113,240,42,92,.457,29,58,.500,13,34,.382,9,12,.750,106,39,81,.481,28,50,.560,11,31,.355,24,28,.857,113
1450,ORL,2019-11-23,106,@,IND,L 106-111,240,43,92,.467,30,61,.492,13,31,.419,7,9,.778,106,43,79,.544,33,55,.600,10,24,.417,15,16,.938,111
1451,UTA,2019-11-15,106,@,MEM,L 106-107,240,35,87,.402,26,53,.491,9,34,.265,27,32,.844,106,43,96,.448,33,61,.541,10,35,.286,11,13,.846,107
1452,DET,2019-11-15,106,@,CHO,L 106-109,240,40,81,.494,25,46,.543,15,35,.429,11,11,1.000,106,43,96,.448,30,61,.492,13,35,.371,10,16,.625,109
1453,NYK,2019-11-14,106,,DAL,W 106-103,240,42,94,.447,29,64,.453,13,30,.433,9,11,.818,106,36,84,.429,28,48,.583,8,36,.222,23,31,.742,103
1454,POR,2019-11-13,106,,TOR,L 106-114,240,38,96,.396,21,48,.438,17,48,.354,13,16,.813,106,42,92,.457,28,60,.467,14,32,.438,16,17,.941,114
1455,DAL,2019-11-11,106,@,BOS,L 106-116,240,37,89,.416,26,47,.553,11,42,.262,21,28,.750,106,41,86,.477,26,51,.510,15,35,.429,19,25,.760,116
1456,CHO,2019-11-10,106,@,PHI,L 106-114,240,38,84,.452,24,51,.471,14,33,.424,16,22,.727,106,46,84,.548,36,56,.643,10,28,.357,12,16,.750,114
1457,DET,2019-11-08,106,@,IND,L 106-112,240,39,86,.453,26,53,.491,13,33,.394,15,18,.833,106,43,83,.518,39,68,.574,4,15,.267,22,25,.880,112
1458,NYK,2019-11-08,106,@,DAL,W 106-102,240,37,89,.416,23,61,.377,14,28,.500,18,31,.581,106,37,90,.411,23,46,.500,14,44,.318,14,17,.824,102
1459,ORL,2019-11-06,106,@,DAL,L 106-107,240,39,80,.488,33,56,.589,6,24,.250,22,28,.786,106,36,84,.429,25,53,.472,11,31,.355,24,30,.800,107
1460,UTA,2019-11-06,106,,PHI,W 106-104,240,41,89,.461,33,67,.493,8,22,.364,16,24,.667,106,33,80,.413,25,55,.455,8,25,.320,30,34,.882,104
1461,WAS,2019-11-06,106,@,IND,L 106-121,240,37,95,.389,24,55,.436,13,40,.325,19,19,1.000,106,44,94,.468,32,64,.500,12,30,.400,21,26,.808,121
1462,MIN,2019-11-04,106,,MIL,L 106-134,240,37,103,.359,24,60,.400,13,43,.302,19,22,.864,106,50,93,.538,36,54,.667,14,39,.359,20,30,.667,134
1463,DET,2019-11-01,106,@,CHI,L 106-112,240,41,85,.482,35,56,.625,6,29,.207,18,24,.750,106,39,89,.438,23,49,.469,16,40,.400,18,23,.783,112
1464,MIA,2019-10-31,106,@,ATL,W 106-97,240,40,84,.476,26,47,.553,14,37,.378,12,19,.632,106,36,88,.409,29,54,.537,7,34,.206,18,26,.692,97
1465,DEN,2019-10-29,106,,DAL,L 106-109,240,43,91,.473,32,59,.542,11,32,.344,9,13,.692,106,41,84,.488,28,47,.596,13,37,.351,14,24,.583,109
1466,TOR,2019-10-25,106,@,BOS,L 106-112,240,37,78,.474,19,42,.452,18,36,.500,14,17,.824,106,42,109,.385,29,71,.408,13,38,.342,15,16,.938,112
1467,HOU,2020-08-11,105,@,SAS,L 105-123,240,36,89,.404,22,41,.537,14,48,.292,19,21,.905,105,46,93,.495,33,61,.541,13,32,.406,18,20,.900,123
1468,OKC,2020-08-05,105,@,LAL,W 105-86,240,34,79,.430,29,55,.527,5,24,.208,32,36,.889,105,31,88,.352,26,51,.510,5,37,.135,19,29,.655,86
1469,DEN,2020-08-01,105,,MIA,L 105-125,240,39,89,.438,31,54,.574,8,35,.229,19,24,.792,105,40,72,.556,27,43,.628,13,29,.448,32,37,.865,125
1470,PHO,2020-03-10,105,@,POR,L 105-121,240,35,87,.402,24,55,.436,11,32,.344,24,25,.960,105,45,89,.506,28,54,.519,17,35,.486,14,17,.824,121
1471,OKC,2020-03-08,105,@,BOS,W 105-104,240,35,79,.443,25,54,.463,10,25,.400,25,34,.735,105,38,92,.413,25,55,.455,13,37,.351,15,19,.789,104
1472,DET,2020-03-07,105,,UTA,L 105-111,240,40,86,.465,31,56,.554,9,30,.300,16,22,.727,105,40,77,.519,30,44,.682,10,33,.303,21,28,.750,111
1473,HOU,2020-03-05,105,,LAC,L 105-120,240,35,97,.361,28,55,.509,7,42,.167,28,36,.778,105,39,84,.464,26,44,.591,13,40,.325,29,39,.744,120
1474,MIA,2020-03-02,105,,MIL,W 105-89,240,37,86,.430,19,49,.388,18,37,.486,13,18,.722,105,35,86,.407,28,52,.538,7,34,.206,12,19,.632,89
1475,MEM,2020-02-29,105,,LAL,W 105-88,240,43,95,.453,33,64,.516,10,31,.323,9,11,.818,105,36,87,.414,27,52,.519,9,35,.257,7,12,.583,88
1476,CLE,2020-02-22,105,@,MIA,L 105-124,240,38,79,.481,25,43,.581,13,36,.361,16,22,.727,105,45,79,.570,26,39,.667,19,40,.475,15,20,.750,124
1477,MEM,2020-02-21,105,@,LAL,L 105-117,240,42,92,.457,37,77,.481,5,15,.333,16,31,.516,105,41,86,.477,32,57,.561,9,29,.310,26,40,.650,117
1478,GSW,2020-02-20,105,,HOU,L 105-135,240,44,89,.494,37,56,.661,7,33,.212,10,12,.833,105,45,85,.529,20,36,.556,25,49,.510,20,22,.909,135
1479,ATL,2020-02-12,105,@,CLE,L 105-127,240,36,84,.429,23,50,.460,13,34,.382,20,25,.800,105,48,94,.511,38,66,.576,10,28,.357,21,25,.840,127
1480,BOS,2020-02-11,105,@,HOU,L 105-116,240,37,85,.435,26,53,.491,11,32,.344,20,25,.800,105,33,77,.429,20,32,.625,13,45,.289,37,42,.881,116
1481,IND,2020-02-10,105,,BRK,L 105-106,240,45,92,.489,38,62,.613,7,30,.233,8,11,.727,105,35,87,.402,23,50,.460,12,37,.324,24,32,.750,106
1482,SAC,2020-02-07,105,,MIA,W 105-97,240,40,82,.488,21,38,.553,19,44,.432,6,12,.500,105,34,77,.442,22,37,.595,12,40,.300,17,25,.680,97
1483,NYK,2020-02-06,105,,ORL,W 105-103,240,43,92,.467,37,72,.514,6,20,.300,13,19,.684,105,34,75,.453,25,44,.568,9,31,.290,26,30,.867,103
1484,SAS,2020-02-03,105,@,LAC,L 105-108,240,40,95,.421,28,58,.483,12,37,.324,13,16,.813,105,39,84,.464,28,57,.491,11,27,.407,19,24,.792,108
1485,TOR,2020-01-31,105,@,DET,W 105-92,240,44,85,.518,35,58,.603,9,27,.333,8,11,.727,105,28,79,.354,17,43,.395,11,36,.306,25,34,.735,92
1486,DEN,2020-01-22,105,@,HOU,L 105-121,240,42,92,.457,32,64,.500,10,28,.357,11,15,.733,105,42,89,.472,29,60,.483,13,29,.448,24,28,.857,121
1487,SAS,2020-01-12,105,@,TOR,W 105-104,240,38,87,.437,31,55,.564,7,32,.219,22,30,.733,105,39,96,.406,22,48,.458,17,48,.354,9,11,.818,104
1488,NOP,2020-01-11,105,@,BOS,L 105-140,240,40,100,.400,26,55,.473,14,45,.311,11,18,.611,105,55,100,.550,41,71,.577,14,29,.483,16,18,.889,140
1489,CHI,2020-01-10,105,,IND,L 105-116,240,37,80,.463,19,39,.487,18,41,.439,13,16,.813,105,48,84,.571,37,54,.685,11,30,.367,9,14,.643,116
1490,ORL,2020-01-03,105,,MIA,W 105-85,240,33,81,.407,20,46,.435,13,35,.371,26,29,.897,105,30,80,.375,23,43,.535,7,37,.189,18,23,.783,85
1491,LAC,2019-12-31,105,@,SAC,W 105-87,240,36,88,.409,24,52,.462,12,36,.333,21,22,.955,105,33,80,.413,25,52,.481,8,28,.286,13,19,.684,87
1492,MIA,2019-12-30,105,@,WAS,L 105-123,240,33,73,.452,23,45,.511,10,28,.357,29,39,.744,105,43,84,.512,26,47,.553,17,37,.459,20,30,.667,123
1493,GSW,2019-12-27,105,,PHO,W 105-96,240,38,92,.413,29,65,.446,9,27,.333,20,25,.800,105,35,75,.467,28,42,.667,7,33,.212,19,24,.792,96
1494,MIN,2019-12-26,105,@,SAC,W 105-104 (2OT),290,36,104,.346,26,58,.448,10,46,.217,23,29,.793,105,37,107,.346,28,68,.412,9,39,.231,21,25,.840,104
1495,SAC,2019-12-20,105,@,IND,L 105-119,240,41,91,.451,31,59,.525,10,32,.313,13,15,.867,105,45,86,.523,31,55,.564,14,31,.452,15,18,.833,119
1496,BRK,2019-12-19,105,@,SAS,L 105-118,240,35,83,.422,28,47,.596,7,36,.194,28,30,.933,105,43,96,.448,30,63,.476,13,33,.394,19,23,.826,118
1497,IND,2019-12-17,105,,LAL,W 105-102,240,41,85,.482,31,60,.517,10,25,.400,13,20,.650,105,43,91,.473,35,60,.583,8,31,.258,8,17,.471,102
1498,NYK,2019-12-15,105,@,DEN,L 105-111,240,44,94,.468,36,62,.581,8,32,.250,9,10,.900,105,44,94,.468,34,66,.515,10,28,.357,13,19,.684,111
1499,DET,2019-12-09,105,@,NOP,W 105-103,240,36,85,.424,25,50,.500,11,35,.314,22,27,.815,105,40,91,.440,32,53,.604,8,38,.211,15,22,.682,103
1500,CHI,2019-12-08,105,@,MIA,L 105-110 (OT),265,35,80,.438,22,44,.500,13,36,.361,22,27,.815,105,32,77,.416,21,42,.500,11,35,.314,35,44,.795,110
1501,BRK,2019-12-08,105,,DEN,W 105-102,240,40,87,.460,33,59,.559,7,28,.250,18,23,.783,105,36,89,.404,18,47,.383,18,42,.429,12,14,.857,102
1502,SAS,2019-12-06,105,,SAC,W 105-104 (OT),265,41,96,.427,30,64,.469,11,32,.344,12,17,.706,105,40,102,.392,31,68,.456,9,34,.265,15,18,.833,104
1503,LAL,2019-12-03,105,@,DEN,W 105-96,240,39,84,.464,32,60,.533,7,24,.292,20,30,.667,105,37,91,.407,31,62,.500,6,29,.207,16,17,.941,96
1504,GSW,2019-11-29,105,@,MIA,L 105-122,240,30,77,.390,20,49,.408,10,28,.357,35,40,.875,105,44,82,.537,31,57,.544,13,25,.520,21,28,.750,122
1505,IND,2019-11-29,105,,ATL,W 105-104 (OT),265,39,92,.424,33,66,.500,6,26,.231,21,28,.750,105,39,90,.433,30,58,.517,9,32,.281,17,18,.944,104
1506,DEN,2019-11-20,105,,HOU,W 105-95,240,44,94,.468,35,67,.522,9,27,.333,8,15,.533,105,32,76,.421,20,38,.526,12,38,.316,19,25,.760,95
1507,CLE,2019-11-18,105,@,NYK,L 105-123,240,36,76,.474,19,40,.475,17,36,.472,16,30,.533,105,44,98,.449,36,75,.480,8,23,.348,27,35,.771,123
1508,MIN,2019-11-16,105,,HOU,L 105-125,240,38,84,.452,26,46,.565,12,38,.316,17,23,.739,105,43,94,.457,24,45,.533,19,49,.388,20,22,.909,125
1509,BOS,2019-11-15,105,@,GSW,W 105-100,240,37,91,.407,24,58,.414,13,33,.394,18,23,.783,105,34,82,.415,29,54,.537,5,28,.179,27,34,.794,100
1510,LAC,2019-11-03,105,,UTA,W 105-94,240,36,92,.391,29,60,.483,7,32,.219,26,34,.765,105,31,78,.397,21,47,.447,10,31,.323,22,31,.710,94
1511,MEM,2019-11-02,105,,PHO,L 105-114,240,42,86,.488,33,58,.569,9,28,.321,12,19,.632,105,44,88,.500,30,54,.556,14,34,.412,12,16,.750,114
1512,TOR,2019-11-02,105,@,MIL,L 105-115,240,34,84,.405,19,48,.396,15,36,.417,22,25,.880,105,41,89,.461,28,51,.549,13,38,.342,20,25,.800,115
1513,MIL,2019-10-30,105,@,BOS,L 105-116,240,38,82,.463,24,37,.649,14,45,.311,15,24,.625,105,41,92,.446,24,51,.471,17,41,.415,17,21,.810,116
1514,NYK,2019-10-28,105,,CHI,W 105-98,240,38,91,.418,29,62,.468,9,29,.310,20,32,.625,105,36,85,.424,27,50,.540,9,35,.257,17,21,.810,98
1515,PHI,2019-10-28,105,@,ATL,W 105-103,240,37,88,.420,26,47,.553,11,41,.268,20,25,.800,105,36,84,.429,27,57,.474,9,27,.333,22,32,.688,103
1516,HOU,2020-08-12,104,,IND,L 104-108,240,32,86,.372,16,29,.552,16,57,.281,24,28,.857,104,40,100,.400,29,69,.420,11,31,.355,17,22,.773,108
1517,NOP,2020-07-30,104,,UTA,L 104-106,240,40,94,.426,29,63,.460,11,31,.355,13,18,.722,104,37,84,.440,29,50,.580,8,34,.235,24,28,.857,106
1518,BRK,2020-03-10,104,@,LAL,W 104-102,240,37,90,.411,24,50,.480,13,40,.325,17,23,.739,104,40,87,.460,25,47,.532,15,40,.375,7,12,.583,102
1519,BOS,2020-03-08,104,,OKC,L 104-105,240,38,92,.413,25,55,.455,13,37,.351,15,19,.789,104,35,79,.443,25,54,.463,10,25,.400,25,34,.735,105
1520,CLE,2020-03-07,104,,DEN,W 104-102,240,42,76,.553,30,48,.625,12,28,.429,8,12,.667,104,43,85,.506,30,53,.566,13,32,.406,3,8,.375,102
1521,MIA,2020-03-06,104,@,NOP,L 104-110,240,37,86,.430,28,53,.528,9,33,.273,21,31,.677,104,38,91,.418,24,53,.453,14,38,.368,20,28,.714,110
1522,NYK,2020-03-04,104,,UTA,L 104-112,240,41,85,.482,34,65,.523,7,20,.350,15,18,.833,104,41,81,.506,31,45,.689,10,36,.278,20,25,.800,112
1523,WAS,2020-03-04,104,@,POR,L 104-125,240,40,103,.388,29,68,.426,11,35,.314,13,21,.619,104,42,81,.519,29,50,.580,13,31,.419,28,32,.875,125
1524,SAS,2020-03-03,104,@,CHO,W 104-103,240,38,80,.475,27,48,.563,11,32,.344,17,20,.850,104,39,82,.476,27,53,.509,12,29,.414,13,18,.722,103
1525,CLE,2020-02-29,104,,IND,L 104-113,240,41,85,.482,36,63,.571,5,22,.227,17,20,.850,104,47,87,.540,39,64,.609,8,23,.348,11,14,.786,113
1526,CLE,2020-02-28,104,@,NOP,L 104-116,240,43,95,.453,32,64,.500,11,31,.355,7,12,.583,104,48,88,.545,39,65,.600,9,23,.391,11,15,.733,116
1527,SAC,2020-02-28,104,@,MEM,W 104-101,240,38,91,.418,27,53,.509,11,38,.289,17,21,.810,104,39,91,.429,31,61,.508,8,30,.267,15,20,.750,101
1528,DET,2020-02-23,104,@,POR,L 104-107,240,37,86,.430,26,51,.510,11,35,.314,19,20,.950,104,41,84,.488,28,54,.519,13,30,.433,12,19,.632,107
1529,CHI,2020-02-22,104,,PHO,L 104-112,240,36,83,.434,22,45,.489,14,38,.368,18,21,.857,104,38,86,.442,28,56,.500,10,30,.333,26,31,.839,112
1530,UTA,2020-02-21,104,,SAS,L 104-113,240,35,82,.427,23,49,.469,12,33,.364,22,26,.846,104,40,91,.440,30,71,.423,10,20,.500,23,26,.885,113
1531,BRK,2020-02-20,104,@,PHI,L 104-112 (OT),265,36,102,.353,26,68,.382,10,34,.294,22,28,.786,104,38,86,.442,34,64,.531,4,22,.182,32,35,.914,112
1532,POR,2020-02-12,104,@,MEM,L 104-111,240,36,97,.371,23,60,.383,13,37,.351,19,24,.792,104,45,95,.474,39,72,.542,6,23,.261,15,22,.682,111
1533,GSW,2020-01-30,104,@,BOS,L 104-119,240,33,77,.429,21,38,.553,12,39,.308,26,30,.867,104,42,88,.477,27,53,.509,15,35,.429,20,22,.909,119
1534,DAL,2020-01-28,104,,PHO,L 104-133,240,37,83,.446,30,50,.600,7,33,.212,23,27,.852,104,51,86,.593,39,58,.672,12,28,.429,19,21,.905,133
1535,GSW,2020-01-28,104,@,PHI,L 104-115,240,37,87,.425,22,47,.468,15,40,.375,15,21,.714,104,42,82,.512,31,50,.620,11,32,.344,20,26,.769,115
1536,MEM,2020-01-28,104,,DEN,W 104-96,240,46,82,.561,40,64,.625,6,18,.333,6,14,.429,104,32,86,.372,15,41,.366,17,45,.378,15,18,.833,96
1537,MIN,2020-01-25,104,,OKC,L 104-113,240,40,90,.444,28,47,.596,12,43,.279,12,18,.667,104,39,80,.488,28,56,.500,11,24,.458,24,25,.960,113
1538,IND,2020-01-15,104,@,MIN,W 104-99,240,44,85,.518,37,62,.597,7,23,.304,9,12,.750,104,38,88,.432,27,60,.450,11,28,.393,12,16,.750,99
1539,MIN,2020-01-13,104,,OKC,L 104-117,240,38,91,.418,26,56,.464,12,35,.343,16,21,.762,104,41,82,.500,29,52,.558,12,30,.400,23,26,.885,117
1540,TOR,2020-01-12,104,,SAS,L 104-105,240,39,96,.406,22,48,.458,17,48,.354,9,11,.818,104,38,87,.437,31,55,.564,7,32,.219,22,30,.733,105
1541,LAC,2020-01-12,104,@,DEN,L 104-114,240,38,84,.452,30,51,.588,8,33,.242,20,26,.769,104,37,77,.481,26,52,.500,11,25,.440,29,37,.784,114
1542,NYK,2020-01-08,104,@,UTA,L 104-128,240,42,97,.433,33,72,.458,9,25,.360,11,11,1.000,104,49,90,.544,33,47,.702,16,43,.372,14,23,.609,128
1543,MIL,2020-01-06,104,@,SAS,L 104-126,240,38,95,.400,23,50,.460,15,45,.333,13,14,.929,104,45,88,.511,26,53,.491,19,35,.543,17,19,.895,126
1544,CHO,2020-01-06,104,,IND,L 104-115,240,37,81,.457,27,51,.529,10,30,.333,20,22,.909,104,47,89,.528,37,63,.587,10,26,.385,11,14,.786,115
1545,CHI,2020-01-04,104,,BOS,L 104-111,240,34,80,.425,21,46,.457,13,34,.382,23,31,.742,104,43,82,.524,35,63,.556,8,19,.421,17,21,.810,111
1546,GSW,2020-01-04,104,,DET,L 104-111,240,33,82,.402,22,61,.361,11,21,.524,27,32,.844,104,43,83,.518,32,56,.571,11,27,.407,14,16,.875,111
1547,MIN,2020-01-01,104,@,MIL,L 104-106,240,34,91,.374,19,45,.422,15,46,.326,21,28,.750,104,40,94,.426,31,58,.534,9,36,.250,17,26,.654,106
1548,DEN,2019-12-31,104,@,HOU,L 104-130,240,45,97,.464,37,72,.514,8,25,.320,6,9,.667,104,46,87,.529,30,53,.566,16,34,.471,22,31,.710,130
1549,UTA,2019-12-30,104,,DET,W 104-81,240,39,83,.470,29,57,.509,10,26,.385,16,20,.800,104,30,79,.380,26,65,.400,4,14,.286,17,23,.739,81
1550,CHO,2019-12-29,104,@,MEM,L 104-117,240,37,86,.430,28,55,.509,9,31,.290,21,32,.656,104,45,93,.484,35,58,.603,10,35,.286,17,17,1.000,117
1551,OKC,2019-12-27,104,@,CHO,W 104-102 (OT),265,40,89,.449,35,58,.603,5,31,.161,19,31,.613,104,42,101,.416,35,62,.565,7,39,.179,11,18,.611,102
1552,SAC,2019-12-26,104,,MIN,L 104-105 (2OT),290,37,107,.346,28,68,.412,9,39,.231,21,25,.840,104,36,104,.346,26,58,.448,10,46,.217,23,29,.793,105
1553,HOU,2019-12-25,104,@,GSW,L 104-116,240,37,100,.370,21,49,.429,16,51,.314,14,16,.875,104,41,87,.471,32,59,.542,9,28,.321,25,28,.893,116
1554,MIN,2019-12-23,104,@,GSW,L 104-113,240,35,87,.402,24,53,.453,11,34,.324,23,29,.793,104,38,87,.437,26,57,.456,12,30,.400,25,30,.833,113
1555,SAC,2019-12-23,104,,HOU,L 104-113,240,41,87,.471,34,57,.596,7,30,.233,15,23,.652,104,39,87,.448,24,48,.500,15,39,.385,20,23,.870,113
1556,UTA,2019-12-23,104,@,MIA,L 104-107,240,39,90,.433,27,54,.500,12,36,.333,14,18,.778,104,37,90,.411,28,65,.431,9,25,.360,24,27,.889,107
1557,LAL,2019-12-22,104,,DEN,L 104-128,240,39,83,.470,29,54,.537,10,29,.345,16,22,.727,104,45,92,.489,34,60,.567,11,32,.344,27,30,.900,128
1558,LAL,2019-12-19,104,@,MIL,L 104-111,240,37,80,.463,25,45,.556,12,35,.343,18,23,.783,104,36,77,.468,20,38,.526,16,39,.410,23,32,.719,111
1559,ORL,2019-12-18,104,@,DEN,L 104-113,240,37,87,.425,26,58,.448,11,29,.379,19,21,.905,104,40,84,.476,29,57,.509,11,27,.407,22,25,.880,113
1560,PHI,2019-12-18,104,,MIA,L 104-108,240,38,90,.422,26,51,.510,12,39,.308,16,18,.889,104,40,85,.471,28,54,.519,12,31,.387,16,20,.800,108
1561,OKC,2019-12-09,104,@,UTA,W 104-90,240,40,85,.471,32,57,.561,8,28,.286,16,19,.842,104,36,89,.404,28,58,.483,8,31,.258,10,12,.833,90
1562,TOR,2019-12-08,104,@,PHI,L 104-110,240,38,88,.432,27,55,.491,11,33,.333,17,20,.850,104,40,79,.506,26,47,.553,14,32,.438,16,21,.762,110
1563,IND,2019-12-07,104,@,NYK,W 104-103,240,41,85,.482,29,57,.509,12,28,.429,10,13,.769,104,39,96,.406,29,65,.446,10,31,.323,15,21,.714,103
1564,CHO,2019-12-06,104,,BRK,L 104-111,240,36,83,.434,19,43,.442,17,40,.425,15,17,.882,104,42,88,.477,27,50,.540,15,38,.395,12,15,.800,111
1565,SAC,2019-12-06,104,@,SAS,L 104-105 (OT),265,40,102,.392,31,68,.456,9,34,.265,15,18,.833,104,41,96,.427,30,64,.469,11,32,.344,12,17,.706,105
1566,ATL,2019-12-02,104,,GSW,W 104-79,240,41,89,.461,33,60,.550,8,29,.276,14,15,.933,104,33,83,.398,30,66,.455,3,17,.176,10,12,.833,79
1567,CHO,2019-12-02,104,,PHO,L 104-109,240,38,84,.452,31,59,.525,7,25,.280,21,26,.808,104,39,88,.443,30,46,.652,9,42,.214,22,30,.733,109
1568,MEM,2019-12-02,104,,IND,L 104-117,240,38,89,.427,28,51,.549,10,38,.263,18,19,.947,104,44,88,.500,28,50,.560,16,38,.421,13,15,.867,117
1569,NOP,2019-12-01,104,,OKC,L 104-107,240,39,87,.448,22,49,.449,17,38,.447,9,10,.900,104,38,81,.469,27,48,.563,11,33,.333,20,26,.769,107
1570,NYK,2019-12-01,104,,BOS,L 104-113,240,35,76,.461,27,50,.540,8,26,.308,26,37,.703,104,41,93,.441,26,52,.500,15,41,.366,16,22,.727,113
1571,NOP,2019-11-29,104,@,OKC,L 104-109,240,39,87,.448,28,49,.571,11,38,.289,15,21,.714,104,43,90,.478,30,56,.536,13,34,.382,10,16,.625,109
1572,ATL,2019-11-29,104,@,IND,L 104-105 (OT),265,39,90,.433,30,58,.517,9,32,.281,17,18,.944,104,39,92,.424,33,66,.500,6,26,.231,21,28,.750,105
1573,CLE,2019-11-27,104,,ORL,L 104-116,240,37,81,.457,26,47,.553,11,34,.324,19,22,.864,104,45,93,.484,33,60,.550,12,33,.364,14,17,.824,116
1574,GSW,2019-11-27,104,,CHI,W 104-90,240,37,81,.457,26,52,.500,11,29,.379,19,26,.731,104,34,89,.382,24,60,.400,10,29,.345,12,18,.667,90
1575,WAS,2019-11-26,104,@,DEN,L 104-117,240,40,95,.421,30,55,.545,10,40,.250,14,21,.667,104,47,90,.522,41,66,.621,6,24,.250,17,23,.739,117
1576,SAS,2019-11-25,104,,LAL,L 104-114,240,41,88,.466,31,63,.492,10,25,.400,12,15,.800,104,44,89,.494,30,56,.536,14,33,.424,12,18,.667,114
1577,PHO,2019-11-24,104,@,DEN,L 104-116,240,41,82,.500,29,47,.617,12,35,.343,10,12,.833,104,43,91,.473,29,60,.483,14,31,.452,16,23,.696,116
1578,MIL,2019-11-23,104,,DET,W 104-90,240,41,84,.488,28,47,.596,13,37,.351,9,18,.500,104,37,91,.407,27,56,.482,10,35,.286,6,10,.600,90
1579,NYK,2019-11-23,104,,SAS,L 104-111,240,40,93,.430,25,53,.472,15,40,.375,9,15,.600,104,40,75,.533,28,52,.538,12,23,.522,19,28,.679,111
1580,POR,2019-11-23,104,@,CLE,L 104-110,240,39,87,.448,25,47,.532,14,40,.350,12,16,.750,104,37,87,.425,27,56,.482,10,31,.323,26,32,.813,110
1581,SAS,2019-11-22,104,@,PHI,L 104-115,240,43,85,.506,37,67,.552,6,18,.333,12,16,.750,104,46,89,.517,36,63,.571,10,26,.385,13,19,.684,115
1582,NYK,2019-11-20,104,@,PHI,L 104-109,240,40,84,.476,27,59,.458,13,25,.520,11,15,.733,104,39,89,.438,26,57,.456,13,32,.406,18,26,.692,109
1583,BOS,2019-11-20,104,@,LAC,L 104-107 (OT),265,41,104,.394,29,59,.492,12,45,.267,10,14,.714,104,39,93,.419,22,48,.458,17,45,.378,12,16,.750,107
1584,POR,2019-11-19,104,@,NOP,L 104-115,240,40,92,.435,24,63,.381,16,29,.552,8,13,.615,104,41,93,.441,28,57,.491,13,36,.361,20,24,.833,115
1585,LAL,2019-11-10,104,,TOR,L 104-113,240,41,94,.436,31,64,.484,10,30,.333,12,19,.632,104,43,89,.483,31,53,.585,12,36,.333,15,22,.682,113
1586,NOP,2019-11-08,104,,TOR,L 104-122,240,40,99,.404,30,58,.517,10,41,.244,14,21,.667,104,41,93,.441,22,50,.440,19,43,.442,21,24,.875,122
1587,PHI,2019-11-06,104,@,UTA,L 104-106,240,33,80,.413,25,55,.455,8,25,.320,30,34,.882,104,41,89,.461,33,67,.493,8,22,.364,16,24,.667,106
1588,NOP,2019-11-02,104,@,OKC,L 104-115,240,40,94,.426,29,62,.468,11,32,.344,13,22,.591,104,41,90,.456,26,53,.491,15,37,.405,18,23,.783,115
1589,BOS,2019-11-01,104,,NYK,W 104-102,240,33,74,.446,22,40,.550,11,34,.324,27,29,.931,104,37,93,.398,23,55,.418,14,38,.368,14,21,.667,102
1590,TOR,2019-10-28,104,,ORL,W 104-95,240,33,85,.388,23,46,.500,10,39,.256,28,30,.933,104,34,89,.382,22,50,.440,12,39,.308,15,18,.833,95
1591,OKC,2020-08-14,103,@,LAC,L 103-107 (OT),265,38,106,.358,24,62,.387,14,44,.318,13,22,.591,103,34,85,.400,22,48,.458,12,37,.324,27,39,.692,107
1592,WAS,2020-08-09,103,@,OKC,L 103-121,240,38,92,.413,29,56,.518,9,36,.250,18,22,.818,103,43,84,.512,25,45,.556,18,39,.462,17,22,.773,121
1593,MIA,2020-08-03,103,,TOR,L 103-107,240,37,87,.425,23,42,.548,14,45,.311,15,16,.938,103,29,67,.433,13,35,.371,16,32,.500,33,36,.917,107
1594,NOP,2020-08-01,103,@,LAC,L 103-126,240,38,85,.447,29,55,.527,9,30,.300,18,28,.643,103,37,87,.425,12,40,.300,25,47,.532,27,35,.771,126
1595,LAL,2020-07-30,103,,LAC,W 103-101,240,32,82,.390,21,46,.457,11,36,.306,28,37,.757,103,32,74,.432,16,38,.421,16,36,.444,21,28,.750,101
1596,CLE,2020-03-10,103,@,CHI,L 103-108,240,40,80,.500,34,56,.607,6,24,.250,17,23,.739,103,42,84,.500,30,50,.600,12,34,.353,12,15,.800,108
1597,LAC,2020-03-08,103,,LAL,L 103-112,240,34,86,.395,27,55,.491,7,31,.226,28,37,.757,103,39,87,.448,29,52,.558,10,35,.286,24,28,.857,112
1598,MIL,2020-03-06,103,@,LAL,L 103-113,240,37,89,.416,25,46,.543,12,43,.279,17,23,.739,103,38,91,.418,32,59,.542,6,32,.188,31,38,.816,113
1599,NYK,2020-03-06,103,,OKC,L 103-126,240,41,91,.451,37,67,.552,4,24,.167,17,22,.773,103,47,96,.490,35,65,.538,12,31,.387,20,25,.800,126
1600,CHO,2020-03-03,103,,SAS,L 103-104,240,39,82,.476,27,53,.509,12,29,.414,13,18,.722,103,38,80,.475,27,48,.563,11,32,.344,17,20,.850,104
1601,DEN,2020-02-28,103,@,LAC,L 103-132,240,41,91,.451,32,66,.485,9,25,.360,12,16,.750,103,48,89,.539,30,50,.600,18,39,.462,18,20,.900,132
1602,SAS,2020-02-26,103,,DAL,L 103-109,240,39,92,.424,28,59,.475,11,33,.333,14,19,.737,103,36,86,.419,19,41,.463,17,45,.378,20,30,.667,109
1603,UTA,2020-02-26,103,,BOS,L 103-114,240,40,89,.449,28,49,.571,12,40,.300,11,15,.733,103,45,84,.536,34,58,.586,11,26,.423,13,16,.813,114
1604,SAS,2020-02-23,103,@,OKC,L 103-131,240,38,103,.369,27,65,.415,11,38,.289,16,19,.842,103,50,87,.575,40,65,.615,10,22,.455,21,24,.875,131
1605,LAC,2020-02-22,103,,SAC,L 103-112,240,34,87,.391,24,57,.421,10,30,.333,25,29,.862,103,40,89,.449,28,58,.483,12,31,.387,20,26,.769,112
1606,CHO,2020-02-20,103,@,CHI,W 103-93,240,35,74,.473,27,46,.587,8,28,.286,25,29,.862,103,37,87,.425,30,56,.536,7,31,.226,12,19,.632,93
1607,LAC,2020-02-11,103,@,PHI,L 103-110,240,40,90,.444,26,59,.441,14,31,.452,9,13,.692,103,44,95,.463,36,68,.529,8,27,.296,14,21,.667,110
1608,ORL,2020-02-06,103,@,NYK,L 103-105,240,34,75,.453,25,44,.568,9,31,.290,26,30,.867,103,43,92,.467,37,72,.514,6,20,.300,13,19,.684,105
1609,CLE,2020-02-05,103,@,OKC,L 103-109,240,41,89,.461,26,51,.510,15,38,.395,6,11,.545,103,38,81,.469,29,55,.527,9,26,.346,24,30,.800,109
1610,IND,2020-02-03,103,,DAL,L 103-112,240,44,96,.458,37,62,.597,7,34,.206,8,11,.727,103,36,86,.419,18,41,.439,18,45,.400,22,23,.957,112
1611,LAC,2020-01-30,103,,SAC,L 103-124,240,35,92,.380,22,61,.361,13,31,.419,20,25,.800,103,44,88,.500,23,47,.489,21,41,.512,15,18,.833,124
1612,CHO,2020-01-24,103,,MIL,L 103-116,240,32,86,.372,18,47,.383,14,39,.359,25,30,.833,103,44,87,.506,34,51,.667,10,36,.278,18,24,.750,116
1613,PHO,2020-01-24,103,@,SAS,W 103-99,240,39,84,.464,31,55,.564,8,29,.276,17,21,.810,103,33,78,.423,28,53,.528,5,25,.200,28,33,.848,99
1614,ATL,2020-01-18,103,,DET,L 103-136,240,40,93,.430,30,59,.508,10,34,.294,13,15,.867,103,51,86,.593,36,54,.667,15,32,.469,19,25,.760,136
1615,BOS,2020-01-15,103,,DET,L 103-116,240,41,83,.494,32,55,.582,9,28,.321,12,20,.600,103,47,78,.603,35,46,.761,12,32,.375,10,19,.526,116
1616,CLE,2020-01-14,103,@,LAC,L 103-128,240,38,91,.418,24,54,.444,14,37,.378,13,15,.867,103,49,94,.521,34,56,.607,15,38,.395,15,21,.714,128
1617,DEN,2020-01-11,103,,CLE,L 103-111,240,41,95,.432,33,56,.589,8,39,.205,13,18,.722,103,44,89,.494,32,52,.615,12,37,.324,11,13,.846,111
1618,BRK,2020-01-07,103,,OKC,L 103-111 (OT),265,40,98,.408,29,61,.475,11,37,.297,12,16,.750,103,38,92,.413,27,55,.491,11,37,.297,24,29,.828,111
1619,PHO,2020-01-07,103,,SAC,L 103-114,240,37,77,.481,26,42,.619,11,35,.314,18,22,.818,103,37,84,.440,22,48,.458,15,36,.417,25,28,.893,114
1620,CLE,2020-01-05,103,,MIN,L 103-118,240,40,84,.476,32,59,.542,8,25,.320,15,19,.789,103,47,95,.495,33,57,.579,14,38,.368,10,13,.769,118
1621,WAS,2020-01-03,103,,POR,L 103-122,240,38,90,.422,27,57,.474,11,33,.333,16,25,.640,103,45,88,.511,39,63,.619,6,25,.240,26,33,.788,122
1622,SAS,2020-01-02,103,,OKC,L 103-109,240,40,92,.435,27,61,.443,13,31,.419,10,12,.833,103,43,89,.483,34,64,.531,9,25,.360,14,20,.700,109
1623,ORL,2019-12-23,103,,CHI,W 103-95,240,39,81,.481,29,55,.527,10,26,.385,15,23,.652,103,35,88,.398,22,51,.431,13,37,.351,12,15,.800,95
1624,ORL,2019-12-20,103,@,POR,L 103-118,240,39,106,.368,32,78,.410,7,28,.250,18,26,.692,103,42,84,.500,25,48,.521,17,36,.472,17,19,.895,118
1625,DAL,2019-12-18,103,,BOS,L 103-109,240,34,87,.391,19,44,.432,15,43,.349,20,25,.800,103,35,86,.407,23,48,.479,12,38,.316,27,30,.900,109
1626,NYK,2019-12-13,103,@,SAC,W 103-101,240,44,95,.463,35,65,.538,9,30,.300,6,10,.600,103,39,83,.470,22,44,.500,17,39,.436,6,8,.750,101
1627,NOP,2019-12-09,103,,DET,L 103-105,240,40,91,.440,32,53,.604,8,38,.211,15,22,.682,103,36,85,.424,25,50,.500,11,35,.314,22,27,.815,105
1628,NYK,2019-12-07,103,,IND,L 103-104,240,39,96,.406,29,65,.446,10,31,.323,15,21,.714,103,41,85,.482,29,57,.509,12,28,.429,10,13,.769,104
1629,WAS,2019-12-06,103,@,MIA,L 103-112,240,39,91,.429,27,52,.519,12,39,.308,13,14,.929,103,42,86,.488,32,58,.552,10,28,.357,18,24,.750,112
1630,DET,2019-12-04,103,,MIL,L 103-127,240,39,93,.419,28,57,.491,11,36,.306,14,22,.636,103,44,90,.489,30,55,.545,14,35,.400,25,27,.926,127
1631,PHI,2019-12-02,103,,UTA,W 103-94,240,37,91,.407,24,65,.369,13,26,.500,16,23,.696,103,38,81,.469,33,59,.559,5,22,.227,13,20,.650,94
1632,CHI,2019-11-29,103,@,POR,L 103-107,240,36,94,.383,22,56,.393,14,38,.368,17,25,.680,103,38,84,.452,28,54,.519,10,30,.333,21,28,.750,107
1633,UTA,2019-11-29,103,@,MEM,W 103-94,240,38,95,.400,26,60,.433,12,35,.343,15,19,.789,103,37,94,.394,27,60,.450,10,34,.294,10,17,.588,94
1634,WAS,2019-11-29,103,@,LAL,L 103-125,240,38,96,.396,28,59,.475,10,37,.270,17,19,.895,103,45,87,.517,31,55,.564,14,32,.438,21,28,.750,125
1635,BOS,2019-11-25,103,,SAC,W 103-102,240,38,85,.447,31,55,.564,7,30,.233,20,23,.870,103,37,79,.468,19,32,.594,18,47,.383,10,15,.667,102
1636,DET,2019-11-25,103,,ORL,W 103-88,240,34,79,.430,20,41,.488,14,38,.368,21,25,.840,103,32,84,.381,24,59,.407,8,25,.320,16,22,.727,88
1637,BRK,2019-11-24,103,@,NYK,W 103-101,240,31,77,.403,17,39,.436,14,38,.368,27,34,.794,103,37,80,.463,19,45,.422,18,35,.514,9,16,.563,101
1638,ATL,2019-11-22,103,@,DET,L 103-128,240,38,88,.432,28,51,.549,10,37,.270,17,17,1.000,103,49,82,.598,32,48,.667,17,34,.500,13,20,.650,128
1639,UTA,2019-11-20,103,@,MIN,W 103-95,240,35,86,.407,21,53,.396,14,33,.424,19,27,.704,103,35,89,.393,21,44,.477,14,45,.311,11,21,.524,95
1640,CHO,2019-11-16,103,@,NYK,W 103-102,240,36,87,.414,19,39,.487,17,48,.354,14,19,.737,103,39,86,.453,33,66,.500,6,20,.300,18,23,.783,102
1641,DAL,2019-11-14,103,@,NYK,L 103-106,240,36,84,.429,28,48,.583,8,36,.222,23,31,.742,103,42,94,.447,29,64,.453,13,30,.433,9,11,.818,106
1642,UTA,2019-11-08,103,,MIL,W 103-100,240,34,84,.405,19,48,.396,15,36,.417,20,29,.690,103,34,95,.358,24,59,.407,10,36,.278,22,30,.733,100
1643,LAL,2019-11-03,103,@,SAS,W 103-96,240,42,87,.483,36,63,.571,6,24,.250,13,19,.684,103,33,83,.398,27,58,.466,6,25,.240,24,29,.828,96
1644,LAC,2019-10-31,103,,SAS,W 103-97,240,39,91,.429,34,65,.523,5,26,.192,20,27,.741,103,36,80,.450,29,59,.492,7,21,.333,18,27,.667,97
1645,ATL,2019-10-28,103,,PHI,L 103-105,240,36,84,.429,27,57,.474,9,27,.333,22,32,.688,103,37,88,.420,26,47,.553,11,41,.268,20,25,.800,105
1646,ATL,2019-10-26,103,,ORL,W 103-99,240,43,84,.512,34,54,.630,9,30,.300,8,15,.533,103,35,99,.354,30,68,.441,5,31,.161,24,26,.923,99
1647,DAL,2020-08-13,102,@,PHO,L 102-128,240,39,89,.438,31,63,.492,8,26,.308,16,19,.842,102,49,89,.551,35,55,.636,14,34,.412,16,21,.762,128
1648,HOU,2020-08-04,102,@,POR,L 102-110,240,34,87,.391,15,34,.441,19,53,.358,15,24,.625,102,39,95,.411,27,64,.422,12,31,.387,20,29,.690,110
1649,LAL,2020-03-10,102,,BRK,L 102-104,240,40,87,.460,25,47,.532,15,40,.375,7,12,.583,102,37,90,.411,24,50,.480,13,40,.325,17,23,.739,104
1650,DEN,2020-03-07,102,@,CLE,L 102-104,240,43,85,.506,30,53,.566,13,32,.406,3,8,.375,102,42,76,.553,30,48,.625,12,28,.429,8,12,.667,104
1651,CHI,2020-03-06,102,,IND,L 102-108,240,40,97,.412,31,59,.525,9,38,.237,13,15,.867,102,38,75,.507,30,53,.566,8,22,.364,24,33,.727,108
1652,LAC,2020-02-26,102,@,PHO,W 102-92,240,37,84,.440,23,46,.500,14,38,.368,14,15,.933,102,34,87,.391,25,53,.472,9,34,.265,15,18,.833,92
1653,SAS,2020-02-08,102,@,SAC,L 102-122,240,41,81,.506,34,57,.596,7,24,.292,13,18,.722,102,45,86,.523,26,51,.510,19,35,.543,13,20,.650,122
1654,SAS,2020-02-04,102,@,LAL,L 102-129,240,40,91,.440,27,64,.422,13,27,.481,9,15,.600,102,50,85,.588,38,57,.667,12,28,.429,17,25,.680,129
1655,CHI,2020-02-02,102,@,TOR,L 102-129,240,35,90,.389,20,42,.476,15,48,.313,17,26,.654,102,47,84,.560,31,50,.620,16,34,.471,19,23,.826,129
1656,MIA,2020-02-01,102,@,ORL,W 102-89,240,33,77,.429,18,44,.409,15,33,.455,21,26,.808,102,33,83,.398,24,50,.480,9,33,.273,14,17,.824,89
1657,ATL,2020-01-22,102,,LAC,W 102-95,240,36,102,.353,25,67,.373,11,35,.314,19,23,.826,102,33,78,.423,29,57,.509,4,21,.190,25,39,.641,95
1658,MIA,2020-01-19,102,@,SAS,L 102-107,240,37,86,.430,27,52,.519,10,34,.294,18,20,.900,102,36,85,.424,24,52,.462,12,33,.364,23,24,.958,107
1659,NYK,2020-01-14,102,@,MIL,L 102-128,240,36,102,.353,25,65,.385,11,37,.297,19,26,.731,102,45,92,.489,30,56,.536,15,36,.417,23,28,.821,128
1660,GSW,2020-01-12,102,@,MEM,L 102-122,240,35,92,.380,18,58,.310,17,34,.500,15,21,.714,102,45,100,.450,34,65,.523,11,35,.314,21,25,.840,122
1661,POR,2020-01-09,102,@,MIN,L 102-116,240,35,96,.365,24,59,.407,11,37,.297,21,31,.677,102,44,89,.494,31,57,.544,13,32,.406,15,21,.714,116
1662,BRK,2020-01-04,102,,TOR,L 102-121,240,32,67,.478,19,32,.594,13,35,.371,25,34,.735,102,44,97,.454,31,65,.477,13,32,.406,20,28,.714,121
1663,UTA,2020-01-02,102,@,CHI,W 102-98,240,37,76,.487,26,46,.565,11,30,.367,17,22,.773,102,37,94,.394,26,58,.448,11,36,.306,13,17,.765,98
1664,CHI,2019-12-30,102,,MIL,L 102-123,240,40,107,.374,23,63,.365,17,44,.386,5,8,.625,102,46,84,.548,35,52,.673,11,32,.344,20,24,.833,123
1665,CHO,2019-12-27,102,,OKC,L 102-104 (OT),265,42,101,.416,35,62,.565,7,39,.179,11,18,.611,102,40,89,.449,35,58,.603,5,31,.161,19,31,.613,104
1666,DAL,2019-12-26,102,,SAS,W 102-98,240,38,90,.422,22,50,.440,16,40,.400,10,15,.667,102,40,83,.482,32,54,.593,8,29,.276,10,15,.667,98
1667,WAS,2019-12-26,102,@,DET,L 102-132,240,38,92,.413,31,68,.456,7,24,.292,19,27,.704,102,46,86,.535,27,38,.711,19,48,.396,21,26,.808,132
1668,TOR,2019-12-25,102,,BOS,L 102-118,240,38,80,.475,30,57,.526,8,23,.348,18,22,.818,102,46,92,.500,32,59,.542,14,33,.424,12,14,.857,118
1669,NOP,2019-12-23,102,@,POR,W 102-94,240,38,93,.409,23,58,.397,15,35,.429,11,16,.688,102,37,91,.407,33,62,.532,4,29,.138,16,18,.889,94
1670,NYK,2019-12-21,102,,MIL,L 102-123,240,39,97,.402,30,67,.448,9,30,.300,15,21,.714,102,41,85,.482,23,42,.548,18,43,.419,23,35,.657,123
1671,NOP,2019-12-20,102,@,GSW,L 102-106,240,39,93,.419,30,59,.508,9,34,.265,15,23,.652,102,36,83,.434,26,50,.520,10,33,.303,24,25,.960,106
1672,ORL,2019-12-17,102,@,UTA,L 102-109,240,42,93,.452,35,58,.603,7,35,.200,11,15,.733,102,42,90,.467,27,54,.500,15,36,.417,10,16,.625,109
1673,SAC,2019-12-17,102,@,CHO,L 102-110,240,38,91,.418,24,52,.462,14,39,.359,12,13,.923,102,39,81,.481,26,51,.510,13,30,.433,19,27,.704,110
1674,LAL,2019-12-17,102,@,IND,L 102-105,240,43,91,.473,35,60,.583,8,31,.258,8,17,.471,102,41,85,.482,31,60,.517,10,25,.400,13,20,.650,105
1675,BRK,2019-12-14,102,@,TOR,L 102-110,240,39,101,.386,27,55,.491,12,46,.261,12,17,.706,102,38,98,.388,24,58,.414,14,40,.350,20,25,.800,110
1676,OKC,2019-12-14,102,@,DEN,L 102-110,240,38,81,.469,32,58,.552,6,23,.261,20,23,.870,102,43,85,.506,36,58,.621,7,27,.259,17,23,.739,110
1677,ATL,2019-12-11,102,@,CHI,L 102-136,240,35,83,.422,22,45,.489,13,38,.342,19,26,.731,102,54,94,.574,43,70,.614,11,24,.458,17,19,.895,136
1678,GSW,2019-12-09,102,,MEM,L 102-110,240,35,93,.376,24,66,.364,11,27,.407,21,25,.840,102,41,82,.500,26,42,.619,15,40,.375,13,17,.765,110
1679,DEN,2019-12-08,102,@,BRK,L 102-105,240,36,89,.404,18,47,.383,18,42,.429,12,14,.857,102,40,87,.460,33,59,.559,7,28,.250,18,23,.783,105
1680,ATL,2019-11-27,102,@,MIL,L 102-111,240,38,94,.404,27,60,.450,11,34,.324,15,22,.682,102,42,88,.477,32,54,.593,10,34,.294,17,27,.630,111
1681,CHO,2019-11-27,102,,DET,W 102-101,240,39,88,.443,32,58,.552,7,30,.233,17,20,.850,102,41,88,.466,31,56,.554,10,32,.313,9,15,.600,101
1682,UTA,2019-11-27,102,@,IND,L 102-121,240,36,83,.434,26,51,.510,10,32,.313,20,25,.800,102,50,96,.521,42,74,.568,8,22,.364,13,16,.813,121
1683,SAC,2019-11-25,102,@,BOS,L 102-103,240,37,79,.468,19,32,.594,18,47,.383,10,15,.667,102,38,85,.447,31,55,.564,7,30,.233,20,23,.870,103
1684,UTA,2019-11-18,102,,MIN,L 102-112,240,35,96,.365,23,65,.354,12,31,.387,20,26,.769,102,41,89,.461,27,51,.529,14,38,.368,16,19,.842,112
1685,TOR,2019-11-16,102,@,DAL,L 102-110,240,37,89,.416,20,48,.417,17,41,.415,11,15,.733,102,37,88,.420,28,49,.571,9,39,.231,27,33,.818,110
1686,MIL,2019-11-16,102,@,IND,W 102-83,240,43,96,.448,32,57,.561,11,39,.282,5,7,.714,102,32,100,.320,20,66,.303,12,34,.353,7,9,.778,83
1687,NYK,2019-11-16,102,,CHO,L 102-103,240,39,86,.453,33,66,.500,6,20,.300,18,23,.783,102,36,87,.414,19,39,.487,17,48,.354,14,19,.737,103
1688,IND,2019-11-15,102,@,HOU,L 102-111,240,37,82,.451,29,49,.592,8,33,.242,20,26,.769,102,36,89,.404,22,43,.512,14,46,.304,25,29,.862,111
1689,HOU,2019-11-13,102,,LAC,W 102-93,240,33,86,.384,19,44,.432,14,42,.333,22,27,.815,102,38,98,.388,28,65,.431,10,33,.303,7,14,.500,93
1690,NYK,2019-11-12,102,@,CHI,L 102-120,240,36,88,.409,26,56,.464,10,32,.313,20,31,.645,102,41,81,.506,27,48,.563,14,33,.424,24,31,.774,120
1691,ORL,2019-11-10,102,,IND,L 102-109,240,41,89,.461,26,53,.491,15,36,.417,5,6,.833,102,48,91,.527,39,71,.549,9,20,.450,4,5,.800,109
1692,DAL,2019-11-08,102,,NYK,L 102-106,240,37,90,.411,23,46,.500,14,44,.318,14,17,.824,102,37,89,.416,23,61,.377,14,28,.500,18,31,.581,106
1693,NYK,2019-11-06,102,@,DET,L 102-122,240,39,80,.488,28,55,.509,11,25,.440,13,21,.619,102,44,79,.557,29,49,.592,15,30,.500,19,24,.792,122
1694,OKC,2019-11-05,102,,ORL,W 102-94,240,37,86,.430,25,53,.472,12,33,.364,16,20,.800,102,32,82,.390,29,60,.483,3,22,.136,27,31,.871,94
1695,NYK,2019-11-01,102,@,BOS,L 102-104,240,37,93,.398,23,55,.418,14,38,.368,14,21,.667,102,33,74,.446,22,40,.550,11,34,.324,27,29,.931,104
1696,SAC,2019-11-01,102,,UTA,W 102-101,240,41,84,.488,33,55,.600,8,29,.276,12,17,.706,102,35,73,.479,24,45,.533,11,28,.393,20,27,.741,101
1697,IND,2019-11-01,102,,CLE,W 102-95,240,39,96,.406,34,69,.493,5,27,.185,19,21,.905,102,32,87,.368,21,55,.382,11,32,.344,20,25,.800,95
1698,POR,2019-10-30,102,@,OKC,W 102-99,240,34,86,.395,17,51,.333,17,35,.486,17,24,.708,102,33,84,.393,29,57,.509,4,27,.148,29,37,.784,99
1699,MEM,2019-10-25,102,,CHI,L 102-110,240,39,94,.415,29,65,.446,10,29,.345,14,20,.700,102,40,93,.430,28,51,.549,12,42,.286,18,24,.750,110
1700,LAL,2019-10-22,102,@,LAC,L 102-112,240,37,85,.435,24,52,.462,13,33,.394,15,21,.714,102,42,81,.519,31,50,.620,11,31,.355,17,24,.708,112
1701,OKC,2020-08-10,101,@,PHO,L 101-128,240,35,90,.389,22,51,.431,13,39,.333,18,21,.857,101,42,89,.472,25,55,.455,17,34,.500,27,29,.931,128
1702,ORL,2020-08-07,101,@,PHI,L 101-108,240,37,88,.420,29,56,.518,8,32,.250,19,25,.760,101,38,93,.409,30,64,.469,8,29,.276,24,33,.727,108
1703,LAC,2020-07-30,101,@,LAL,L 101-103,240,32,74,.432,16,38,.421,16,36,.444,21,28,.750,101,32,82,.390,21,46,.457,11,36,.306,28,37,.757,103
1704,TOR,2020-03-09,101,@,UTA,W 101-92,240,36,83,.434,23,47,.489,13,36,.361,16,18,.889,101,33,83,.398,17,40,.425,16,43,.372,10,14,.714,92
1705,ATL,2020-03-07,101,@,MEM,L 101-118,240,32,95,.337,19,46,.413,13,49,.265,24,28,.857,101,43,87,.494,31,54,.574,12,33,.364,20,33,.606,118
1706,MEM,2020-02-28,101,,SAC,L 101-104,240,39,91,.429,31,61,.508,8,30,.267,15,20,.750,101,38,91,.418,27,53,.509,11,38,.289,17,21,.810,104
1707,NYK,2020-02-26,101,@,CHO,L 101-107,240,43,85,.506,39,70,.557,4,15,.267,11,17,.647,101,39,83,.470,29,53,.547,10,30,.333,19,25,.760,107
1708,GSW,2020-02-23,101,,NOP,L 101-115,240,40,92,.435,29,57,.509,11,35,.314,10,15,.667,101,46,98,.469,29,56,.518,17,42,.405,6,13,.462,115
1709,DEN,2020-02-21,101,@,OKC,L 101-113,240,37,77,.481,31,50,.620,6,27,.222,21,23,.913,101,40,87,.460,31,61,.508,9,26,.346,24,27,.889,113
1710,PHO,2020-02-21,101,@,TOR,L 101-118,240,38,92,.413,32,58,.552,6,34,.176,19,23,.826,101,42,80,.525,28,43,.651,14,37,.378,20,22,.909,118
1711,MIA,2020-02-12,101,@,UTA,L 101-116,240,38,88,.432,25,49,.510,13,39,.333,12,16,.750,101,41,85,.482,27,49,.551,14,36,.389,20,23,.870,116
1712,BRK,2020-02-12,101,,TOR,W 101-91,240,36,88,.409,27,53,.509,9,35,.257,20,25,.800,101,34,90,.378,21,47,.447,13,43,.302,10,13,.769,91
1713,GSW,2020-02-10,101,,MIA,L 101-113,240,30,77,.390,19,43,.442,11,34,.324,30,34,.882,101,43,87,.494,31,54,.574,12,33,.364,15,21,.714,113
1714,DET,2020-02-07,101,@,OKC,L 101-108,240,38,89,.427,27,51,.529,11,38,.289,14,19,.737,101,39,76,.513,34,53,.642,5,23,.217,25,30,.833,108
1715,PHI,2020-02-06,101,@,MIL,L 101-112,240,37,99,.374,18,54,.333,19,45,.422,8,14,.571,101,44,94,.468,32,57,.561,12,37,.324,12,18,.667,112
1716,MIA,2020-01-28,101,,BOS,L 101-109,240,33,89,.371,24,52,.462,9,37,.243,26,31,.839,101,39,83,.470,26,47,.553,13,36,.361,18,24,.750,109
1717,SAC,2020-01-18,101,@,UTA,L 101-123,240,42,86,.488,32,60,.533,10,26,.385,7,12,.583,101,43,85,.506,29,43,.674,14,42,.333,23,24,.958,123
1718,CHI,2020-01-13,101,@,BOS,L 101-113,240,37,81,.457,31,56,.554,6,25,.240,21,26,.808,101,39,83,.470,30,60,.500,9,23,.391,26,29,.897,113
1719,IND,2020-01-13,101,,PHI,W 101-95,240,33,86,.384,23,60,.383,10,26,.385,25,31,.806,101,37,89,.416,31,56,.554,6,33,.182,15,19,.789,95
1720,POR,2020-01-11,101,,MIL,L 101-122,240,37,95,.389,27,59,.458,10,36,.278,17,21,.810,101,47,103,.456,33,65,.508,14,38,.368,14,20,.700,122
1721,ATL,2020-01-10,101,@,WAS,L 101-111,240,41,89,.461,34,60,.567,7,29,.241,12,24,.500,101,42,112,.375,32,83,.386,10,29,.345,17,28,.607,111
1722,POR,2020-01-07,101,@,TOR,W 101-99,240,38,88,.432,25,53,.472,13,35,.371,12,14,.857,101,35,96,.365,20,54,.370,15,42,.357,14,19,.737,99
1723,ORL,2020-01-06,101,,BRK,W 101-89,240,35,81,.432,27,55,.491,8,26,.308,23,31,.742,101,32,96,.333,22,49,.449,10,47,.213,15,19,.789,89
1724,WAS,2020-01-01,101,,ORL,L 101-122,240,33,87,.379,24,56,.429,9,31,.290,26,31,.839,101,45,95,.474,33,63,.524,12,32,.375,20,27,.741,122
1725,DAL,2019-12-31,101,@,OKC,L 101-106,240,33,93,.355,18,42,.429,15,51,.294,20,27,.741,101,39,91,.429,33,64,.516,6,27,.222,22,28,.786,106
1726,ATL,2019-12-30,101,@,ORL,W 101-93,240,39,81,.481,30,52,.577,9,29,.310,14,17,.824,101,37,89,.416,32,64,.500,5,25,.200,14,24,.583,93
1727,NOP,2019-12-17,101,,BRK,L 101-108 (OT),265,37,107,.346,26,67,.388,11,40,.275,16,24,.667,101,40,96,.417,29,57,.509,11,39,.282,17,23,.739,108
1728,LAL,2019-12-15,101,@,ATL,W 101-96,240,36,84,.429,31,53,.585,5,31,.161,24,33,.727,101,31,86,.360,19,44,.432,12,42,.286,22,25,.880,96
1729,SAC,2019-12-13,101,,NYK,L 101-103,240,39,83,.470,22,44,.500,17,39,.436,6,8,.750,101,44,95,.463,35,65,.538,9,30,.300,6,10,.600,103
1730,ORL,2019-12-09,101,@,MIL,L 101-110,240,35,92,.380,25,61,.410,10,31,.323,21,26,.808,101,43,92,.467,27,51,.529,16,41,.390,8,15,.533,110
1731,IND,2019-12-06,101,@,DET,L 101-108,240,38,83,.458,29,59,.492,9,24,.375,16,20,.800,101,39,87,.448,28,62,.452,11,25,.440,19,26,.731,108
1732,PHI,2019-11-29,101,@,NYK,W 101-95,240,31,72,.431,24,46,.522,7,26,.269,32,40,.800,101,34,78,.436,26,58,.448,8,20,.400,19,33,.576,95
1733,SAS,2019-11-27,101,,MIN,L 101-113,240,41,97,.423,36,68,.529,5,29,.172,14,17,.824,101,37,85,.435,19,45,.422,18,40,.450,21,27,.778,113
1734,DET,2019-11-27,101,@,CHO,L 101-102,240,41,88,.466,31,56,.554,10,32,.313,9,15,.600,101,39,88,.443,32,58,.552,7,30,.233,17,20,.850,102
1735,TOR,2019-11-25,101,,PHI,W 101-96,240,38,84,.452,27,50,.540,11,34,.324,14,22,.636,101,36,88,.409,21,48,.438,15,40,.375,9,16,.563,96
1736,NYK,2019-11-24,101,,BRK,L 101-103,240,37,80,.463,19,45,.422,18,35,.514,9,16,.563,101,31,77,.403,17,39,.436,14,38,.368,27,34,.794,103
1737,CLE,2019-11-22,101,@,DAL,L 101-143,240,37,86,.430,25,57,.439,12,29,.414,15,17,.882,101,58,100,.580,38,63,.603,20,37,.541,7,9,.778,143
1738,BRK,2019-11-20,101,,CHO,W 101-91,240,36,90,.400,26,51,.510,10,39,.256,19,23,.826,101,30,81,.370,19,48,.396,11,33,.333,20,26,.769,91
1739,CHI,2019-11-18,101,,MIL,L 101-115,240,39,97,.402,27,63,.429,12,34,.353,11,14,.786,101,38,82,.463,23,41,.561,15,41,.366,24,35,.686,115
1740,ATL,2019-11-17,101,@,LAL,L 101-122,240,37,86,.430,29,58,.500,8,28,.286,19,25,.760,101,47,89,.528,32,54,.593,15,35,.429,13,16,.813,122
1741,ATL,2019-11-16,101,@,LAC,L 101-150,240,34,90,.378,28,66,.424,6,24,.250,27,37,.730,101,50,93,.538,33,60,.550,17,33,.515,33,35,.943,150
1742,DEN,2019-11-14,101,,BRK,W 101-93,240,43,101,.426,33,68,.485,10,33,.303,5,10,.500,101,36,95,.379,28,57,.491,8,38,.211,13,16,.813,93
1743,POR,2019-11-07,101,@,LAC,L 101-107,240,39,104,.375,28,65,.431,11,39,.282,12,16,.750,101,39,89,.438,35,66,.530,4,23,.174,25,30,.833,107
1744,UTA,2019-11-01,101,@,SAC,L 101-102,240,35,73,.479,24,45,.533,11,28,.393,20,27,.741,101,41,84,.488,33,55,.600,8,29,.276,12,17,.706,102
1745,DEN,2019-10-28,101,@,SAC,W 101-94,240,36,98,.367,26,62,.419,10,36,.278,19,21,.905,101,36,91,.396,24,54,.444,12,37,.324,10,16,.625,94
1746,CHO,2019-10-27,101,@,LAL,L 101-120,240,35,91,.385,25,56,.446,10,35,.286,21,23,.913,101,49,93,.527,38,62,.613,11,31,.355,11,14,.786,120
1747,MEM,2019-10-23,101,@,MIA,L 101-120,240,38,89,.427,33,57,.579,5,32,.156,20,30,.667,101,40,85,.471,33,67,.493,7,18,.389,33,39,.846,120
1748,TOR,2020-08-07,100,,BOS,L 100-122,240,38,89,.427,28,51,.549,10,38,.263,14,17,.824,100,47,96,.490,31,50,.620,16,46,.348,12,16,.750,122
1749,WAS,2020-08-03,100,,IND,L 100-111,240,41,94,.436,30,64,.469,11,30,.367,7,13,.538,100,44,92,.478,37,66,.561,7,26,.269,16,16,1.000,111
1750,MIA,2020-03-08,100,@,WAS,W 100-89,240,32,66,.485,19,38,.500,13,28,.464,23,28,.821,100,26,78,.333,7,31,.226,19,47,.404,18,21,.857,89
1751,IND,2020-03-04,100,@,MIL,L 100-119,240,42,97,.433,35,70,.500,7,27,.259,9,11,.818,100,43,94,.457,30,48,.625,13,46,.283,20,22,.909,119
1752,DEN,2020-03-03,100,,GSW,L 100-116,240,39,87,.448,36,67,.537,3,20,.150,19,26,.731,100,42,82,.512,24,41,.585,18,41,.439,14,22,.636,116
1753,DET,2020-03-01,100,@,SAC,L 100-106,240,33,80,.413,15,38,.395,18,42,.429,16,24,.667,100,37,91,.407,28,56,.500,9,35,.257,23,26,.885,106
1754,POR,2020-02-27,100,@,IND,L 100-106,240,41,89,.461,32,59,.542,9,30,.300,9,14,.643,100,40,90,.444,32,65,.492,8,25,.320,18,23,.783,106
1755,PHO,2020-02-10,100,@,LAL,L 100-125,240,32,76,.421,21,45,.467,11,31,.355,25,31,.806,100,47,91,.516,33,54,.611,14,37,.378,17,25,.680,125
1756,CHO,2020-02-08,100,,DAL,L 100-116,240,38,87,.437,27,51,.529,11,36,.306,13,18,.722,100,44,87,.506,27,52,.519,17,35,.486,11,11,1.000,116
1757,ORL,2020-02-05,100,@,BOS,L 100-116,240,32,75,.427,19,44,.432,13,31,.419,23,30,.767,100,46,86,.535,33,63,.524,13,23,.565,11,16,.688,116
1758,CHO,2020-02-03,100,,ORL,L 100-112,240,41,89,.461,32,58,.552,9,31,.290,9,14,.643,100,43,80,.538,27,46,.587,16,34,.471,10,17,.588,112
1759,ATL,2020-02-01,100,@,DAL,L 100-123,240,37,91,.407,27,58,.466,10,33,.303,16,21,.762,100,44,94,.468,24,55,.436,20,39,.513,15,16,.938,123
1760,UTA,2020-01-30,100,@,DEN,L 100-106,240,36,78,.462,19,41,.463,17,37,.459,11,17,.647,100,40,85,.471,31,58,.534,9,27,.333,17,21,.810,106
1761,SAC,2020-01-29,100,,OKC,L 100-120,240,42,91,.462,33,52,.635,9,39,.231,7,11,.636,100,44,88,.500,29,54,.537,15,34,.441,17,20,.850,120
1762,DET,2020-01-27,100,,CLE,L 100-115,240,38,84,.452,26,49,.531,12,35,.343,12,17,.706,100,48,96,.500,39,72,.542,9,24,.375,10,13,.769,115
1763,LAL,2020-01-22,100,@,NYK,W 100-92,240,36,82,.439,27,55,.491,9,27,.333,19,28,.679,100,36,88,.409,25,54,.463,11,34,.324,9,13,.692,92
1764,DET,2020-01-20,100,@,WAS,L 100-106,240,38,89,.427,28,57,.491,10,32,.313,14,20,.700,100,42,82,.512,33,58,.569,9,24,.375,13,16,.813,106
1765,MIN,2020-01-20,100,,DEN,L 100-107,240,38,91,.418,25,49,.510,13,42,.310,11,14,.786,100,43,90,.478,32,59,.542,11,31,.355,10,12,.833,107
1766,PHI,2020-01-17,100,,CHI,W 100-89,240,40,82,.488,31,53,.585,9,29,.310,11,11,1.000,100,35,81,.432,27,46,.587,8,35,.229,11,15,.733,89
1767,SAS,2020-01-15,100,@,MIA,L 100-106,240,39,89,.438,29,56,.518,10,33,.303,12,15,.800,100,41,88,.466,24,48,.500,17,40,.425,7,13,.538,106
1768,DEN,2020-01-15,100,,CHO,W 100-86,240,38,79,.481,29,51,.569,9,28,.321,15,25,.600,100,33,81,.407,21,46,.457,12,35,.343,8,14,.571,86
1769,PHO,2020-01-12,100,,CHO,W 100-92,240,41,82,.500,34,61,.557,7,21,.333,11,18,.611,100,36,86,.419,28,51,.549,8,35,.229,12,18,.667,92
1770,GSW,2020-01-10,100,@,LAC,L 100-109,240,37,96,.385,29,57,.509,8,39,.205,18,25,.720,100,41,84,.488,30,45,.667,11,39,.282,16,22,.727,109
1771,ORL,2019-12-28,100,@,MIL,L 100-111,240,35,87,.402,21,52,.404,14,35,.400,16,19,.842,100,43,84,.512,30,47,.638,13,37,.351,12,18,.667,111
1772,WAS,2019-12-28,100,,NYK,L 100-107,240,33,96,.344,23,71,.324,10,25,.400,24,31,.774,100,38,85,.447,27,54,.500,11,31,.355,20,26,.769,107
1773,DEN,2019-12-25,100,,NOP,L 100-112,240,37,92,.402,25,55,.455,12,37,.324,14,18,.778,100,41,90,.456,23,47,.489,18,43,.419,12,12,1.000,112
1774,MIN,2019-12-20,100,@,DEN,L 100-109,240,36,87,.414,26,45,.578,10,42,.238,18,27,.667,100,44,89,.494,34,61,.557,10,28,.357,11,12,.917,109
1775,CLE,2019-12-18,100,,CHO,W 100-98,240,40,74,.541,33,48,.688,7,26,.269,13,17,.765,100,37,91,.407,24,54,.444,13,37,.351,11,18,.611,98
1776,SAC,2019-12-15,100,@,GSW,W 100-79,240,38,63,.603,28,41,.683,10,22,.455,14,16,.875,100,30,76,.395,24,51,.471,6,25,.240,13,18,.722,79
1777,ATL,2019-12-13,100,,IND,L 100-110,240,39,94,.415,33,66,.500,6,28,.214,16,23,.696,100,46,92,.500,39,70,.557,7,22,.318,11,15,.733,110
1778,GSW,2019-12-06,100,@,CHI,W 100-98,240,38,71,.535,29,47,.617,9,24,.375,15,22,.682,100,39,88,.443,22,47,.468,17,41,.415,3,5,.600,98
1779,OKC,2019-12-04,100,,IND,L 100-107,240,41,84,.488,32,58,.552,9,26,.346,9,10,.900,100,42,87,.483,33,63,.524,9,24,.375,14,17,.824,107
1780,ORL,2019-12-01,100,,GSW,W 100-96,240,37,87,.425,26,54,.481,11,33,.333,15,22,.682,100,36,91,.396,30,68,.441,6,23,.261,18,23,.783,96
1781,LAL,2019-12-01,100,,DAL,L 100-114,240,40,87,.460,33,60,.550,7,27,.259,13,16,.813,100,42,97,.433,25,48,.521,17,49,.347,13,18,.722,114
1782,SAC,2019-11-30,100,,DEN,W 100-97 (OT),265,37,96,.385,29,63,.460,8,33,.242,18,21,.857,100,36,87,.414,25,55,.455,11,32,.344,14,21,.667,97
1783,OKC,2019-11-25,100,@,GSW,W 100-97,240,40,85,.471,29,53,.547,11,32,.344,9,11,.818,100,37,89,.416,28,69,.406,9,20,.450,14,16,.875,97
1784,CHO,2019-11-25,100,@,MIA,L 100-117,240,36,87,.414,27,54,.500,9,33,.273,19,25,.760,100,40,77,.519,27,46,.587,13,31,.419,24,28,.857,117
1785,PHO,2019-11-23,100,@,MIN,W 100-98,240,33,96,.344,23,61,.377,10,35,.286,24,26,.923,100,38,91,.418,26,49,.531,12,42,.286,10,17,.588,98
1786,CLE,2019-11-20,100,@,MIA,L 100-124,240,37,87,.425,25,49,.510,12,38,.316,14,16,.875,100,41,78,.526,22,41,.537,19,37,.514,23,31,.742,124
1787,GSW,2019-11-17,100,@,NOP,L 100-108,240,37,91,.407,30,66,.455,7,25,.280,19,23,.826,100,37,89,.416,19,43,.442,18,46,.391,16,20,.800,108
1788,SAC,2019-11-17,100,,BOS,W 100-99,240,38,89,.427,24,54,.444,14,35,.400,10,12,.833,100,34,82,.415,24,52,.462,10,30,.333,21,24,.875,99
1789,GSW,2019-11-15,100,,BOS,L 100-105,240,34,82,.415,29,54,.537,5,28,.179,27,34,.794,100,37,91,.407,24,58,.414,13,33,.394,18,23,.783,105
1790,DEN,2019-11-10,100,@,MIN,W 100-98 (OT),265,39,101,.386,28,73,.384,11,28,.393,11,17,.647,100,34,97,.351,28,52,.538,6,45,.133,24,33,.727,98
1791,DEN,2019-11-08,100,,PHI,W 100-97,240,39,87,.448,30,65,.462,9,22,.409,13,17,.765,100,38,86,.442,25,60,.417,13,26,.500,8,17,.471,97
1792,WAS,2019-11-08,100,,CLE,L 100-113,240,45,96,.469,38,65,.585,7,31,.226,3,6,.500,100,41,90,.456,35,63,.556,6,27,.222,25,29,.862,113
1793,MIL,2019-11-08,100,@,UTA,L 100-103,240,34,95,.358,24,59,.407,10,36,.278,22,30,.733,100,34,84,.405,19,48,.396,15,36,.417,20,29,.690,103
1794,SAS,2019-11-05,100,@,ATL,L 100-108,240,38,91,.418,30,58,.517,8,33,.242,16,23,.696,100,43,90,.478,32,60,.533,11,30,.367,11,16,.688,108
1795,MEM,2019-11-04,100,,HOU,L 100-107,240,40,94,.426,37,69,.536,3,25,.120,17,21,.810,100,35,93,.376,18,43,.419,17,50,.340,20,29,.690,107
1796,HOU,2019-11-03,100,@,MIA,L 100-129,240,31,79,.392,17,31,.548,14,48,.292,24,31,.774,100,47,89,.528,29,48,.604,18,41,.439,17,22,.773,129
1797,DET,2019-10-24,100,,ATL,L 100-117,240,35,85,.412,25,48,.521,10,37,.270,20,22,.909,100,44,86,.512,33,55,.600,11,31,.355,18,21,.857,117
1798,POR,2019-10-23,100,,DEN,L 100-108,240,36,87,.414,29,59,.492,7,28,.250,21,23,.913,100,34,81,.420,16,49,.327,18,32,.563,22,27,.815,108
1799,UTA,2019-10-23,100,,OKC,W 100-95,240,40,90,.444,34,66,.515,6,24,.250,14,20,.700,100,32,83,.386,22,56,.393,10,27,.370,21,31,.677,95
1800,WAS,2019-10-23,100,@,DAL,L 100-108,240,37,93,.398,26,52,.500,11,41,.268,15,18,.833,100,35,76,.461,24,40,.600,11,36,.306,27,33,.818,108
1801,MEM,2020-08-09,99,@,TOR,L 99-108,240,37,91,.407,23,49,.469,14,42,.333,11,16,.688,99,34,71,.479,19,32,.594,15,39,.385,25,33,.758,108
1802,IND,2020-08-06,99,@,PHO,L 99-114,240,37,85,.435,27,56,.482,10,29,.345,15,19,.789,99,43,92,.467,34,58,.586,9,34,.265,19,20,.950,114
1803,ORL,2020-08-05,99,,TOR,L 99-109,240,35,87,.402,24,46,.522,11,41,.268,18,26,.692,99,38,78,.487,26,45,.578,12,33,.364,21,30,.700,109
1804,MEM,2020-08-03,99,@,NOP,L 99-109,240,37,93,.398,25,50,.500,12,43,.279,13,15,.867,99,37,82,.451,26,53,.491,11,29,.379,24,39,.615,109
1805,HOU,2020-03-07,99,@,CHO,L 99-108,240,35,76,.461,20,31,.645,15,45,.333,14,20,.700,99,37,70,.529,22,38,.579,15,32,.469,19,25,.760,108
1806,UTA,2020-03-06,99,@,BOS,W 99-94,240,36,80,.450,19,35,.543,17,45,.378,10,12,.833,99,35,94,.372,25,58,.431,10,36,.278,14,18,.778,94
1807,PHO,2020-02-29,99,,GSW,L 99-115,240,34,83,.410,22,54,.407,12,29,.414,19,23,.826,99,41,87,.471,32,57,.561,9,30,.300,24,32,.750,115
1808,CHO,2020-02-28,99,@,TOR,W 99-96,240,34,78,.436,21,48,.438,13,30,.433,18,25,.720,99,33,95,.347,23,52,.442,10,43,.233,20,29,.690,96
1809,WAS,2020-02-09,99,,MEM,L 99-106,240,35,100,.350,28,67,.418,7,33,.212,22,29,.759,99,43,102,.422,38,70,.543,5,32,.156,15,25,.600,106
1810,POR,2020-02-04,99,@,DEN,L 99-127,240,36,91,.396,27,60,.450,9,31,.290,18,22,.818,99,46,90,.511,29,56,.518,17,34,.500,18,25,.720,127
1811,SAS,2020-01-24,99,,PHO,L 99-103,240,33,78,.423,28,53,.528,5,25,.200,28,33,.848,99,39,84,.464,31,55,.564,8,29,.276,17,21,.810,103
1812,MIN,2020-01-15,99,,IND,L 99-104,240,38,88,.432,27,60,.450,11,28,.393,12,16,.750,99,44,85,.518,37,62,.597,7,23,.304,9,12,.750,104
1813,CLE,2020-01-13,99,@,LAL,L 99-128,240,38,85,.447,31,60,.517,7,25,.280,16,24,.667,99,48,88,.545,37,58,.638,11,30,.367,21,28,.750,128
1814,DET,2020-01-11,99,,CHI,L 99-108,240,36,78,.462,27,50,.540,9,28,.321,18,27,.667,99,42,83,.506,31,48,.646,11,35,.314,13,14,.929,108
1815,TOR,2020-01-07,99,,POR,L 99-101,240,35,96,.365,20,54,.370,15,42,.357,14,19,.737,99,38,88,.432,25,53,.472,13,35,.371,12,14,.857,101
1816,WAS,2020-01-06,99,,BOS,W 99-94,240,39,84,.464,32,63,.508,7,21,.333,14,23,.609,99,33,95,.347,25,58,.431,8,37,.216,20,26,.769,94
1817,DET,2020-01-05,99,@,LAL,L 99-106,240,29,78,.372,18,52,.346,11,26,.423,30,35,.857,99,42,92,.457,36,72,.500,6,20,.300,16,23,.696,106
1818,MIN,2020-01-02,99,,GSW,W 99-84,240,38,95,.400,25,52,.481,13,43,.302,10,17,.588,99,33,77,.429,30,57,.526,3,20,.150,15,21,.714,84
1819,MIN,2019-12-18,99,,NOP,L 99-107,240,36,95,.379,26,56,.464,10,39,.256,17,27,.630,99,38,86,.442,24,53,.453,14,33,.424,17,21,.810,107
1820,DET,2019-12-18,99,,TOR,L 99-112,240,39,87,.448,33,52,.635,6,35,.171,15,22,.682,99,39,91,.429,26,56,.464,13,35,.371,21,24,.875,112
1821,PHO,2019-12-17,99,@,LAC,L 99-120,240,41,102,.402,31,67,.463,10,35,.286,7,10,.700,99,45,89,.506,31,57,.544,14,32,.438,16,22,.727,120
1822,POR,2019-12-12,99,@,DEN,L 99-114,240,41,86,.477,32,56,.571,9,30,.300,8,11,.727,99,42,88,.477,24,52,.462,18,36,.500,12,19,.632,114
1823,IND,2019-12-09,99,,LAC,L 99-110,240,34,97,.351,24,62,.387,10,35,.286,21,28,.750,99,40,97,.412,30,65,.462,10,32,.313,20,27,.741,110
1824,MEM,2019-12-04,99,@,CHI,L 99-106,240,37,96,.385,30,66,.455,7,30,.233,18,21,.857,99,33,77,.429,20,44,.455,13,33,.394,27,37,.730,106
1825,DAL,2019-11-26,99,,LAC,L 99-114,240,30,79,.380,19,41,.463,11,38,.289,28,35,.800,99,41,97,.423,30,64,.469,11,33,.333,21,30,.700,114
1826,BOS,2019-11-18,99,@,PHO,W 99-85,240,37,89,.416,25,48,.521,12,41,.293,13,17,.765,99,33,82,.402,23,46,.500,10,36,.278,9,12,.750,85
1827,BOS,2019-11-17,99,@,SAC,L 99-100,240,34,82,.415,24,52,.462,10,30,.333,21,24,.875,99,38,89,.427,24,54,.444,14,35,.400,10,12,.833,100
1828,LAL,2019-11-15,99,,SAC,W 99-97,240,34,81,.420,23,44,.523,11,37,.297,20,22,.909,99,36,82,.439,20,43,.465,16,39,.410,9,9,1.000,97
1829,POR,2019-11-12,99,@,SAC,L 99-107,240,34,77,.442,26,47,.553,8,30,.267,23,30,.767,99,38,86,.442,27,54,.500,11,32,.344,20,26,.769,107
1830,DET,2019-11-04,99,@,WAS,L 99-115,240,34,82,.415,21,55,.382,13,27,.481,18,23,.783,99,43,93,.462,35,64,.547,8,29,.276,21,25,.840,115
1831,OKC,2019-10-30,99,,POR,L 99-102,240,33,84,.393,29,57,.509,4,27,.148,29,37,.784,99,34,86,.395,17,51,.333,17,35,.486,17,24,.708,102
1832,IND,2019-10-26,99,@,CLE,L 99-110,240,39,87,.448,29,59,.492,10,28,.357,11,13,.846,99,40,80,.500,29,49,.592,11,31,.355,19,29,.655,110
1833,ORL,2019-10-26,99,@,ATL,L 99-103,240,35,99,.354,30,68,.441,5,31,.161,24,26,.923,99,43,84,.512,34,54,.630,9,30,.300,8,15,.533,103
1834,CHO,2019-10-25,99,,MIN,L 99-121,240,37,84,.440,25,55,.455,12,29,.414,13,26,.500,99,43,91,.473,31,53,.585,12,38,.316,23,31,.742,121
1835,WAS,2020-08-05,98,,PHI,L 98-107,240,36,85,.424,29,64,.453,7,21,.333,19,24,.792,98,38,82,.463,27,53,.509,11,29,.379,20,29,.690,107
1836,MIA,2020-03-11,98,,CHO,L 98-109,240,39,84,.464,24,40,.600,15,44,.341,5,6,.833,98,37,82,.451,20,48,.417,17,34,.500,18,22,.818,109
1837,DET,2020-02-25,98,@,DEN,L 98-115,240,33,81,.407,18,40,.450,15,41,.366,17,21,.810,98,44,76,.579,35,57,.614,9,19,.474,18,22,.818,115
1838,PHI,2020-02-22,98,@,MIL,L 98-119,240,35,99,.354,22,61,.361,13,38,.342,15,18,.833,98,48,91,.527,34,50,.680,14,41,.341,9,13,.692,119
1839,NYK,2020-02-21,98,,IND,L 98-106,240,35,81,.432,24,56,.429,11,25,.440,17,25,.680,98,36,88,.409,28,60,.467,8,28,.286,26,33,.788,106
1840,DEN,2020-02-05,98,@,UTA,W 98-95,240,39,90,.433,32,60,.533,7,30,.233,13,18,.722,98,36,86,.419,22,47,.468,14,39,.359,9,14,.643,95
1841,SAC,2020-01-24,98,@,CHI,W 98-81,240,35,81,.432,25,49,.510,10,32,.313,18,21,.857,98,31,79,.392,23,42,.548,8,37,.216,11,14,.786,81
1842,ORL,2020-01-24,98,,BOS,L 98-109,240,36,90,.400,24,53,.453,12,37,.324,14,19,.737,98,40,86,.465,26,51,.510,14,35,.400,15,18,.833,109
1843,CHI,2020-01-20,98,@,MIL,L 98-111,240,34,92,.370,20,44,.455,14,48,.292,16,18,.889,98,45,77,.584,34,51,.667,11,26,.423,10,23,.435,111
1844,NYK,2020-01-16,98,,PHO,L 98-121,240,37,90,.411,29,64,.453,8,26,.308,16,24,.667,98,47,92,.511,35,62,.565,12,30,.400,15,18,.833,121
1845,PHO,2020-01-10,98,,ORL,W 98-94,240,33,79,.418,24,51,.471,9,28,.321,23,26,.885,98,33,89,.371,24,56,.429,9,33,.273,19,24,.792,94
1846,BOS,2020-01-09,98,@,PHI,L 98-109,240,38,88,.432,24,52,.462,14,36,.389,8,8,1.000,98,43,88,.489,32,61,.525,11,27,.407,12,17,.706,109
1847,GSW,2020-01-08,98,,MIL,L 98-107,240,33,87,.379,18,49,.367,15,38,.395,17,20,.850,98,35,87,.402,26,46,.565,9,41,.220,28,32,.875,107
1848,GSW,2020-01-06,98,@,SAC,L 98-111,240,34,86,.395,29,60,.483,5,26,.192,25,32,.781,98,39,81,.481,24,51,.471,15,30,.500,18,23,.783,111
1849,CHI,2020-01-02,98,,UTA,L 98-102,240,37,94,.394,26,58,.448,11,36,.306,13,17,.765,98,37,76,.487,26,46,.565,11,30,.367,17,22,.773,102
1850,OKC,2019-12-29,98,@,TOR,W 98-97,240,34,78,.436,24,45,.533,10,33,.303,20,23,.870,98,35,83,.422,20,43,.465,15,40,.375,12,12,1.000,97
1851,IND,2019-12-28,98,@,NOP,L 98-120,240,33,85,.388,27,57,.474,6,28,.214,26,29,.897,98,43,93,.462,25,51,.490,18,42,.429,16,20,.800,120
1852,BRK,2019-12-28,98,@,HOU,L 98-108,240,37,92,.402,26,53,.491,11,39,.282,13,21,.619,98,44,101,.436,31,59,.525,13,42,.310,7,16,.438,108
1853,ORL,2019-12-27,98,,PHI,W 98-97,240,37,88,.420,27,58,.466,10,30,.333,14,23,.609,98,35,87,.402,25,58,.431,10,29,.345,17,21,.810,97
1854,SAS,2019-12-26,98,@,DAL,L 98-102,240,40,83,.482,32,54,.593,8,29,.276,10,15,.667,98,38,90,.422,22,50,.440,16,40,.400,10,15,.667,102
1855,PHI,2019-12-20,98,,DAL,L 98-117,240,38,90,.422,28,56,.500,10,34,.294,12,18,.667,98,43,83,.518,29,50,.580,14,33,.424,17,22,.773,117
1856,CHO,2019-12-18,98,@,CLE,L 98-100,240,37,91,.407,24,54,.444,13,37,.351,11,18,.611,98,40,74,.541,33,48,.688,7,26,.269,13,17,.765,100
1857,CHI,2019-12-06,98,,GSW,L 98-100,240,39,88,.443,22,47,.468,17,41,.415,3,5,.600,98,38,71,.535,29,47,.617,9,24,.375,15,22,.682,100
1858,SAS,2019-12-01,98,@,DET,L 98-132,240,36,88,.409,29,62,.468,7,26,.269,19,22,.864,98,52,88,.591,37,57,.649,15,31,.484,13,18,.722,132
1859,NYK,2019-11-27,98,@,TOR,L 98-126,240,33,88,.375,21,47,.447,12,41,.293,20,24,.833,98,46,94,.489,25,53,.472,21,41,.512,13,17,.765,126
1860,MIN,2019-11-23,98,,PHO,L 98-100,240,38,91,.418,26,49,.531,12,42,.286,10,17,.588,98,33,96,.344,23,61,.377,10,35,.286,24,26,.923,100
1861,PHI,2019-11-12,98,,CLE,W 98-97,240,40,89,.449,32,51,.627,8,38,.211,10,13,.769,98,38,86,.442,33,65,.508,5,21,.238,16,20,.800,97
1862,LAC,2019-11-11,98,,TOR,W 98-88,240,34,92,.370,26,56,.464,8,36,.222,22,30,.733,98,34,85,.400,23,55,.418,11,30,.367,9,15,.600,88
1863,MIN,2019-11-10,98,,DEN,L 98-100 (OT),265,34,97,.351,28,52,.538,6,45,.133,24,33,.727,98,39,101,.386,28,73,.384,11,28,.393,11,17,.647,100
1864,CHI,2019-10-28,98,@,NYK,L 98-105,240,36,85,.424,27,50,.540,9,35,.257,17,21,.810,98,38,91,.418,29,62,.468,9,29,.310,20,32,.625,105
1865,LAL,2020-08-06,97,@,HOU,L 97-113,240,35,77,.455,33,58,.569,2,19,.105,25,36,.694,97,36,84,.429,15,27,.556,21,57,.368,20,23,.870,113
1866,DEN,2020-03-11,97,@,DAL,L 97-113,240,39,83,.470,25,44,.568,14,39,.359,5,8,.625,97,42,92,.457,30,57,.526,12,35,.343,17,23,.739,113
1867,TOR,2020-02-25,97,,MIL,L 97-108,240,32,91,.352,14,39,.359,18,52,.346,15,21,.714,97,32,84,.381,18,42,.429,14,42,.333,30,36,.833,108
1868,MEM,2020-02-24,97,@,LAC,L 97-124,240,37,89,.416,30,62,.484,7,27,.259,16,22,.727,97,47,94,.500,31,57,.544,16,37,.432,14,17,.824,124
1869,MIA,2020-02-07,97,@,SAC,L 97-105,240,34,77,.442,22,37,.595,12,40,.300,17,25,.680,97,40,82,.488,21,38,.553,19,44,.432,6,12,.500,105
1870,PHO,2020-02-03,97,@,BRK,L 97-119,240,39,90,.433,33,73,.452,6,17,.353,13,18,.722,97,43,89,.483,28,55,.509,15,34,.441,18,21,.857,119
1871,CHO,2020-01-28,97,,NYK,W 97-92,240,34,88,.386,26,56,.464,8,32,.250,21,27,.778,97,38,86,.442,29,54,.537,9,32,.281,7,11,.636,92
1872,OKC,2020-01-27,97,,DAL,L 97-107,240,34,86,.395,22,56,.393,12,30,.400,17,19,.895,97,41,99,.414,22,48,.458,19,51,.373,6,9,.667,107
1873,BRK,2020-01-26,97,@,NYK,L 97-110,240,34,81,.420,21,42,.500,13,39,.333,16,23,.696,97,49,92,.533,43,73,.589,6,19,.316,6,13,.462,110
1874,ORL,2020-01-26,97,,LAC,L 97-112,240,34,95,.358,27,63,.429,7,32,.219,22,32,.688,97,37,79,.468,24,49,.490,13,30,.433,25,29,.862,112
1875,BRK,2020-01-18,97,,MIL,L 97-117,240,33,99,.333,18,50,.360,15,49,.306,16,17,.941,97,45,89,.506,28,52,.538,17,37,.459,10,16,.625,117
1876,GSW,2020-01-14,97,,DAL,L 97-124,240,39,87,.448,30,55,.545,9,32,.281,10,13,.769,97,49,96,.510,36,59,.610,13,37,.351,13,21,.619,124
1877,CLE,2019-12-31,97,@,TOR,L 97-117,240,37,87,.425,27,49,.551,10,38,.263,13,16,.813,97,40,84,.476,23,45,.511,17,39,.436,20,25,.800,117
1878,PHI,2019-12-31,97,@,IND,L 97-115,240,37,91,.407,31,62,.500,6,29,.207,17,20,.850,97,42,86,.488,31,61,.508,11,25,.440,20,26,.769,115
1879,TOR,2019-12-29,97,,OKC,L 97-98,240,35,83,.422,20,43,.465,15,40,.375,12,12,1.000,97,34,78,.436,24,45,.533,10,33,.303,20,23,.870,98
1880,BOS,2019-12-28,97,,TOR,L 97-113,240,31,78,.397,24,46,.522,7,32,.219,28,36,.778,97,44,84,.524,30,50,.600,14,34,.412,11,17,.647,113
1881,PHI,2019-12-27,97,@,ORL,L 97-98,240,35,87,.402,25,58,.431,10,29,.345,17,21,.810,97,37,88,.420,27,58,.466,10,30,.333,14,23,.609,98
1882,OKC,2019-12-26,97,,MEM,L 97-110,240,38,92,.413,28,57,.491,10,35,.286,11,13,.846,97,46,84,.548,36,59,.610,10,25,.400,8,11,.727,110
1883,PHI,2019-12-10,97,,DEN,W 97-92,240,37,89,.416,25,53,.472,12,36,.333,11,16,.688,97,37,85,.435,30,58,.517,7,27,.259,11,12,.917,92
1884,POR,2019-12-03,97,@,LAC,L 97-117,240,39,91,.429,32,64,.500,7,27,.259,12,15,.800,97,43,94,.457,26,60,.433,17,34,.500,14,25,.560,117
1885,NOP,2019-12-03,97,,DAL,L 97-118,240,38,94,.404,27,53,.509,11,41,.268,10,15,.667,97,38,88,.432,19,43,.442,19,45,.422,23,27,.852,118
1886,DEN,2019-11-30,97,@,SAC,L 97-100 (OT),265,36,87,.414,25,55,.455,11,32,.344,14,21,.667,97,37,96,.385,29,63,.460,8,33,.242,18,21,.857,100
1887,LAC,2019-11-29,97,@,SAS,L 97-107,240,36,92,.391,24,59,.407,12,33,.364,13,13,1.000,97,40,93,.430,26,57,.456,14,36,.389,13,14,.929,107
1888,PHI,2019-11-27,97,,SAC,W 97-91,240,36,77,.468,31,51,.608,5,26,.192,20,24,.833,97,39,95,.411,30,61,.492,9,34,.265,4,9,.444,91
1889,GSW,2019-11-25,97,,OKC,L 97-100,240,37,89,.416,28,69,.406,9,20,.450,14,16,.875,97,40,85,.471,29,53,.547,11,32,.344,9,11,.818,100
1890,SAC,2019-11-22,97,@,BRK,L 97-116,240,39,86,.453,35,60,.583,4,26,.154,15,19,.789,97,41,81,.506,29,47,.617,12,34,.353,22,31,.710,116
1891,ORL,2019-11-20,97,@,TOR,L 97-113,240,35,91,.385,26,59,.441,9,32,.281,18,28,.643,97,45,87,.517,36,60,.600,9,27,.333,14,19,.737,113
1892,SAC,2019-11-15,97,@,LAL,L 97-99,240,36,82,.439,20,43,.465,16,39,.410,9,9,1.000,97,34,81,.420,23,44,.523,11,37,.297,20,22,.909,99
1893,CLE,2019-11-14,97,,MIA,L 97-108,240,36,85,.424,28,53,.528,8,32,.250,17,21,.810,97,43,79,.544,31,49,.633,12,30,.400,10,11,.909,108
1894,PHI,2019-11-13,97,@,ORL,L 97-112,240,40,91,.440,32,61,.525,8,30,.267,9,13,.692,97,38,86,.442,28,54,.519,10,32,.313,26,34,.765,112
1895,CLE,2019-11-12,97,@,PHI,L 97-98,240,38,86,.442,33,65,.508,5,21,.238,16,20,.800,97,40,89,.449,32,51,.627,8,38,.211,10,13,.769,98
1896,PHI,2019-11-08,97,@,DEN,L 97-100,240,38,86,.442,25,60,.417,13,26,.500,8,17,.471,97,39,87,.448,30,65,.462,9,22,.409,13,17,.765,100
1897,SAS,2019-10-31,97,@,LAC,L 97-103,240,36,80,.450,29,59,.492,7,21,.333,18,27,.667,97,39,91,.429,34,65,.523,5,26,.192,20,27,.741,103
1898,ATL,2019-10-31,97,,MIA,L 97-106,240,36,88,.409,29,54,.537,7,34,.206,18,26,.692,97,40,84,.476,26,47,.553,14,37,.378,12,19,.632,106
1899,ATL,2019-10-29,97,@,MIA,L 97-112,240,35,83,.422,24,44,.545,11,39,.282,16,24,.667,97,33,73,.452,20,42,.476,13,31,.419,33,45,.733,112
1900,WAS,2019-10-25,97,@,OKC,W 97-85,240,39,97,.402,28,56,.500,11,41,.268,8,10,.800,97,33,83,.398,28,60,.467,5,23,.217,14,22,.636,85
1901,HOU,2020-08-14,96,,PHI,L 96-134,240,35,80,.438,23,32,.719,12,48,.250,14,16,.875,96,49,87,.563,31,49,.633,18,38,.474,18,22,.818,134
1902,WAS,2020-08-13,96,@,BOS,W 96-90,240,34,88,.386,24,62,.387,10,26,.385,18,24,.750,96,35,88,.398,27,53,.509,8,35,.229,12,14,.857,90
1903,ORL,2020-08-11,96,,BRK,L 96-108,240,32,83,.386,25,60,.417,7,23,.304,25,29,.862,96,38,89,.427,25,46,.543,13,43,.302,19,24,.792,108
1904,NYK,2020-03-08,96,,DET,W 96-84,240,36,82,.439,30,63,.476,6,19,.316,18,25,.720,96,29,80,.363,18,42,.429,11,38,.289,15,22,.682,84
1905,MEM,2020-03-06,96,@,DAL,L 96-121,240,39,84,.464,30,54,.556,9,30,.300,9,13,.692,96,45,95,.474,27,48,.563,18,47,.383,13,17,.765,121
1906,TOR,2020-02-28,96,,CHO,L 96-99,240,33,95,.347,23,52,.442,10,43,.233,20,29,.690,96,34,78,.436,21,48,.438,13,30,.433,18,25,.720,99
1907,NYK,2020-02-12,96,,WAS,L 96-114,240,36,88,.409,33,65,.508,3,23,.130,21,29,.724,96,40,84,.476,30,56,.536,10,28,.357,24,33,.727,114
1908,MEM,2020-02-03,96,,DET,W 96-82,240,42,90,.467,40,73,.548,2,17,.118,10,12,.833,96,34,98,.347,26,72,.361,8,26,.308,6,9,.667,82
1909,DEN,2020-01-28,96,@,MEM,L 96-104,240,32,86,.372,15,41,.366,17,45,.378,15,18,.833,96,46,82,.561,40,64,.625,6,18,.333,6,14,.429,104
1910,GSW,2020-01-22,96,,UTA,L 96-129,240,35,88,.398,29,65,.446,6,23,.261,20,24,.833,96,50,93,.538,33,53,.623,17,40,.425,12,23,.522,129
1911,ORL,2020-01-04,96,,UTA,L 96-109,240,38,85,.447,27,48,.563,11,37,.297,9,12,.750,96,42,93,.452,26,53,.491,16,40,.400,9,14,.643,109
1912,PHO,2019-12-27,96,@,GSW,L 96-105,240,35,75,.467,28,42,.667,7,33,.212,19,24,.792,96,38,92,.413,29,65,.446,9,27,.333,20,25,.800,105
1913,ATL,2019-12-15,96,,LAL,L 96-101,240,31,86,.360,19,44,.432,12,42,.286,22,25,.880,96,36,84,.429,31,53,.585,5,31,.161,24,33,.727,101
1914,LAL,2019-12-11,96,@,ORL,W 96-87,240,37,87,.425,25,56,.446,12,31,.387,10,19,.526,96,34,81,.420,26,55,.473,8,26,.308,11,17,.647,87
1915,POR,2019-12-08,96,,OKC,L 96-108,240,36,100,.360,27,67,.403,9,33,.273,15,18,.833,96,35,85,.412,24,53,.453,11,32,.344,27,34,.794,108
1916,UTA,2019-12-04,96,,LAL,L 96-121,240,34,83,.410,20,52,.385,14,31,.452,14,19,.737,96,46,90,.511,32,61,.525,14,29,.483,15,25,.600,121
1917,DEN,2019-12-03,96,,LAL,L 96-105,240,37,91,.407,31,62,.500,6,29,.207,16,17,.941,96,39,84,.464,32,60,.533,7,24,.292,20,30,.667,105
1918,GSW,2019-12-01,96,@,ORL,L 96-100,240,36,91,.396,30,68,.441,6,23,.261,18,23,.783,96,37,87,.425,26,54,.481,11,33,.333,15,22,.682,100
1919,CHO,2019-11-30,96,@,MIL,L 96-137,240,37,101,.366,22,56,.393,15,45,.333,7,8,.875,96,54,96,.563,34,52,.654,20,44,.455,9,15,.600,137
1920,PHI,2019-11-25,96,@,TOR,L 96-101,240,36,88,.409,21,48,.438,15,40,.375,9,16,.563,96,38,84,.452,27,50,.540,11,34,.324,14,22,.636,101
1921,DEN,2019-11-22,96,,BOS,W 96-92,240,39,88,.443,32,60,.533,7,28,.250,11,13,.846,96,33,81,.407,26,54,.481,7,27,.259,19,23,.826,92
1922,CHO,2019-11-18,96,@,TOR,L 96-132,240,33,78,.423,18,33,.545,15,45,.333,15,24,.625,96,50,97,.515,30,54,.556,20,43,.465,12,15,.800,132
1923,SAS,2019-11-03,96,,LAL,L 96-103,240,33,83,.398,27,58,.466,6,25,.240,24,29,.828,96,42,87,.483,36,63,.571,6,24,.250,13,19,.684,103
1924,LAC,2019-10-30,96,@,UTA,L 96-110,240,39,82,.476,31,59,.525,8,23,.348,10,12,.833,96,44,80,.550,33,56,.589,11,24,.458,11,16,.688,110
1925,CHO,2019-10-28,96,@,LAC,L 96-111,240,36,83,.434,22,44,.500,14,39,.359,10,14,.714,96,40,83,.482,28,50,.560,12,33,.364,19,21,.905,111
1926,UTA,2019-10-28,96,@,PHO,W 96-95,240,27,71,.380,17,40,.425,10,31,.323,32,39,.821,96,33,80,.413,20,46,.435,13,34,.382,16,23,.696,95
1927,DET,2019-10-28,96,,IND,W 96-94,240,37,81,.457,24,57,.421,13,24,.542,9,10,.900,96,39,94,.415,33,73,.452,6,21,.286,10,13,.769,94
1928,MIL,2020-03-09,95,@,DEN,L 95-109,240,34,90,.378,19,40,.475,15,50,.300,12,18,.667,95,41,94,.436,25,53,.472,16,41,.390,11,12,.917,109
1929,ORL,2020-02-08,95,,MIL,L 95-111,240,37,98,.378,27,58,.466,10,40,.250,11,14,.786,95,42,93,.452,27,54,.500,15,39,.385,12,16,.750,111
1930,NYK,2020-02-08,95,@,DET,W 95-92,240,38,85,.447,30,63,.476,8,22,.364,11,17,.647,95,34,69,.493,21,40,.525,13,29,.448,11,16,.688,92
1931,UTA,2020-02-05,95,,DEN,L 95-98,240,36,86,.419,22,47,.468,14,39,.359,9,14,.643,95,39,90,.433,32,60,.533,7,30,.233,13,18,.722,98
1932,PHI,2020-02-01,95,@,BOS,L 95-116,240,31,84,.369,24,51,.471,7,33,.212,26,31,.839,95,38,80,.475,30,50,.600,8,30,.267,32,41,.780,116
1933,MEM,2020-01-22,95,@,BOS,L 95-119,240,36,85,.424,25,53,.472,11,32,.344,12,15,.800,95,45,89,.506,31,57,.544,14,32,.438,15,20,.750,119
1934,PHI,2020-01-22,95,@,TOR,L 95-107,240,32,84,.381,14,38,.368,18,46,.391,13,18,.722,95,40,86,.465,27,53,.509,13,33,.394,14,21,.667,107
1935,LAC,2020-01-22,95,@,ATL,L 95-102,240,33,78,.423,29,57,.509,4,21,.190,25,39,.641,95,36,102,.353,25,67,.373,11,35,.314,19,23,.826,102
1936,ORL,2020-01-18,95,@,GSW,L 95-109,240,39,86,.453,30,55,.545,9,31,.290,8,13,.615,95,43,94,.457,31,54,.574,12,40,.300,11,11,1.000,109
1937,ORL,2020-01-16,95,@,LAC,L 95-122,240,36,92,.391,22,50,.440,14,42,.333,9,16,.563,95,47,95,.495,33,63,.524,14,32,.438,14,20,.700,122
1938,PHI,2020-01-13,95,@,IND,L 95-101,240,37,89,.416,31,56,.554,6,33,.182,15,19,.789,95,33,86,.384,23,60,.383,10,26,.385,25,31,.806,101
1939,DAL,2019-12-29,95,@,LAL,L 95-108,240,32,89,.360,19,46,.413,13,43,.302,18,20,.900,95,38,78,.487,29,55,.527,9,23,.391,23,28,.821,108
1940,CHI,2019-12-23,95,@,ORL,L 95-103,240,35,88,.398,22,51,.431,13,37,.351,12,15,.800,95,39,81,.481,29,55,.527,10,26,.385,15,23,.652,103
1941,DEN,2019-12-06,95,@,BOS,L 95-108,240,39,94,.415,34,64,.531,5,30,.167,12,15,.800,95,44,82,.537,31,47,.660,13,35,.371,7,8,.875,108
1942,NYK,2019-11-29,95,,PHI,L 95-101,240,34,78,.436,26,58,.448,8,20,.400,19,33,.576,95,31,72,.431,24,46,.522,7,26,.269,32,40,.800,101
1943,MIN,2019-11-20,95,,UTA,L 95-103,240,35,89,.393,21,44,.477,14,45,.311,11,21,.524,95,35,86,.407,21,53,.396,14,33,.424,19,27,.704,103
1944,HOU,2019-11-20,95,@,DEN,L 95-105,240,32,76,.421,20,38,.526,12,38,.316,19,25,.760,95,44,94,.468,35,67,.522,9,27,.333,8,15,.533,105
1945,MEM,2019-11-19,95,,GSW,L 95-114,240,36,88,.409,27,63,.429,9,25,.360,14,19,.737,95,43,90,.478,34,61,.557,9,29,.310,19,22,.864,114
1946,CLE,2019-11-17,95,,PHI,L 95-114,240,34,90,.378,28,65,.431,6,25,.240,21,24,.875,95,46,84,.548,37,61,.607,9,23,.391,13,17,.765,114
1947,LAL,2019-11-08,95,,MIA,W 95-80,240,40,89,.449,32,57,.561,8,32,.250,7,8,.875,95,28,80,.350,22,45,.489,6,35,.171,18,24,.750,80
1948,CHI,2019-11-03,95,@,IND,L 95-108,240,36,84,.429,27,55,.491,9,29,.310,14,25,.560,95,40,85,.471,32,59,.542,8,26,.308,20,27,.741,108
1949,CLE,2019-11-01,95,@,IND,L 95-102,240,32,87,.368,21,55,.382,11,32,.344,20,25,.800,95,39,96,.406,34,69,.493,5,27,.185,19,21,.905,102
1950,MIN,2019-10-30,95,@,PHI,L 95-117,240,32,81,.395,22,46,.478,10,35,.286,21,28,.750,95,43,92,.467,34,67,.507,9,25,.360,22,28,.786,117
1951,ORL,2019-10-30,95,,NYK,W 95-83,240,37,88,.420,25,56,.446,12,32,.375,9,12,.750,95,31,82,.378,24,51,.471,7,31,.226,14,20,.700,83
1952,PHO,2019-10-28,95,,UTA,L 95-96,240,33,80,.413,20,46,.435,13,34,.382,16,23,.696,95,27,71,.380,17,40,.425,10,31,.323,32,39,.821,96
1953,ORL,2019-10-28,95,@,TOR,L 95-104,240,34,89,.382,22,50,.440,12,39,.308,15,18,.833,95,33,85,.388,23,46,.500,10,39,.256,28,30,.933,104
1954,NYK,2019-10-26,95,,BOS,L 95-118,240,31,82,.378,24,55,.436,7,27,.259,26,34,.765,95,42,93,.452,27,52,.519,15,41,.366,19,29,.655,118
1955,LAL,2019-10-25,95,,UTA,W 95-86,240,34,86,.395,26,60,.433,8,26,.308,19,24,.792,95,29,70,.414,21,45,.467,8,25,.320,20,21,.952,86
1956,SAC,2019-10-23,95,@,PHO,L 95-124,240,34,87,.391,24,58,.414,10,29,.345,17,26,.654,95,49,98,.500,38,65,.585,11,33,.333,15,18,.833,124
1957,OKC,2019-10-23,95,@,UTA,L 95-100,240,32,83,.386,22,56,.393,10,27,.370,21,31,.677,95,40,90,.444,34,66,.515,6,24,.250,14,20,.700,100
1958,UTA,2020-08-01,94,@,OKC,L 94-110,240,34,87,.391,26,56,.464,8,31,.258,18,22,.818,94,41,77,.532,31,51,.608,10,26,.385,18,24,.750,110
1959,BOS,2020-03-06,94,,UTA,L 94-99,240,35,94,.372,25,58,.431,10,36,.278,14,18,.778,94,36,80,.450,19,35,.543,17,45,.378,10,12,.833,99
1960,OKC,2020-03-03,94,,LAC,L 94-109,240,34,81,.420,25,53,.472,9,28,.321,17,26,.654,94,38,84,.452,27,48,.563,11,36,.306,22,26,.846,109
1961,PHI,2020-02-26,94,@,CLE,L 94-108,240,36,89,.404,23,51,.451,13,38,.342,9,14,.643,94,41,78,.526,30,54,.556,11,24,.458,15,17,.882,108
1962,GSW,2020-02-25,94,,SAC,L 94-112,240,35,79,.443,31,51,.608,4,28,.143,20,24,.833,94,40,76,.526,27,46,.587,13,30,.433,19,34,.559,112
1963,ORL,2020-01-10,94,@,PHO,L 94-98,240,33,89,.371,24,56,.429,9,33,.273,19,24,.792,94,33,79,.418,24,51,.471,9,28,.321,23,26,.885,98
1964,BOS,2020-01-06,94,@,WAS,L 94-99,240,33,95,.347,25,58,.431,8,37,.216,20,26,.769,94,39,84,.464,32,63,.508,7,21,.333,14,23,.609,99
1965,CLE,2019-12-28,94,@,MIN,W 94-88,240,32,77,.416,28,57,.491,4,20,.200,26,36,.722,94,33,93,.355,25,56,.446,8,37,.216,14,19,.737,88
1966,NYK,2019-12-26,94,@,BRK,W 94-82,240,37,92,.402,28,63,.444,9,29,.310,11,15,.733,94,21,78,.269,8,28,.286,13,50,.260,27,36,.750,82
1967,POR,2019-12-23,94,,NOP,L 94-102,240,37,91,.407,33,62,.532,4,29,.138,16,18,.889,94,38,93,.409,23,58,.397,15,35,.429,11,16,.688,102
1968,SAC,2019-12-11,94,,OKC,W 94-93,240,39,88,.443,29,57,.509,10,31,.323,6,10,.600,94,34,79,.430,21,46,.457,13,33,.394,12,18,.667,93
1969,CLE,2019-12-07,94,@,PHI,L 94-141,240,36,96,.375,27,61,.443,9,35,.257,13,17,.765,94,57,90,.633,46,64,.719,11,26,.423,16,23,.696,141
1970,CLE,2019-12-03,94,,DET,L 94-127,240,38,90,.422,30,63,.476,8,27,.296,10,14,.714,94,51,94,.543,33,59,.559,18,35,.514,7,11,.636,127
1971,UTA,2019-12-02,94,@,PHI,L 94-103,240,38,81,.469,33,59,.559,5,22,.227,13,20,.650,94,37,91,.407,24,65,.369,13,26,.500,16,23,.696,103
1972,MEM,2019-11-29,94,,UTA,L 94-103,240,37,94,.394,27,60,.450,10,34,.294,10,17,.588,94,38,95,.400,26,60,.433,12,35,.343,15,19,.789,103
1973,CHI,2019-11-25,94,,POR,L 94-117,240,36,86,.419,27,47,.574,9,39,.231,13,20,.650,94,46,89,.517,38,62,.613,8,27,.296,17,22,.773,117
1974,GSW,2019-11-20,94,@,DAL,L 94-142,240,35,90,.389,27,63,.429,8,27,.296,16,25,.640,94,51,90,.567,29,52,.558,22,38,.579,18,23,.783,142
1975,NOP,2019-11-16,94,@,MIA,L 94-109,240,37,82,.451,21,47,.447,16,35,.457,4,6,.667,94,44,81,.543,35,57,.614,9,24,.375,12,13,.923,109
1976,GSW,2019-11-13,94,@,LAL,L 94-120,240,36,89,.404,27,54,.500,9,35,.257,13,17,.765,94,48,89,.539,39,69,.565,9,20,.450,15,18,.833,120
1977,CHI,2019-11-09,94,,HOU,L 94-117,240,37,98,.378,33,66,.500,4,32,.125,16,18,.889,94,39,83,.470,20,39,.513,19,44,.432,20,28,.714,117
1978,ORL,2019-11-05,94,@,OKC,L 94-102,240,32,82,.390,29,60,.483,3,22,.136,27,31,.871,94,37,86,.430,25,53,.472,12,33,.364,16,20,.800,102
1979,UTA,2019-11-03,94,@,LAC,L 94-105,240,31,78,.397,21,47,.447,10,31,.323,22,31,.710,94,36,92,.391,29,60,.483,7,32,.219,26,34,.765,105
1980,IND,2019-10-28,94,@,DET,L 94-96,240,39,94,.415,33,73,.452,6,21,.286,10,13,.769,94,37,81,.457,24,57,.421,13,24,.542,9,10,.900,96
1981,SAC,2019-10-28,94,,DEN,L 94-101,240,36,91,.396,24,54,.444,12,37,.324,10,16,.625,94,36,98,.367,26,62,.419,10,36,.278,19,21,.905,101
1982,ORL,2019-10-23,94,,CLE,W 94-85,240,37,86,.430,28,56,.500,9,30,.300,11,19,.579,94,33,88,.375,24,54,.444,9,34,.265,10,15,.667,85
1983,MIL,2020-03-01,93,@,CHO,W 93-85,240,35,87,.402,28,56,.500,7,31,.226,16,21,.762,93,34,96,.354,26,61,.426,8,35,.229,9,10,.900,85
1984,CHI,2020-02-20,93,,CHO,L 93-103,240,37,87,.425,30,56,.536,7,31,.226,12,19,.632,93,35,74,.473,27,46,.587,8,28,.286,25,29,.862,103
1985,POR,2020-01-01,93,@,NYK,L 93-117,240,37,94,.394,27,62,.435,10,32,.313,9,15,.600,93,47,98,.480,33,62,.532,14,36,.389,9,14,.643,117
1986,ORL,2019-12-30,93,,ATL,L 93-101,240,37,89,.416,32,64,.500,5,25,.200,14,24,.583,93,39,81,.481,30,52,.577,9,29,.310,14,17,.824,101
1987,CHO,2019-12-22,93,@,BOS,L 93-119,240,33,82,.402,23,48,.479,10,34,.294,17,23,.739,93,46,88,.523,32,56,.571,14,32,.438,13,16,.813,119
1988,DET,2019-12-20,93,@,BOS,L 93-114,240,34,85,.400,23,54,.426,11,31,.355,14,19,.737,93,45,86,.523,36,59,.610,9,27,.333,15,21,.714,114
1989,OKC,2019-12-11,93,@,SAC,L 93-94,240,34,79,.430,21,46,.457,13,33,.394,12,18,.667,93,39,88,.443,29,57,.509,10,31,.323,6,10,.600,94
1990,TOR,2019-12-09,93,@,CHI,W 93-92,240,34,90,.378,27,61,.443,7,29,.241,18,26,.692,93,35,89,.393,23,43,.535,12,46,.261,10,14,.714,92
1991,ORL,2019-12-06,93,@,CLE,W 93-87,240,32,82,.390,23,56,.411,9,26,.346,20,23,.870,93,35,83,.422,25,49,.510,10,34,.294,7,10,.700,87
1992,MIA,2019-12-04,93,@,BOS,L 93-112,240,34,77,.442,20,39,.513,14,38,.368,11,17,.647,93,35,79,.443,19,38,.500,16,41,.390,26,32,.813,112
1993,BRK,2019-11-14,93,@,DEN,L 93-101,240,36,95,.379,28,57,.491,8,38,.211,13,16,.813,93,43,101,.426,33,68,.485,10,33,.303,5,10,.500,101
1994,LAC,2019-11-13,93,@,HOU,L 93-102,240,38,98,.388,28,65,.431,10,33,.303,7,14,.500,93,33,86,.384,19,44,.432,14,42,.333,22,27,.815,102
1995,ATL,2019-11-06,93,,CHI,L 93-113,240,30,74,.405,24,44,.545,6,30,.200,27,35,.771,93,41,82,.500,28,49,.571,13,33,.394,18,27,.667,113
1996,CHO,2019-11-02,93,@,GSW,W 93-87,240,36,85,.424,31,56,.554,5,29,.172,16,23,.696,93,34,77,.442,25,49,.510,9,28,.321,10,13,.769,87
1997,BOS,2019-10-23,93,@,PHI,L 93-107,240,33,90,.367,26,64,.406,7,26,.269,20,34,.588,93,37,85,.435,30,56,.536,7,29,.241,26,36,.722,107
1998,MIA,2020-08-14,92,@,IND,L 92-109,240,31,87,.356,21,49,.429,10,38,.263,20,27,.741,92,43,89,.483,28,51,.549,15,38,.395,8,11,.727,109
1999,IND,2020-08-10,92,@,MIA,L 92-114,240,33,84,.393,23,49,.469,10,35,.286,16,25,.640,92,44,98,.449,31,58,.534,13,40,.325,13,19,.684,114
2000,OKC,2020-08-07,92,@,MEM,L 92-121,240,34,97,.351,21,54,.389,13,43,.302,11,15,.733,92,46,83,.554,35,52,.673,11,31,.355,18,20,.900,121
2001,LAL,2020-08-01,92,@,TOR,L 92-107,240,29,82,.354,19,42,.452,10,40,.250,24,33,.727,92,35,84,.417,21,50,.420,14,34,.412,23,26,.885,107
2002,UTA,2020-03-09,92,,TOR,L 92-101,240,33,83,.398,17,40,.425,16,43,.372,10,14,.714,92,36,83,.434,23,47,.489,13,36,.361,16,18,.889,101
2003,PHO,2020-02-26,92,,LAC,L 92-102,240,34,87,.391,25,53,.472,9,34,.265,15,18,.833,92,37,84,.440,23,46,.500,14,38,.368,14,15,.933,102
2004,CLE,2020-02-09,92,,LAC,L 92-133,240,35,95,.368,28,62,.452,7,33,.212,15,22,.682,92,53,93,.570,41,57,.719,12,36,.333,15,20,.750,133
2005,DET,2020-02-08,92,,NYK,L 92-95,240,34,69,.493,21,40,.525,13,29,.448,11,16,.688,92,38,85,.447,30,63,.476,8,22,.364,11,17,.647,95
2006,NYK,2020-02-01,92,@,IND,W 92-85,240,34,82,.415,27,56,.482,7,26,.269,17,23,.739,92,32,76,.421,24,52,.462,8,24,.333,13,21,.619,85
2007,DET,2020-01-31,92,,TOR,L 92-105,240,28,79,.354,17,43,.395,11,36,.306,25,34,.735,92,44,85,.518,35,58,.603,9,27,.333,8,11,.727,105
2008,NYK,2020-01-28,92,@,CHO,L 92-97,240,38,86,.442,29,54,.537,9,32,.281,7,11,.636,92,34,88,.386,26,56,.464,8,32,.250,21,27,.778,97
2009,ORL,2020-01-27,92,@,MIA,L 92-113,240,33,89,.371,22,52,.423,11,37,.297,15,19,.789,92,42,79,.532,28,51,.549,14,28,.500,15,16,.938,113
2010,NYK,2020-01-22,92,,LAL,L 92-100,240,36,88,.409,25,54,.463,11,34,.324,9,13,.692,92,36,82,.439,27,55,.491,9,27,.333,19,28,.679,100
2011,CHO,2020-01-12,92,@,PHO,L 92-100,240,36,86,.419,28,51,.549,8,35,.229,12,18,.667,92,41,82,.500,34,61,.557,7,21,.333,11,18,.611,100
2012,CHO,2020-01-10,92,@,UTA,L 92-109,240,35,75,.467,27,49,.551,8,26,.308,14,19,.737,92,40,79,.506,22,37,.595,18,42,.429,11,14,.786,109
2013,HOU,2020-01-09,92,@,OKC,L 92-113,240,34,89,.382,23,49,.469,11,40,.275,13,14,.929,92,43,87,.494,32,55,.582,11,32,.344,16,20,.800,113
2014,CHO,2019-12-31,92,,BOS,L 92-109,240,34,86,.395,22,52,.423,12,34,.353,12,16,.750,92,44,97,.454,30,59,.508,14,38,.368,7,10,.700,109
2015,TOR,2019-12-11,92,,LAC,L 92-112,240,31,88,.352,23,52,.442,8,36,.222,22,25,.880,92,38,86,.442,26,46,.565,12,40,.300,24,27,.889,112
2016,DEN,2019-12-10,92,@,PHI,L 92-97,240,37,85,.435,30,58,.517,7,27,.259,11,12,.917,92,37,89,.416,25,53,.472,12,36,.333,11,16,.688,97
2017,CHI,2019-12-09,92,,TOR,L 92-93,240,35,89,.393,23,43,.535,12,46,.261,10,14,.714,92,34,90,.378,27,61,.443,7,29,.241,18,26,.692,93
2018,NYK,2019-12-05,92,,DEN,L 92-129,240,34,83,.410,25,49,.510,9,34,.265,15,23,.652,92,49,87,.563,28,48,.583,21,39,.538,10,18,.556,129
2019,BOS,2019-11-22,92,@,DEN,L 92-96,240,33,81,.407,26,54,.481,7,27,.259,19,23,.826,92,39,88,.443,32,60,.533,7,28,.250,11,13,.846,96
2020,NYK,2019-11-03,92,,SAC,L 92-113,240,32,80,.400,24,49,.490,8,31,.258,20,31,.645,92,41,85,.482,26,46,.565,15,39,.385,16,25,.640,113
2021,GSW,2019-10-27,92,@,OKC,L 92-120,240,30,92,.326,25,59,.424,5,33,.152,27,31,.871,92,44,78,.564,29,46,.630,15,32,.469,17,22,.773,120
2022,MIN,2020-03-01,91,,DAL,L 91-111,240,36,99,.364,23,57,.404,13,42,.310,6,15,.400,91,44,94,.468,33,54,.611,11,40,.275,12,19,.632,111
2023,TOR,2020-02-12,91,@,BRK,L 91-101,240,34,90,.378,21,47,.447,13,43,.302,10,13,.769,91,36,88,.409,27,53,.509,9,35,.257,20,25,.800,101
2024,HOU,2020-02-07,91,@,PHO,L 91-127,240,29,85,.341,18,37,.486,11,48,.229,22,26,.846,91,43,77,.558,28,46,.609,15,31,.484,26,27,.963,127
2025,LAL,2020-01-25,91,@,PHI,L 91-108,240,35,76,.461,29,45,.644,6,31,.194,15,23,.652,91,41,78,.526,28,41,.683,13,37,.351,13,19,.684,108
2026,PHI,2020-01-11,91,@,DAL,L 91-109,240,37,98,.378,28,61,.459,9,37,.243,8,12,.667,91,40,79,.506,29,52,.558,11,27,.407,18,27,.667,109
2027,LAC,2019-12-06,91,@,MIL,L 91-119,240,33,94,.351,25,62,.403,8,32,.250,17,19,.895,91,44,94,.468,30,58,.517,14,36,.389,17,21,.810,119
2028,GSW,2019-12-04,91,@,CHO,L 91-106,240,36,78,.462,27,55,.491,9,23,.391,10,15,.667,91,40,87,.460,19,39,.487,21,48,.438,5,8,.625,106
2029,SAC,2019-11-27,91,@,PHI,L 91-97,240,39,95,.411,30,61,.492,9,34,.265,4,9,.444,91,36,77,.468,31,51,.608,5,26,.192,20,24,.833,97
2030,CHO,2019-11-20,91,@,BRK,L 91-101,240,30,81,.370,19,48,.396,11,33,.333,20,26,.769,91,36,90,.400,26,51,.510,10,39,.256,19,23,.826,101
2031,DEN,2019-11-02,91,@,ORL,W 91-87,240,27,73,.370,18,45,.400,9,28,.321,28,39,.718,91,37,86,.430,31,57,.544,6,29,.207,7,11,.636,87
2032,ORL,2019-11-01,91,,MIL,L 91-123,240,34,91,.374,22,54,.407,12,37,.324,11,17,.647,91,47,93,.505,30,46,.652,17,47,.362,12,18,.667,123
2033,MEM,2019-10-29,91,@,LAL,L 91-120,240,31,95,.326,24,61,.393,7,34,.206,22,23,.957,91,40,86,.465,33,60,.550,7,26,.269,33,39,.846,120
2034,BOS,2020-08-13,90,,WAS,L 90-96,240,35,88,.398,27,53,.509,8,35,.229,12,14,.857,90,34,88,.386,24,62,.387,10,26,.385,18,24,.750,96
2035,CHO,2020-02-01,90,@,SAS,L 90-114,240,35,83,.422,25,47,.532,10,36,.278,10,12,.833,90,45,87,.517,35,59,.593,10,28,.357,14,21,.667,114
2036,PHI,2020-01-18,90,@,NYK,W 90-87,240,34,78,.436,24,46,.522,10,32,.313,12,19,.632,90,35,88,.398,29,63,.460,6,25,.240,11,18,.611,87
2037,UTA,2019-12-09,90,,OKC,L 90-104,240,36,89,.404,28,58,.483,8,31,.258,10,12,.833,90,40,85,.471,32,57,.561,8,28,.286,16,19,.842,104
2038,TOR,2019-11-29,90,@,ORL,W 90-83,240,31,84,.369,20,46,.435,11,38,.289,17,28,.607,90,27,78,.346,20,49,.408,7,29,.241,22,27,.815,83
2039,CHI,2019-11-27,90,@,GSW,L 90-104,240,34,89,.382,24,60,.400,10,29,.345,12,18,.667,90,37,81,.457,26,52,.500,11,29,.379,19,26,.731,104
2040,DET,2019-11-23,90,@,MIL,L 90-104,240,37,91,.407,27,56,.482,10,35,.286,6,10,.600,90,41,84,.488,28,47,.596,13,37,.351,9,18,.500,104
2041,LAC,2019-11-18,90,,OKC,W 90-88,240,35,87,.402,25,51,.490,10,36,.278,10,14,.714,90,28,75,.373,21,48,.438,7,27,.259,25,28,.893,88
2042,WAS,2020-03-08,89,,MIA,L 89-100,240,26,78,.333,7,31,.226,19,47,.404,18,21,.857,89,32,66,.485,19,38,.500,13,28,.464,23,28,.821,100
2043,MIL,2020-03-02,89,@,MIA,L 89-105,240,35,86,.407,28,52,.538,7,34,.206,12,19,.632,89,37,86,.430,19,49,.388,18,37,.486,13,18,.722,105
2044,ORL,2020-02-01,89,,MIA,L 89-102,240,33,83,.398,24,50,.480,9,33,.273,14,17,.824,89,33,77,.429,18,44,.409,15,33,.455,21,26,.808,102
2045,CHI,2020-01-17,89,@,PHI,L 89-100,240,35,81,.432,27,46,.587,8,35,.229,11,15,.733,89,40,82,.488,31,53,.585,9,29,.310,11,11,1.000,100
2046,WAS,2020-01-08,89,@,ORL,L 89-123,240,36,84,.429,30,61,.492,6,23,.261,11,19,.579,89,43,87,.494,33,60,.550,10,27,.370,27,34,.794,123
2047,BRK,2020-01-06,89,@,ORL,L 89-101,240,32,96,.333,22,49,.449,10,47,.213,15,19,.789,89,35,81,.432,27,55,.491,8,26,.308,23,31,.742,101
2048,IND,2019-12-22,89,@,MIL,L 89-117,240,37,100,.370,25,60,.417,12,40,.300,3,5,.600,89,44,104,.423,29,60,.483,15,44,.341,14,17,.824,117
2049,PHI,2019-12-15,89,@,BRK,L 89-109,240,37,86,.430,32,60,.533,5,26,.192,10,17,.588,89,43,94,.457,34,70,.486,9,24,.375,14,18,.778,109
2050,DET,2019-11-20,89,@,CHI,L 89-109,240,28,83,.337,20,50,.400,8,33,.242,25,32,.781,89,39,91,.429,25,64,.391,14,27,.519,17,26,.654,109
2051,MIA,2019-11-05,89,@,DEN,L 89-109,240,32,88,.364,23,59,.390,9,29,.310,16,25,.640,89,45,86,.523,36,63,.571,9,23,.391,10,16,.625,109
2052,ATL,2020-03-02,88,,MEM,L 88-127,240,32,99,.323,23,64,.359,9,35,.257,15,16,.938,88,46,92,.500,32,60,.533,14,32,.438,21,31,.677,127
2053,LAL,2020-02-29,88,@,MEM,L 88-105,240,36,87,.414,27,52,.519,9,35,.257,7,12,.583,88,43,95,.453,33,64,.516,10,31,.323,9,11,.818,105
2054,GSW,2020-02-05,88,@,BRK,L 88-129,240,35,96,.365,30,57,.526,5,39,.128,13,18,.722,88,51,100,.510,37,66,.561,14,34,.412,13,15,.867,129
2055,IND,2020-01-20,88,@,UTA,L 88-118,240,39,93,.419,32,67,.478,7,26,.269,3,7,.429,88,47,87,.540,35,56,.625,12,31,.387,12,12,1.000,118
2056,MIN,2019-12-28,88,,CLE,L 88-94,240,33,93,.355,25,56,.446,8,37,.216,14,19,.737,88,32,77,.416,28,57,.491,4,20,.200,26,36,.722,94
2057,CLE,2019-12-09,88,@,BOS,L 88-110,240,36,91,.396,29,60,.483,7,31,.226,9,19,.474,88,45,78,.577,30,51,.588,15,27,.556,5,8,.625,110
2058,NYK,2019-12-02,88,@,MIL,L 88-132,240,28,91,.308,18,52,.346,10,39,.256,22,33,.667,88,48,86,.558,32,51,.627,16,35,.457,20,32,.625,132
2059,ORL,2019-11-25,88,@,DET,L 88-103,240,32,84,.381,24,59,.407,8,25,.320,16,22,.727,88,34,79,.430,20,41,.488,14,38,.368,21,25,.840,103
2060,OKC,2019-11-18,88,@,LAC,L 88-90,240,28,75,.373,21,48,.438,7,27,.259,25,28,.893,88,35,87,.402,25,51,.490,10,36,.278,10,14,.714,90
2061,TOR,2019-11-11,88,@,LAC,L 88-98,240,34,85,.400,23,55,.418,11,30,.367,9,15,.600,88,34,92,.370,26,56,.464,8,36,.222,22,30,.733,98
2062,CHO,2020-02-10,87,@,DET,W 87-76,240,33,88,.375,24,52,.462,9,36,.250,12,14,.857,87,29,82,.354,22,47,.468,7,35,.200,11,13,.846,76
2063,PHO,2020-01-22,87,,IND,L 87-112,240,30,84,.357,26,64,.406,4,20,.200,23,26,.885,87,45,84,.536,36,64,.563,9,20,.450,13,20,.650,112
2064,NYK,2020-01-18,87,,PHI,L 87-90,240,35,88,.398,29,63,.460,6,25,.240,11,18,.611,87,34,78,.436,24,46,.522,10,32,.313,12,19,.632,90
2065,NYK,2020-01-07,87,@,LAL,L 87-117,240,37,95,.389,33,75,.440,4,20,.200,9,16,.563,87,41,82,.500,24,46,.522,17,36,.472,18,21,.857,117
2066,SAC,2019-12-31,87,,LAC,L 87-105,240,33,80,.413,25,52,.481,8,28,.286,13,19,.684,87,36,88,.409,24,52,.462,12,36,.333,21,22,.955,105
2067,ORL,2019-12-11,87,,LAL,L 87-96,240,34,81,.420,26,55,.473,8,26,.308,11,17,.647,87,37,87,.425,25,56,.446,12,31,.387,10,19,.526,96
2068,NYK,2019-12-10,87,@,POR,L 87-115,240,32,91,.352,25,53,.472,7,38,.184,16,26,.615,87,39,90,.433,22,49,.449,17,41,.415,20,24,.833,115
2069,CLE,2019-12-06,87,,ORL,L 87-93,240,35,83,.422,25,49,.510,10,34,.294,7,10,.700,87,32,82,.390,23,56,.411,9,26,.346,20,23,.870,93
2070,NYK,2019-11-10,87,,CLE,L 87-108,240,31,86,.360,22,55,.400,9,31,.290,16,25,.640,87,36,82,.439,28,54,.519,8,28,.286,28,31,.903,108
2071,CHO,2019-11-07,87,,BOS,L 87-108,240,33,86,.384,27,55,.491,6,31,.194,15,21,.714,87,40,93,.430,30,60,.500,10,33,.303,18,23,.783,108
2072,ORL,2019-11-02,87,,DEN,L 87-91,240,37,86,.430,31,57,.544,6,29,.207,7,11,.636,87,27,73,.370,18,45,.400,9,28,.321,28,39,.718,91
2073,GSW,2019-11-02,87,,CHO,L 87-93,240,34,77,.442,25,49,.510,9,28,.321,10,13,.769,87,36,85,.424,31,56,.554,5,29,.172,16,23,.696,93
2074,LAL,2020-08-05,86,,OKC,L 86-105,240,31,88,.352,26,51,.510,5,37,.135,19,29,.655,86,34,79,.430,29,55,.527,5,24,.208,32,36,.889,105
2075,OKC,2020-02-28,86,@,MIL,L 86-133,240,33,91,.363,27,56,.482,6,35,.171,14,20,.700,86,50,100,.500,29,55,.527,21,45,.467,12,14,.857,133
2076,GSW,2020-02-27,86,,LAL,L 86-116,240,34,80,.425,25,48,.521,9,32,.281,9,10,.900,86,45,88,.511,37,64,.578,8,24,.333,18,27,.667,116
2077,CHO,2020-02-22,86,,BRK,L 86-115,240,31,88,.352,19,53,.358,12,35,.343,12,21,.571,86,42,87,.483,25,40,.625,17,47,.362,14,19,.737,115
2078,CLE,2020-01-20,86,,NYK,L 86-106,240,32,94,.340,21,61,.344,11,33,.333,11,17,.647,86,41,85,.482,32,62,.516,9,23,.391,15,17,.882,106
2079,CHO,2020-01-15,86,@,DEN,L 86-100,240,33,81,.407,21,46,.457,12,35,.343,8,14,.571,86,38,79,.481,29,51,.569,9,28,.321,15,25,.600,100
2080,ATL,2020-01-12,86,@,BRK,L 86-108,240,32,97,.330,20,49,.408,12,48,.250,10,11,.909,86,41,77,.532,31,51,.608,10,26,.385,16,29,.552,108
2081,ATL,2019-12-27,86,,MIL,L 86-112,240,33,91,.363,21,50,.420,12,41,.293,8,14,.571,86,46,91,.505,35,63,.556,11,28,.393,9,13,.692,112
2082,MIA,2019-11-23,86,@,PHI,L 86-113,240,30,75,.400,24,51,.471,6,24,.250,20,27,.741,86,42,83,.506,28,54,.519,14,29,.483,15,17,.882,113
2083,BRK,2019-11-18,86,,IND,L 86-115,240,30,84,.357,19,50,.380,11,34,.324,15,24,.625,86,44,101,.436,30,68,.441,14,33,.424,13,17,.765,115
2084,MEM,2019-11-08,86,@,ORL,L 86-118,240,32,86,.372,21,57,.368,11,29,.379,11,13,.846,86,44,93,.473,37,65,.569,7,28,.250,23,27,.852,118
2085,UTA,2019-10-25,86,@,LAL,L 86-95,240,29,70,.414,21,45,.467,8,25,.320,20,21,.952,86,34,86,.395,26,60,.433,8,26,.308,19,24,.792,95
2086,CHO,2020-03-01,85,,MIL,L 85-93,240,34,96,.354,26,61,.426,8,35,.229,9,10,.900,85,35,87,.402,28,56,.500,7,31,.226,16,21,.762,93
2087,IND,2020-02-01,85,,NYK,L 85-92,240,32,76,.421,24,52,.462,8,24,.333,13,21,.619,85,34,82,.415,27,56,.482,7,26,.269,17,23,.739,92
2088,MIA,2020-01-03,85,@,ORL,L 85-105,240,30,80,.375,23,43,.535,7,37,.189,18,23,.783,85,33,81,.407,20,46,.435,13,35,.371,26,29,.897,105
2089,CHO,2019-12-15,85,@,IND,L 85-107,240,28,91,.308,23,59,.390,5,32,.156,24,35,.686,85,40,88,.455,30,53,.566,10,35,.286,17,20,.850,107
2090,PHO,2019-11-18,85,,BOS,L 85-99,240,33,82,.402,23,46,.500,10,36,.278,9,12,.750,85,37,89,.416,25,48,.521,12,41,.293,13,17,.765,99
2091,OKC,2019-11-12,85,@,IND,L 85-111,240,29,82,.354,23,57,.404,6,25,.240,21,24,.875,85,46,94,.489,39,71,.549,7,23,.304,12,13,.923,111
2092,OKC,2019-10-25,85,,WAS,L 85-97,240,33,83,.398,28,60,.467,5,23,.217,14,22,.636,85,39,97,.402,28,56,.500,11,41,.268,8,10,.800,97
2093,CLE,2019-10-23,85,@,ORL,L 85-94,240,33,88,.375,24,54,.444,9,34,.265,10,15,.667,85,37,86,.430,28,56,.500,9,30,.300,11,19,.579,94
2094,DET,2020-03-08,84,@,NYK,L 84-96,240,29,80,.363,18,42,.429,11,38,.289,15,22,.682,84,36,82,.439,30,63,.476,6,19,.316,18,25,.720,96
2095,MIA,2020-01-02,84,,TOR,W 84-76,240,33,81,.407,21,44,.477,12,37,.324,6,11,.545,84,28,89,.315,22,47,.468,6,42,.143,14,17,.824,76
2096,GSW,2020-01-02,84,@,MIN,L 84-99,240,33,77,.429,30,57,.526,3,20,.150,15,21,.714,84,38,95,.400,25,52,.481,13,43,.302,10,17,.588,99
2097,NOP,2019-12-07,84,@,DAL,L 84-130,240,32,89,.360,29,57,.509,3,32,.094,17,21,.810,84,46,86,.535,33,48,.688,13,38,.342,25,31,.806,130
2098,CHI,2019-10-26,84,,TOR,L 84-108,240,29,97,.299,20,62,.323,9,35,.257,17,25,.680,84,38,82,.463,23,40,.575,15,42,.357,17,18,.944,108
2099,CHO,2020-01-20,83,,ORL,L 83-106,240,29,76,.382,19,43,.442,10,33,.303,15,20,.750,83,44,92,.478,30,64,.469,14,28,.500,4,9,.444,106
2100,CHO,2019-12-13,83,@,CHI,W 83-73,240,30,79,.380,24,48,.500,6,31,.194,17,21,.810,83,27,90,.300,20,56,.357,7,34,.206,12,14,.857,73
2101,ORL,2019-11-29,83,,TOR,L 83-90,240,27,78,.346,20,49,.408,7,29,.241,22,27,.815,83,31,84,.369,20,46,.435,11,38,.289,17,28,.607,90
2102,IND,2019-11-16,83,,MIL,L 83-102,240,32,100,.320,20,66,.303,12,34,.353,7,9,.778,83,43,96,.448,32,57,.561,11,39,.282,5,7,.714,102
2103,NYK,2019-10-30,83,@,ORL,L 83-95,240,31,82,.378,24,51,.471,7,31,.226,14,20,.700,83,37,88,.420,25,56,.446,12,32,.375,9,12,.750,95
2104,DET,2020-02-03,82,@,MEM,L 82-96,240,34,98,.347,26,72,.361,8,26,.308,6,9,.667,82,42,90,.467,40,73,.548,2,17,.118,10,12,.833,96
2105,BRK,2019-12-26,82,,NYK,L 82-94,240,21,78,.269,8,28,.286,13,50,.260,27,36,.750,82,37,92,.402,28,63,.444,9,29,.310,11,15,.733,94
2106,IND,2020-02-23,81,@,TOR,L 81-127,240,31,95,.326,23,62,.371,8,33,.242,11,17,.647,81,47,92,.511,30,48,.625,17,44,.386,16,18,.889,127
2107,CHI,2020-01-24,81,,SAC,L 81-98,240,31,79,.392,23,42,.548,8,37,.216,11,14,.786,81,35,81,.432,25,49,.510,10,32,.313,18,21,.857,98
2108,DET,2019-12-30,81,@,UTA,L 81-104,240,30,79,.380,26,65,.400,4,14,.286,17,23,.739,81,39,83,.470,29,57,.509,10,26,.385,16,20,.800,104
2109,ATL,2019-12-28,81,@,CHI,L 81-116,240,32,86,.372,23,52,.442,9,34,.265,8,11,.727,81,43,87,.494,28,56,.500,15,31,.484,15,19,.789,116
2110,SAC,2019-10-26,81,@,UTA,L 81-113,240,30,81,.370,23,55,.418,7,26,.269,14,17,.824,81,44,78,.564,26,41,.634,18,37,.486,7,12,.583,113
2111,CHO,2020-02-25,80,@,IND,L 80-119,240,31,93,.333,21,60,.350,10,33,.303,8,18,.444,80,49,86,.570,39,63,.619,10,23,.435,11,13,.846,119
2112,MIA,2019-11-08,80,@,LAL,L 80-95,240,28,80,.350,22,45,.489,6,35,.171,18,24,.750,80,40,89,.449,32,57,.561,8,32,.250,7,8,.875,95
2113,BRK,2020-03-04,79,,MEM,L 79-118,240,30,90,.333,23,48,.479,7,42,.167,12,17,.706,79,43,100,.430,23,56,.411,20,44,.455,12,14,.857,118
2114,GSW,2019-12-15,79,,SAC,L 79-100,240,30,76,.395,24,51,.471,6,25,.240,13,18,.722,79,38,63,.603,28,41,.683,10,22,.455,14,16,.875,100
2115,GSW,2019-12-02,79,@,ATL,L 79-104,240,33,83,.398,30,66,.455,3,17,.176,10,12,.833,79,41,89,.461,33,60,.550,8,29,.276,14,15,.933,104
2116,DET,2020-02-10,76,,CHO,L 76-87,240,29,82,.354,22,47,.468,7,35,.200,11,13,.846,76,33,88,.375,24,52,.462,9,36,.250,12,14,.857,87
2117,TOR,2020-01-02,76,@,MIA,L 76-84,240,28,89,.315,22,47,.468,6,42,.143,14,17,.824,76,33,81,.407,21,44,.477,12,37,.324,6,11,.545,84
2118,CHI,2019-12-13,73,,CHO,L 73-83,240,27,90,.300,20,56,.357,7,34,.206,12,14,.857,73,30,79,.380,24,48,.500,6,31,.194,17,21,.810,83
1,CHO,2022-01-26,158,@,IND,W 158-126,240,54,93,.581,30,48,.625,24,45,.533,26,33,.788,158,44,92,.478,34,58,.586,10,34,.294,28,34,.824,126
2,SAS,2022-02-25,157,@,WAS,W 157-153 (2OT),290,57,105,.543,48,76,.632,9,29,.310,34,43,.791,157,59,108,.546,43,70,.614,16,38,.421,19,24,.792,153
3,LAC,2022-04-01,153,@,MIL,W 153-119,240,56,92,.609,33,49,.673,23,43,.535,18,24,.750,153,50,94,.532,42,69,.609,8,25,.320,11,18,.611,119
4,WAS,2022-02-25,153,,SAS,L 153-157 (2OT),290,59,108,.546,43,70,.614,16,38,.421,19,24,.792,153,57,105,.543,48,76,.632,9,29,.310,34,43,.791,157
5,MEM,2021-12-02,152,,OKC,W 152-79,240,60,96,.625,41,60,.683,19,36,.528,13,18,.722,152,25,76,.329,14,38,.368,11,38,.289,18,22,.818,79
6,BRK,2022-03-15,150,@,ORL,W 150-108,240,53,88,.602,37,61,.607,16,27,.593,28,34,.824,150,36,95,.379,21,54,.389,15,41,.366,21,27,.778,108
7,MIN,2022-03-14,149,@,SAS,W 149-139,240,52,90,.578,35,57,.614,17,33,.515,28,32,.875,149,52,97,.536,39,62,.629,13,35,.371,22,26,.846,139
8,LAL,2022-04-10,146,@,DEN,W 146-141 (OT),265,44,94,.468,28,51,.549,16,43,.372,42,47,.894,146,49,100,.490,34,53,.642,15,47,.319,28,36,.778,141
9,HOU,2021-11-27,146,,CHO,W 146-143 (OT),265,51,95,.537,28,46,.609,23,49,.469,21,31,.677,146,48,103,.466,28,53,.528,20,50,.400,27,30,.900,143
10,BOS,2021-12-04,145,@,POR,W 145-117,240,49,87,.563,28,50,.560,21,37,.568,26,29,.897,145,42,89,.472,34,60,.567,8,29,.276,25,32,.781,117
11,MIA,2022-04-05,144,,CHO,W 144-115,240,48,84,.571,25,42,.595,23,42,.548,25,29,.862,144,45,85,.529,33,47,.702,12,38,.316,13,18,.722,115
12,BOS,2022-04-03,144,,WAS,W 144-102,240,56,91,.615,33,47,.702,23,44,.523,9,13,.692,144,38,82,.463,30,61,.492,8,21,.381,18,20,.900,102
13,PHI,2022-04-02,144,,CHO,W 144-114,240,53,87,.609,32,44,.727,21,43,.488,17,21,.810,144,42,87,.483,31,57,.544,11,30,.367,19,24,.792,114
14,SAS,2021-12-26,144,,DET,W 144-109,240,51,91,.560,38,64,.594,13,27,.481,29,37,.784,144,38,98,.388,30,66,.455,8,32,.250,25,34,.735,109
15,CLE,2021-12-26,144,,TOR,W 144-99,240,56,106,.528,34,54,.630,22,52,.423,10,12,.833,144,37,89,.416,28,53,.528,9,36,.250,16,23,.696,99
16,CHO,2021-11-27,143,@,HOU,L 143-146 (OT),265,48,103,.466,28,53,.528,20,50,.400,27,30,.900,143,51,95,.537,28,46,.609,23,49,.469,21,31,.677,146
17,CHO,2022-03-11,142,@,NOP,W 142-120,240,52,87,.598,30,40,.750,22,47,.468,16,20,.800,142,43,86,.500,28,47,.596,15,39,.385,19,25,.760,120
18,MIL,2022-03-08,142,@,OKC,W 142-115,240,53,100,.530,33,60,.550,20,40,.500,16,20,.800,142,42,84,.500,26,45,.578,16,39,.410,15,21,.714,115
19,LAC,2022-02-17,142,,HOU,W 142-111,240,51,92,.554,33,57,.579,18,35,.514,22,26,.846,142,42,91,.462,29,54,.537,13,37,.351,14,19,.737,111
20,SAC,2021-12-08,142,,ORL,W 142-130,240,53,97,.546,38,63,.603,15,34,.441,21,25,.840,142,48,97,.495,32,63,.508,16,34,.471,18,23,.783,130
21,DEN,2022-04-10,141,,LAL,L 141-146 (OT),265,49,100,.490,34,53,.642,15,47,.319,28,36,.778,141,44,94,.468,28,51,.549,16,43,.372,42,47,.894,146
22,MEM,2022-04-09,141,,NOP,W 141-114,240,53,90,.589,35,55,.636,18,35,.514,17,23,.739,141,41,91,.451,35,61,.574,6,30,.200,26,35,.743,114
23,CHO,2022-02-11,141,@,DET,W 141-119,240,54,97,.557,36,55,.655,18,42,.429,15,23,.652,141,48,102,.471,36,67,.537,12,35,.343,11,18,.611,119
24,MIN,2022-01-09,141,@,HOU,W 141-123,240,55,108,.509,40,66,.606,15,42,.357,16,21,.762,141,46,97,.474,32,54,.593,14,43,.326,17,28,.607,123
25,SAC,2021-11-26,141,@,LAL,W 141-137 (3OT),315,54,120,.450,40,75,.533,14,45,.311,19,29,.655,141,51,102,.500,36,58,.621,15,44,.341,20,28,.714,137
26,PHO,2022-03-24,140,@,DEN,W 140-130,240,52,86,.605,39,59,.661,13,27,.481,23,29,.793,140,48,81,.593,33,49,.673,15,32,.469,19,27,.704,130
27,PHO,2022-03-13,140,,LAL,W 140-111,240,58,102,.569,46,69,.667,12,33,.364,12,14,.857,140,36,81,.444,20,41,.488,16,40,.400,23,31,.742,111
28,DEN,2022-01-13,140,,POR,W 140-108,240,52,83,.627,31,41,.756,21,42,.500,15,20,.750,140,39,86,.453,26,46,.565,13,40,.325,17,28,.607,108
29,CHO,2022-01-05,140,,DET,W 140-111,240,48,81,.593,24,39,.615,24,42,.571,20,29,.690,140,43,92,.467,29,50,.580,14,42,.333,11,20,.550,111
30,SAC,2021-11-05,140,,CHO,W 140-110,240,48,87,.552,26,43,.605,22,44,.500,22,26,.846,140,43,92,.467,32,57,.561,11,35,.314,13,21,.619,110
31,BOS,2021-10-25,140,@,CHO,W 140-129 (OT),265,50,101,.495,31,51,.608,19,50,.380,21,25,.840,140,46,103,.447,27,59,.458,19,44,.432,18,28,.643,129
32,BOS,2022-04-10,139,@,MEM,W 139-110,240,54,99,.545,36,51,.706,18,48,.375,13,13,1.000,139,39,102,.382,24,55,.436,15,47,.319,17,27,.630,110
33,MIN,2022-04-03,139,@,HOU,W 139-132,240,51,86,.593,34,45,.756,17,41,.415,20,25,.800,139,48,85,.565,32,45,.711,16,40,.400,20,29,.690,132
34,SAS,2022-03-14,139,,MIN,L 139-149,240,52,97,.536,39,62,.629,13,35,.371,22,26,.846,139,52,90,.578,35,57,.614,17,33,.515,28,32,.875,149
35,HOU,2022-03-09,139,,LAL,W 139-130 (OT),265,52,102,.510,35,62,.565,17,40,.425,18,19,.947,139,47,101,.465,29,54,.537,18,47,.383,18,26,.692,130
36,TOR,2022-02-10,139,@,HOU,W 139-120,240,53,97,.546,38,58,.655,15,39,.385,18,22,.818,139,43,82,.524,27,44,.614,16,38,.421,18,30,.600,120
37,LAC,2022-01-17,139,,IND,W 139-133,240,45,82,.549,27,46,.587,18,36,.500,31,36,.861,139,50,97,.515,37,64,.578,13,33,.394,20,23,.870,133
38,LAL,2021-12-31,139,,POR,W 139-106,240,47,85,.553,28,44,.636,19,41,.463,26,30,.867,139,36,102,.353,24,60,.400,12,42,.286,22,27,.815,106
39,DAL,2021-12-01,139,@,NOP,W 139-107,240,57,83,.687,39,49,.796,18,34,.529,7,9,.778,139,40,89,.449,27,52,.519,13,37,.351,14,16,.875,107
40,LAC,2022-04-10,138,,OKC,W 138-88,240,54,97,.557,36,62,.581,18,35,.514,12,14,.857,138,37,98,.378,28,64,.438,9,34,.265,5,9,.556,88
41,MIN,2022-03-19,138,,MIL,W 138-119,240,47,92,.511,25,45,.556,22,47,.468,22,26,.846,138,43,97,.443,24,45,.533,19,52,.365,14,17,.824,119
42,DEN,2022-03-06,138,,NOP,W 138-130 (OT),265,47,87,.540,37,54,.685,10,33,.303,34,43,.791,138,48,101,.475,34,68,.500,14,33,.424,20,29,.690,130
43,MIN,2022-03-04,138,@,OKC,W 138-101,240,49,91,.538,27,44,.614,22,47,.468,18,23,.783,138,37,86,.430,28,51,.549,9,35,.257,18,21,.857,101
44,GSW,2022-01-14,138,@,CHI,W 138-96,240,53,94,.564,34,52,.654,19,42,.452,13,17,.765,138,37,87,.425,27,49,.551,10,38,.263,12,18,.667,96
45,BRK,2022-01-12,138,@,CHI,W 138-112,240,49,87,.563,32,55,.582,17,32,.531,23,28,.821,138,38,81,.469,27,51,.529,11,30,.367,25,31,.806,112
46,SAS,2021-12-23,138,@,LAL,W 138-110,240,46,95,.484,28,56,.500,18,39,.462,28,33,.848,138,44,94,.468,39,67,.582,5,27,.185,17,30,.567,110
47,MIN,2021-11-20,138,,MEM,W 138-95,240,49,91,.538,29,50,.580,20,41,.488,20,28,.714,138,29,83,.349,20,51,.392,9,32,.281,28,35,.800,95
48,NYK,2021-10-20,138,,BOS,W 138-134 (2OT),290,51,105,.486,34,60,.567,17,45,.378,19,27,.704,138,48,117,.410,27,60,.450,21,57,.368,17,23,.739,134
49,UTA,2022-04-06,137,,OKC,W 137-101,240,49,84,.583,34,48,.708,15,36,.417,24,32,.750,137,37,90,.411,21,53,.396,16,37,.432,11,17,.647,101
50,MIL,2022-02-06,137,@,LAC,W 137-113,240,48,88,.545,29,50,.580,19,38,.500,22,27,.815,137,40,96,.417,22,50,.440,18,46,.391,15,16,.938,113
51,MIL,2022-02-05,137,@,POR,W 137-108,240,49,92,.533,26,42,.619,23,50,.460,16,22,.727,137,41,85,.482,27,40,.675,14,45,.311,12,21,.571,108
52,PHO,2021-12-19,137,,CHO,W 137-106,240,54,95,.568,34,54,.630,20,41,.488,9,13,.692,137,36,100,.360,26,55,.473,10,45,.222,24,28,.857,106
53,UTA,2021-12-03,137,,BOS,W 137-130,240,45,81,.556,18,30,.600,27,51,.529,20,23,.870,137,47,91,.516,33,52,.635,14,39,.359,22,22,1.000,130
54,LAL,2021-11-26,137,,SAC,L 137-141 (3OT),315,51,102,.500,36,58,.621,15,44,.341,20,28,.714,137,54,120,.450,40,75,.533,14,45,.311,19,29,.655,141
55,MIA,2021-10-21,137,,MIL,W 137-95,240,51,96,.531,36,61,.590,15,35,.429,20,31,.645,137,32,84,.381,20,42,.476,12,42,.286,19,29,.655,95
56,MIN,2022-04-01,136,@,DEN,W 136-130,240,43,86,.500,24,46,.522,19,40,.475,31,36,.861,136,46,86,.535,34,51,.667,12,35,.343,26,29,.897,130
57,ATL,2022-03-30,136,@,OKC,W 136-118,240,49,91,.538,31,52,.596,18,39,.462,20,22,.909,136,41,87,.471,24,46,.522,17,41,.415,19,27,.704,118
58,SAS,2022-02-11,136,@,ATL,W 136-121,240,50,90,.556,32,58,.552,18,32,.563,18,21,.857,136,47,103,.456,33,60,.550,14,43,.326,13,15,.867,121
59,DEN,2022-01-30,136,@,MIL,W 136-100,240,53,88,.602,30,45,.667,23,43,.535,7,10,.700,136,37,78,.474,27,48,.563,10,30,.333,16,22,.727,100
60,MIN,2022-01-23,136,,BRK,W 136-125,240,48,92,.522,34,60,.567,14,32,.438,26,31,.839,136,48,95,.505,33,57,.579,15,38,.395,14,15,.933,125
61,POR,2022-01-03,136,,ATL,W 136-131,240,47,89,.528,29,48,.604,18,41,.439,24,28,.857,136,48,88,.545,34,47,.723,14,41,.341,21,24,.875,131
62,MIL,2022-01-01,136,,NOP,W 136-113,240,49,92,.533,26,44,.591,23,48,.479,15,18,.833,136,39,95,.411,23,44,.523,16,51,.314,19,30,.633,113
63,MIL,2021-12-30,136,@,ORL,W 136-118,240,45,91,.495,32,58,.552,13,33,.394,33,36,.917,136,42,87,.483,29,51,.569,13,36,.361,21,27,.778,118
64,UTA,2021-12-08,136,@,MIN,W 136-104,240,50,88,.568,25,34,.735,25,54,.463,11,15,.733,136,38,95,.400,21,48,.438,17,47,.362,11,17,.647,104
65,MEM,2021-11-15,136,,HOU,W 136-102,240,52,96,.542,36,55,.655,16,41,.390,16,20,.800,136,36,95,.379,25,57,.439,11,38,.289,19,26,.731,102
66,SAS,2021-11-10,136,,SAC,W 136-117,240,49,92,.533,31,60,.517,18,32,.563,20,31,.645,136,47,91,.516,37,55,.673,10,36,.278,13,16,.813,117
67,WAS,2022-04-01,135,,DAL,W 135-103,240,49,90,.544,32,57,.561,17,33,.515,20,22,.909,135,34,78,.436,23,40,.575,11,38,.289,24,26,.923,103
68,CHI,2022-03-31,135,,LAC,W 135-130 (OT),265,50,102,.490,40,73,.548,10,29,.345,25,32,.781,135,45,90,.500,29,54,.537,16,36,.444,24,26,.923,130
69,MIL,2022-03-16,135,@,SAC,W 135-126,240,47,89,.528,29,54,.537,18,35,.514,23,32,.719,135,46,94,.489,30,51,.588,16,43,.372,18,21,.857,126
70,MEM,2022-03-15,135,@,IND,W 135-102,240,54,105,.514,39,65,.600,15,40,.375,12,20,.600,135,41,98,.418,35,68,.515,6,30,.200,14,19,.737,102
71,MIN,2022-03-05,135,,POR,W 135-121,240,48,85,.565,33,48,.688,15,37,.405,24,29,.828,135,40,85,.471,24,47,.511,16,38,.421,25,30,.833,121
72,BOS,2022-02-15,135,@,PHI,W 135-87,240,46,82,.561,21,37,.568,25,45,.556,18,22,.818,135,23,80,.288,15,48,.313,8,32,.250,33,39,.846,87
73,UTA,2022-02-14,135,,HOU,W 135-101,240,49,89,.551,31,49,.633,18,40,.450,19,22,.864,135,35,83,.422,23,46,.500,12,37,.324,19,28,.679,101
74,MEM,2022-02-08,135,,LAC,W 135-109,240,53,103,.515,44,77,.571,9,26,.346,20,25,.800,135,40,89,.449,29,58,.500,11,31,.355,18,24,.750,109
75,MEM,2022-02-05,135,@,ORL,W 135-115,240,53,105,.505,40,66,.606,13,39,.333,16,22,.727,135,39,90,.433,22,42,.524,17,48,.354,20,29,.690,115
76,PHO,2022-01-16,135,@,DET,W 135-108,240,51,87,.586,40,60,.667,11,27,.407,22,30,.733,135,38,82,.463,29,57,.509,9,25,.360,23,34,.676,108
77,MIN,2022-01-07,135,@,OKC,W 135-105,240,50,90,.556,33,49,.673,17,41,.415,18,25,.720,135,36,89,.404,21,45,.467,15,44,.341,18,23,.783,105
78,WAS,2021-10-22,135,,IND,W 135-134 (OT),265,49,94,.521,30,56,.536,19,38,.500,18,19,.947,135,52,97,.536,37,63,.587,15,34,.441,15,20,.750,134
79,BRK,2022-04-10,134,,IND,W 134-126,240,52,81,.642,44,59,.746,8,22,.364,22,25,.880,134,47,104,.452,28,58,.483,19,46,.413,13,19,.684,126
80,OKC,2022-03-28,134,@,POR,W 134-131 (OT),265,48,90,.533,28,45,.622,20,45,.444,18,25,.720,134,51,112,.455,31,62,.500,20,50,.400,9,13,.692,131
81,BOS,2022-03-27,134,,MIN,W 134-112,240,49,87,.563,32,48,.667,17,39,.436,19,21,.905,134,45,84,.536,31,52,.596,14,32,.438,8,12,.667,112
82,DET,2022-03-17,134,@,ORL,W 134-120,240,47,94,.500,27,51,.529,20,43,.465,20,31,.645,134,47,97,.485,36,67,.537,11,30,.367,15,21,.714,120
83,CHO,2022-03-14,134,@,OKC,W 134-116,240,49,91,.538,29,56,.518,20,35,.571,16,21,.762,134,42,90,.467,26,46,.565,16,44,.364,16,19,.842,116
84,UTA,2022-03-12,134,,SAC,W 134-125,240,48,86,.558,32,45,.711,16,41,.390,22,31,.710,134,47,94,.500,34,61,.557,13,33,.394,18,21,.857,125
85,CHI,2022-02-11,134,,MIN,W 134-122,240,55,87,.632,41,56,.732,14,31,.452,10,13,.769,134,48,96,.500,35,56,.625,13,40,.325,13,16,.813,122
86,MIN,2022-02-08,134,@,SAC,W 134-114,240,50,104,.481,28,60,.467,22,44,.500,12,17,.706,134,41,83,.494,32,58,.552,9,25,.360,23,26,.885,114
87,PHO,2022-01-28,134,,MIN,W 134-124,240,43,84,.512,23,45,.511,20,39,.513,28,37,.757,134,44,90,.489,30,51,.588,14,39,.359,22,27,.815,124
88,SAS,2022-01-25,134,@,HOU,W 134-104,240,58,101,.574,46,69,.667,12,32,.375,6,6,1.000,134,39,95,.411,30,61,.492,9,34,.265,17,25,.680,104
89,ATL,2022-01-19,134,,MIN,W 134-122,240,45,86,.523,30,48,.625,15,38,.395,29,33,.879,134,42,97,.433,25,51,.490,17,46,.370,21,29,.724,122
90,LAL,2022-01-07,134,,ATL,W 134-118,240,50,101,.495,33,60,.550,17,41,.415,17,19,.895,134,43,96,.448,30,60,.500,13,36,.361,19,27,.704,118
91,POR,2021-10-23,134,,PHO,W 134-105,240,51,94,.543,30,44,.682,21,50,.420,11,17,.647,134,43,89,.483,34,61,.557,9,28,.321,10,15,.667,105
92,IND,2021-10-22,134,@,WAS,L 134-135 (OT),265,52,97,.536,37,63,.587,15,34,.441,15,20,.750,134,49,94,.521,30,56,.536,19,38,.500,18,19,.947,135
93,BOS,2021-10-20,134,@,NYK,L 134-138 (2OT),290,48,117,.410,27,60,.450,21,57,.368,17,23,.739,134,51,105,.486,34,60,.567,17,45,.378,19,27,.704,138
94,CLE,2022-04-10,133,,MIL,W 133-115,240,51,94,.543,32,56,.571,19,38,.500,12,17,.706,133,39,88,.443,27,58,.466,12,30,.400,25,32,.781,115
95,PHI,2022-04-09,133,,IND,W 133-120,240,50,90,.556,38,56,.679,12,34,.353,21,27,.778,133,41,78,.526,31,55,.564,10,23,.435,28,36,.778,120
96,CHO,2022-04-08,133,@,CHI,W 133-117,240,52,86,.605,33,46,.717,19,40,.475,10,10,1.000,133,44,82,.537,31,58,.534,13,24,.542,16,20,.800,117
97,MEM,2022-03-24,133,,IND,W 133-103,240,50,93,.538,29,51,.569,21,42,.500,12,17,.706,133,39,92,.424,30,59,.508,9,33,.273,16,23,.696,103
98,SAS,2022-03-23,133,@,POR,W 133-96,240,46,94,.489,27,50,.540,19,44,.432,22,24,.917,133,36,94,.383,29,68,.426,7,26,.269,17,18,.944,96
99,WAS,2022-03-06,133,,IND,W 133-123,240,45,86,.523,28,44,.636,17,42,.405,26,32,.813,133,44,85,.518,34,54,.630,10,31,.323,25,29,.862,123
100,TOR,2022-02-28,133,@,BRK,W 133-97,240,51,99,.515,33,61,.541,18,38,.474,13,22,.591,133,33,86,.384,21,51,.412,12,35,.343,19,24,.792,97
101,MIA,2022-02-26,133,,SAS,W 133-129,240,47,83,.566,35,55,.636,12,28,.429,27,38,.711,133,50,90,.556,36,59,.610,14,31,.452,15,19,.789,129
102,PHI,2022-02-25,133,@,MIN,W 133-102,240,42,82,.512,23,43,.535,19,39,.487,30,36,.833,133,36,86,.419,27,47,.574,9,39,.231,21,25,.840,102
103,ATL,2022-02-08,133,,IND,W 133-112,240,52,90,.578,35,57,.614,17,33,.515,12,16,.750,133,37,93,.398,27,62,.435,10,31,.323,28,33,.848,112
104,MIL,2022-01-22,133,,SAC,W 133-127,240,45,91,.495,24,49,.490,21,42,.500,22,25,.880,133,51,97,.526,36,60,.600,15,37,.405,10,16,.625,127
105,DET,2022-01-19,133,@,SAC,W 133-131,240,46,91,.505,31,55,.564,15,36,.417,26,30,.867,133,44,84,.524,32,57,.561,12,27,.444,31,44,.705,131
106,IND,2022-01-17,133,@,LAC,L 133-139,240,50,97,.515,37,64,.578,13,33,.394,20,23,.870,133,45,82,.549,27,46,.587,18,36,.500,31,36,.861,139
107,DEN,2022-01-15,133,,LAL,W 133-96,240,47,91,.516,24,51,.471,23,40,.575,16,17,.941,133,36,82,.439,26,52,.500,10,30,.333,14,19,.737,96
108,CHI,2022-01-11,133,,DET,W 133-87,240,50,92,.543,32,58,.552,18,34,.529,15,19,.789,133,30,89,.337,24,54,.444,6,35,.171,21,27,.778,87
109,PHI,2022-01-03,133,,HOU,W 133-113,240,50,96,.521,33,56,.589,17,40,.425,16,17,.941,133,37,89,.416,22,45,.489,15,44,.341,24,33,.727,113
110,PHO,2022-01-02,133,@,CHO,W 133-99,240,52,103,.505,35,62,.565,17,41,.415,12,12,1.000,133,39,85,.459,30,50,.600,9,35,.257,12,21,.571,99
111,CHI,2021-12-20,133,,HOU,W 133-118,240,47,88,.534,31,53,.585,16,35,.457,23,24,.958,133,44,78,.564,32,45,.711,12,33,.364,18,24,.750,118
112,DEN,2021-12-17,133,@,ATL,W 133-115,240,50,86,.581,33,48,.688,17,38,.447,16,18,.889,133,41,88,.466,34,64,.531,7,24,.292,26,34,.765,115
113,CHI,2021-11-29,133,,CHO,W 133-119,240,53,89,.596,39,59,.661,14,30,.467,13,19,.684,133,42,88,.477,24,49,.490,18,39,.462,17,21,.810,119
114,CHO,2021-11-26,133,,MIN,W 133-115,240,49,88,.557,26,48,.542,23,40,.575,12,15,.800,133,45,100,.450,34,65,.523,11,35,.314,14,19,.737,115
115,WAS,2022-04-05,132,@,MIN,W 132-114,240,56,101,.554,43,71,.606,13,30,.433,7,14,.500,132,41,91,.451,27,50,.540,14,41,.341,18,25,.720,114
116,HOU,2022-04-03,132,,MIN,L 132-139,240,48,85,.565,32,45,.711,16,40,.400,20,29,.690,132,51,86,.593,34,45,.756,17,41,.415,20,25,.800,139
117,ATL,2022-03-28,132,@,IND,W 132-123,240,47,86,.547,30,51,.588,17,35,.486,21,26,.808,132,45,87,.517,28,51,.549,17,36,.472,16,18,.889,123
118,MEM,2022-03-23,132,,BRK,W 132-120,240,47,101,.465,28,63,.444,19,38,.500,19,22,.864,132,43,87,.494,34,62,.548,9,25,.360,25,27,.926,120
119,BOS,2022-03-21,132,@,OKC,W 132-123,240,44,86,.512,29,46,.630,15,40,.375,29,34,.853,132,48,93,.516,31,56,.554,17,37,.459,10,14,.714,123
120,MIN,2022-03-09,132,,OKC,W 132-102,240,45,86,.523,23,34,.676,22,52,.423,20,26,.769,132,36,87,.414,22,44,.500,14,43,.326,16,24,.667,102
121,BRK,2022-03-08,132,@,CHO,W 132-121,240,46,82,.561,28,47,.596,18,35,.514,22,29,.759,132,45,92,.489,32,51,.627,13,41,.317,18,22,.818,121
122,MEM,2022-03-08,132,,NOP,W 132-111,240,48,101,.475,32,57,.561,16,44,.364,20,24,.833,132,41,88,.466,30,54,.556,11,34,.324,18,27,.667,111
123,MIL,2022-03-06,132,,PHO,W 132-122,240,47,87,.540,32,55,.582,15,32,.469,23,29,.793,132,50,93,.538,36,62,.581,14,31,.452,8,11,.727,122
124,LAC,2022-03-03,132,,LAL,W 132-111,240,51,93,.548,34,66,.515,17,27,.630,13,15,.867,132,41,84,.488,29,49,.592,12,35,.343,17,22,.773,111
125,UTA,2022-03-02,132,@,HOU,W 132-127 (OT),265,50,91,.549,35,49,.714,15,42,.357,17,24,.708,132,43,86,.500,22,35,.629,21,51,.412,20,30,.667,127
126,GSW,2022-02-24,132,@,POR,W 132-95,240,45,88,.511,30,47,.638,15,41,.366,27,32,.844,132,31,79,.392,22,44,.500,9,35,.257,24,29,.828,95
127,PHO,2022-02-12,132,,ORL,W 132-105,240,55,105,.524,40,71,.563,15,34,.441,7,10,.700,132,37,87,.425,22,46,.478,15,41,.366,16,24,.667,105
128,MEM,2022-02-10,132,@,DET,W 132-107,240,44,92,.478,29,62,.468,15,30,.500,29,42,.690,132,41,94,.436,34,59,.576,7,35,.200,18,21,.857,107
129,SAC,2022-02-09,132,,MIN,W 132-119,240,48,93,.516,36,63,.571,12,30,.400,24,27,.889,132,44,98,.449,28,52,.538,16,46,.348,15,18,.833,119
130,DEN,2022-02-08,132,,NYK,W 132-115,240,46,85,.541,30,46,.652,16,39,.410,24,31,.774,132,45,101,.446,30,58,.517,15,43,.349,10,12,.833,115
131,DAL,2022-01-29,132,,IND,W 132-105,240,51,96,.531,35,62,.565,16,34,.471,14,22,.636,132,40,91,.440,31,58,.534,9,33,.273,16,23,.696,105
132,DAL,2022-01-26,132,@,POR,W 132-112,240,48,88,.545,32,52,.615,16,36,.444,20,26,.769,132,42,82,.512,28,44,.636,14,38,.368,14,23,.609,112
133,LAL,2021-12-28,132,@,HOU,W 132-123,240,48,92,.522,34,58,.586,14,34,.412,22,29,.759,132,44,83,.530,28,48,.583,16,35,.457,19,25,.760,123
134,DAL,2021-12-27,132,@,POR,W 132-117,240,48,84,.571,36,51,.706,12,33,.364,24,33,.727,132,35,82,.427,23,42,.548,12,40,.300,35,42,.833,117
135,HOU,2021-12-13,132,@,ATL,W 132-126,240,46,96,.479,27,50,.540,19,46,.413,21,27,.778,132,42,85,.494,27,46,.587,15,39,.385,27,31,.871,126
136,ATL,2021-11-26,132,@,MEM,W 132-100,240,52,89,.584,39,62,.629,13,27,.481,15,21,.714,132,37,91,.407,25,53,.472,12,38,.316,14,19,.737,100
137,MEM,2021-10-20,132,,CLE,W 132-121,240,53,100,.530,39,67,.582,14,33,.424,12,12,1.000,132,47,93,.505,33,55,.600,14,38,.368,13,18,.722,121
138,MIL,2022-04-08,131,@,DET,W 131-101,240,50,101,.495,39,64,.609,11,37,.297,20,23,.870,131,35,90,.389,25,42,.595,10,48,.208,21,23,.913,101
139,DAL,2022-04-06,131,@,DET,W 131-113,240,45,80,.563,30,47,.638,15,33,.455,26,34,.765,131,35,82,.427,24,52,.462,11,30,.367,32,35,.914,113
140,PHI,2022-04-05,131,@,IND,W 131-122,240,47,87,.540,24,47,.511,23,40,.575,14,18,.778,131,45,95,.474,33,55,.600,12,40,.300,20,21,.952,122
141,ATL,2022-03-31,131,,CLE,W 131-107,240,45,91,.495,28,52,.538,17,39,.436,24,28,.857,131,39,90,.433,32,60,.533,7,30,.233,22,28,.786,107
142,POR,2022-03-28,131,,OKC,L 131-134 (OT),265,51,112,.455,31,62,.500,20,50,.400,9,13,.692,131,48,90,.533,28,45,.622,20,45,.444,18,25,.720,134
143,TOR,2022-03-26,131,,IND,W 131-91,240,51,84,.607,36,52,.692,15,32,.469,14,19,.737,131,33,79,.418,22,43,.512,11,36,.306,14,20,.700,91
144,LAL,2022-03-21,131,@,CLE,W 131-120,240,53,94,.564,41,62,.661,12,32,.375,13,16,.813,131,45,86,.523,31,47,.660,14,39,.359,16,19,.842,120
145,PHO,2022-03-15,131,@,NOP,W 131-115,240,49,90,.544,31,56,.554,18,34,.529,15,15,1.000,131,43,86,.500,31,52,.596,12,34,.353,17,24,.708,115
146,ATL,2022-03-13,131,,IND,W 131-128,240,46,84,.548,29,46,.630,17,38,.447,22,24,.917,131,46,89,.517,31,54,.574,15,35,.429,21,26,.808,128
147,NYK,2022-03-07,131,@,SAC,W 131-115,240,47,92,.511,29,50,.580,18,42,.429,19,23,.826,131,39,80,.488,28,48,.583,11,32,.344,26,36,.722,115
148,DEN,2022-03-07,131,,GSW,W 131-124,240,46,84,.548,36,52,.692,10,32,.313,29,41,.707,131,45,88,.511,28,48,.583,17,40,.425,17,23,.739,124
149,SAC,2022-02-28,131,@,OKC,W 131-110,240,49,87,.563,39,56,.696,10,31,.323,23,30,.767,131,40,86,.465,29,51,.569,11,35,.314,19,27,.704,110
150,PHO,2022-02-10,131,,MIL,W 131-107,240,51,90,.567,42,60,.700,9,30,.300,20,29,.690,131,40,88,.455,30,50,.600,10,38,.263,17,25,.680,107
151,MIL,2022-02-08,131,@,LAL,W 131-116,240,52,96,.542,37,60,.617,15,36,.417,12,20,.600,131,44,85,.518,34,53,.642,10,32,.313,18,30,.600,116
152,SAS,2022-02-04,131,,HOU,W 131-106,240,51,89,.573,38,61,.623,13,28,.464,16,20,.800,131,36,83,.434,25,50,.500,11,33,.333,23,29,.793,106
153,SAS,2022-01-28,131,,CHI,W 131-122,240,50,95,.526,34,58,.586,16,37,.432,15,18,.833,131,46,88,.523,38,58,.655,8,30,.267,22,26,.846,122
154,SAC,2022-01-19,131,,DET,L 131-133,240,44,84,.524,32,57,.561,12,27,.444,31,44,.705,131,46,91,.505,31,55,.564,15,36,.417,26,30,.867,133
155,ATL,2022-01-03,131,@,POR,L 131-136,240,48,88,.545,34,47,.723,14,41,.341,21,24,.875,131,47,89,.528,29,48,.604,18,41,.439,24,28,.857,136
156,CHI,2021-12-29,131,,ATL,W 131-117,240,52,84,.619,42,62,.677,10,22,.455,17,22,.773,131,44,92,.478,33,66,.500,11,26,.423,18,26,.692,117
157,CHO,2021-12-15,131,@,SAS,W 131-115,240,51,86,.593,33,52,.635,18,34,.529,11,16,.688,131,39,90,.433,27,53,.509,12,37,.324,25,25,1.000,115
158,BRK,2021-12-14,131,,TOR,W 131-129 (OT),265,50,103,.485,36,64,.563,14,39,.359,17,23,.739,131,48,105,.457,30,53,.566,18,52,.346,15,19,.789,129
159,IND,2021-11-01,131,,SAS,W 131-118,240,52,91,.571,34,53,.642,18,38,.474,9,12,.750,131,47,89,.528,33,61,.541,14,28,.500,10,14,.714,118
160,DAL,2022-04-10,130,,SAS,W 130-120,240,46,85,.541,26,49,.531,20,36,.556,18,23,.783,130,43,89,.483,32,58,.552,11,31,.355,23,23,1.000,120
161,ATL,2022-04-10,130,@,HOU,W 130-114,240,45,87,.517,24,49,.490,21,38,.553,19,24,.792,130,41,89,.461,24,43,.558,17,46,.370,15,20,.750,114
162,DEN,2022-04-01,130,,MIN,L 130-136,240,46,86,.535,34,51,.667,12,35,.343,26,29,.897,130,43,86,.500,24,46,.522,19,40,.475,31,36,.861,136
163,SAS,2022-04-01,130,,POR,W 130-111,240,46,81,.568,30,44,.682,16,37,.432,22,28,.786,130,41,92,.446,26,57,.456,15,35,.429,14,20,.700,111
164,LAC,2022-03-31,130,@,CHI,L 130-135 (OT),265,45,90,.500,29,54,.537,16,36,.444,24,26,.923,130,50,102,.490,40,73,.548,10,29,.345,25,32,.781,135
165,BRK,2022-03-29,130,,DET,W 130-123,240,42,76,.553,27,48,.563,15,28,.536,31,34,.912,130,48,99,.485,32,61,.525,16,38,.421,11,13,.846,123
166,DEN,2022-03-24,130,,PHO,L 130-140,240,48,81,.593,33,49,.673,15,32,.469,19,27,.704,130,52,86,.605,39,59,.661,13,27,.481,23,29,.793,140
167,NOP,2022-03-13,130,,HOU,W 130-105,240,48,93,.516,38,61,.623,10,32,.313,24,34,.706,130,39,77,.506,27,46,.587,12,31,.387,15,25,.600,105
168,LAL,2022-03-09,130,@,HOU,L 130-139 (OT),265,47,101,.465,29,54,.537,18,47,.383,18,26,.692,130,52,102,.510,35,62,.565,17,40,.425,18,19,.947,139
169,NOP,2022-03-06,130,@,DEN,L 130-138 (OT),265,48,101,.475,34,68,.500,14,33,.424,20,29,.690,130,47,87,.540,37,54,.685,10,33,.303,34,43,.791,138
170,ATL,2022-03-03,130,,CHI,W 130-124,240,44,84,.524,26,44,.591,18,40,.450,24,28,.857,130,52,88,.591,38,62,.613,14,26,.538,6,7,.857,124
171,MIL,2022-02-28,130,,CHO,W 130-106,240,40,91,.440,22,46,.478,18,45,.400,32,37,.865,130,36,93,.387,22,54,.407,14,39,.359,20,32,.625,106
172,ATL,2022-02-16,130,@,ORL,W 130-109,240,45,90,.500,27,57,.474,18,33,.545,22,28,.786,130,42,98,.429,29,57,.509,13,41,.317,12,13,.923,109
173,MIN,2022-02-01,130,,DEN,W 130-115,240,46,93,.495,27,48,.563,19,45,.422,19,25,.760,130,38,89,.427,24,45,.533,14,44,.318,25,28,.893,115
174,CHI,2022-01-30,130,,POR,W 130-116,240,50,90,.556,37,58,.638,13,32,.406,17,18,.944,130,43,83,.518,25,44,.568,18,39,.462,12,16,.750,116
175,GSW,2022-01-25,130,,DAL,W 130-92,240,49,92,.533,32,49,.653,17,43,.395,15,18,.833,130,32,91,.352,22,51,.431,10,40,.250,18,18,1.000,92
176,DEN,2022-01-19,130,,LAC,W 130-128 (OT),265,48,98,.490,35,60,.583,13,38,.342,21,25,.840,130,52,97,.536,37,58,.638,15,39,.385,9,12,.750,128
177,OKC,2022-01-13,130,@,BRK,W 130-109,240,47,91,.516,27,46,.587,20,45,.444,16,18,.889,130,41,98,.418,34,66,.515,7,32,.219,20,22,.909,109
178,DAL,2022-01-07,130,@,HOU,W 130-106,240,49,90,.544,32,52,.615,17,38,.447,15,28,.536,130,37,87,.425,25,44,.568,12,43,.279,20,29,.690,106
179,CHI,2022-01-07,130,,WAS,W 130-122,240,48,91,.527,33,58,.569,15,33,.455,19,21,.905,130,45,88,.511,38,64,.594,7,24,.292,25,26,.962,122
180,CHI,2021-12-27,130,@,ATL,W 130-118,240,51,94,.543,33,57,.579,18,37,.486,10,14,.714,130,40,89,.449,25,55,.455,15,34,.441,23,26,.885,118
181,ORL,2021-12-08,130,@,SAC,L 130-142,240,48,97,.495,32,63,.508,16,34,.471,18,23,.783,130,53,97,.546,38,63,.603,15,34,.441,21,25,.840,142
182,CHO,2021-12-05,130,@,ATL,W 130-127,240,46,86,.535,29,49,.592,17,37,.459,21,28,.750,130,48,93,.516,31,56,.554,17,37,.459,14,18,.778,127
183,BOS,2021-12-03,130,@,UTA,L 130-137,240,47,91,.516,33,52,.635,14,39,.359,22,22,1.000,130,45,81,.556,18,30,.600,27,51,.529,20,23,.870,137
184,BOS,2021-11-19,130,,LAL,W 130-108,240,44,88,.500,33,58,.569,11,30,.367,31,38,.816,130,39,84,.464,27,54,.500,12,30,.400,18,24,.750,108
185,DEN,2022-04-03,129,@,LAL,W 129-118,240,47,82,.573,35,51,.686,12,31,.387,23,29,.793,129,49,92,.533,43,72,.597,6,20,.300,14,21,.667,118
186,IND,2022-03-20,129,,POR,W 129-98,240,48,84,.571,33,49,.673,15,35,.429,18,21,.857,129,38,81,.469,29,48,.604,9,33,.273,13,18,.722,98
187,CHO,2022-03-19,129,,DAL,W 129-108,240,44,88,.500,24,46,.522,20,42,.476,21,27,.778,129,39,89,.438,25,51,.490,14,38,.368,16,20,.800,108
188,PHO,2022-03-18,129,,CHI,W 129-102,240,47,84,.560,36,59,.610,11,25,.440,24,26,.923,129,35,85,.412,28,58,.483,7,27,.259,25,31,.806,102
189,PHO,2022-03-16,129,@,HOU,W 129-112,240,53,95,.558,40,62,.645,13,33,.394,10,13,.769,129,42,85,.494,26,46,.565,16,39,.410,12,19,.632,112
190,BRK,2022-03-10,129,@,PHI,W 129-100,240,51,91,.560,33,51,.647,18,40,.450,9,17,.529,129,30,93,.323,16,57,.281,14,36,.389,26,30,.867,100
191,MIN,2022-03-01,129,,GSW,W 129-114,240,47,89,.528,31,49,.633,16,40,.400,19,23,.826,129,41,90,.456,28,45,.622,13,45,.289,19,22,.864,114
192,SAS,2022-02-26,129,@,MIA,L 129-133,240,50,90,.556,36,59,.610,14,31,.452,15,19,.789,129,47,83,.566,35,55,.636,12,28,.429,27,38,.711,133
193,OKC,2022-02-25,129,@,IND,W 129-125 (OT),265,50,101,.495,39,70,.557,11,31,.355,18,24,.750,129,49,101,.485,35,64,.547,14,37,.378,13,22,.591,125
194,BOS,2022-02-24,129,@,BRK,W 129-106,240,46,85,.541,29,43,.674,17,42,.405,20,27,.741,129,39,94,.415,32,65,.492,7,29,.241,21,28,.750,106
195,MIN,2022-02-13,129,@,IND,W 129-120,240,43,84,.512,25,50,.500,18,34,.529,25,28,.893,129,45,102,.441,32,57,.561,13,45,.289,17,22,.773,120
196,ATL,2022-01-30,129,,LAL,W 129-121,240,49,84,.583,39,53,.736,10,31,.323,21,32,.656,129,47,87,.540,32,52,.615,15,35,.429,12,23,.522,121
197,BRK,2022-01-05,129,@,IND,W 129-121,240,49,86,.570,44,65,.677,5,21,.238,26,29,.897,129,41,82,.500,28,43,.651,13,39,.333,26,28,.929,121
198,TOR,2022-01-04,129,,SAS,W 129-104,240,45,96,.469,27,52,.519,18,44,.409,21,29,.724,129,41,95,.432,32,60,.533,9,35,.257,13,19,.684,104
199,TOR,2021-12-14,129,@,BRK,L 129-131 (OT),265,48,105,.457,30,53,.566,18,52,.346,15,19,.789,129,50,103,.485,36,64,.563,14,39,.359,17,23,.739,131
200,UTA,2021-11-29,129,,POR,W 129-107,240,47,89,.528,28,43,.651,19,46,.413,16,23,.696,129,42,91,.462,31,60,.517,11,31,.355,12,17,.706,107
201,SAC,2021-11-15,129,@,DET,W 129-107,240,52,98,.531,36,65,.554,16,33,.485,9,11,.818,129,39,96,.406,26,49,.531,13,47,.277,16,17,.941,107
202,ATL,2021-11-15,129,,ORL,W 129-111,240,47,85,.553,33,55,.600,14,30,.467,21,32,.656,129,43,95,.453,27,52,.519,16,43,.372,9,14,.643,111
203,LAC,2021-11-13,129,,MIN,W 129-102,240,53,99,.535,37,59,.627,16,40,.400,7,9,.778,129,40,102,.392,29,66,.439,11,36,.306,11,16,.688,102
204,MIA,2021-10-30,129,@,MEM,W 129-103,240,46,88,.523,25,51,.490,21,37,.568,16,19,.842,129,34,88,.386,18,38,.474,16,50,.320,19,21,.905,103
205,CHO,2021-10-25,129,,BOS,L 129-140 (OT),265,46,103,.447,27,59,.458,19,44,.432,18,28,.643,129,50,101,.495,31,51,.608,19,50,.380,21,25,.840,140
206,GSW,2022-04-10,128,@,NOP,W 128-107,240,49,81,.605,30,48,.625,19,33,.576,11,13,.846,128,42,99,.424,28,59,.475,14,40,.350,9,12,.750,107
207,DAL,2022-04-08,128,,POR,W 128-78,240,42,79,.532,22,34,.647,20,45,.444,24,31,.774,128,31,83,.373,24,51,.471,7,32,.219,9,12,.750,78
208,GSW,2022-04-07,128,,LAL,W 128-112,240,51,97,.526,35,65,.538,16,32,.500,10,10,1.000,128,37,83,.446,28,51,.549,9,32,.281,29,38,.763,112
209,CHO,2022-04-07,128,,ORL,W 128-101,240,48,92,.522,36,58,.621,12,34,.353,20,27,.741,128,38,95,.400,23,47,.489,15,48,.313,10,13,.769,101
210,BOS,2022-04-01,128,,IND,W 128-123,240,45,83,.542,33,50,.660,12,33,.364,26,28,.929,128,42,81,.519,25,45,.556,17,36,.472,22,23,.957,123
211,DAL,2022-03-29,128,,LAL,W 128-110,240,45,87,.517,25,41,.610,20,46,.435,18,23,.783,128,40,89,.449,28,45,.622,12,44,.273,18,22,.818,110
212,LAL,2022-03-18,128,@,TOR,W 128-123 (OT),265,47,96,.490,28,53,.528,19,43,.442,15,21,.714,128,49,97,.505,37,60,.617,12,37,.324,13,20,.650,123
213,BRK,2022-03-18,128,,POR,W 128-123,240,45,77,.584,35,52,.673,10,25,.400,28,33,.848,128,48,96,.500,35,61,.574,13,35,.371,14,24,.583,123
214,NYK,2022-03-16,128,,POR,W 128-98,240,40,80,.500,24,42,.571,16,38,.421,32,39,.821,128,40,91,.440,29,57,.509,11,34,.324,7,14,.500,98
215,IND,2022-03-13,128,@,ATL,L 128-131,240,46,89,.517,31,54,.574,15,35,.429,21,26,.808,128,46,84,.548,29,46,.630,17,38,.447,22,24,.917,131
216,IND,2022-02-27,128,,BOS,W 128-107,240,47,90,.522,30,57,.526,17,33,.515,17,20,.850,128,39,91,.429,27,48,.563,12,43,.279,17,20,.850,107
217,DEN,2022-02-24,128,@,SAC,W 128-110,240,48,86,.558,33,51,.647,15,35,.429,17,20,.850,128,43,86,.500,34,57,.596,9,29,.310,15,18,.833,110
218,MIL,2022-02-15,128,,IND,W 128-119,240,48,86,.558,38,57,.667,10,29,.345,22,30,.733,128,47,93,.505,30,52,.577,17,41,.415,8,19,.421,119
219,MIN,2022-02-03,128,@,DET,W 128-117,240,44,87,.506,29,53,.547,15,34,.441,25,28,.893,128,40,91,.440,25,45,.556,15,46,.326,22,28,.786,117
220,BOS,2022-01-25,128,,SAC,W 128-75,240,51,103,.495,31,58,.534,20,45,.444,6,7,.857,128,29,95,.305,23,62,.371,6,33,.182,11,15,.733,75
221,LAC,2022-01-19,128,@,DEN,L 128-130 (OT),265,52,97,.536,37,58,.638,15,39,.385,9,12,.750,128,48,98,.490,35,60,.583,13,38,.342,21,25,.840,130
222,HOU,2022-01-12,128,@,SAS,W 128-124,240,45,82,.549,29,46,.630,16,36,.444,22,32,.688,128,43,99,.434,26,53,.491,17,46,.370,21,27,.778,124
223,NOP,2022-01-11,128,,MIN,W 128-125,240,42,76,.553,26,43,.605,16,33,.485,28,37,.757,128,42,86,.488,24,47,.511,18,39,.462,23,31,.742,125
224,UTA,2021-12-23,128,,MIN,W 128-116,240,48,90,.533,32,51,.627,16,39,.410,16,22,.727,128,45,101,.446,28,56,.500,17,45,.378,9,12,.750,116
225,SAS,2021-12-17,128,@,UTA,W 128-126,240,50,100,.500,35,59,.593,15,41,.366,13,18,.722,128,46,93,.495,33,56,.589,13,37,.351,21,26,.808,126
226,MEM,2021-11-28,128,,SAC,W 128-101,240,50,104,.481,37,65,.569,13,39,.333,15,20,.750,128,33,97,.340,24,55,.436,9,42,.214,26,37,.703,101
227,CHI,2021-11-01,128,@,BOS,W 128-114,240,49,86,.570,36,55,.655,13,31,.419,17,18,.944,128,42,96,.438,27,63,.429,15,33,.455,15,20,.750,114
228,CHI,2021-10-22,128,,NOP,W 128-112,240,47,89,.528,33,61,.541,14,28,.500,20,25,.800,128,42,87,.483,27,58,.466,15,29,.517,13,16,.813,112
229,NOP,2022-04-07,127,,POR,W 127-94,240,44,93,.473,31,56,.554,13,37,.351,26,31,.839,127,36,69,.522,25,38,.658,11,31,.355,11,13,.846,94
230,MIN,2022-04-07,127,,SAS,W 127-121,240,41,96,.427,21,43,.488,20,53,.377,25,31,.806,127,43,89,.483,33,61,.541,10,28,.357,25,34,.735,121
231,MIL,2022-04-07,127,,BOS,W 127-121,240,49,97,.505,35,59,.593,14,38,.368,15,21,.714,127,43,87,.494,22,37,.595,21,50,.420,14,19,.737,121
232,MIL,2022-04-05,127,@,CHI,W 127-106,240,46,87,.529,34,52,.654,12,35,.343,23,25,.920,127,42,98,.429,33,65,.508,9,33,.273,13,13,1.000,106
233,MIA,2022-04-02,127,@,CHI,W 127-109,240,44,82,.537,27,48,.563,17,34,.500,22,27,.815,127,37,86,.430,28,52,.538,9,34,.265,26,29,.897,109
234,WAS,2022-03-30,127,,ORL,W 127-110,240,47,92,.511,34,56,.607,13,36,.361,20,26,.769,127,40,96,.417,29,62,.468,11,34,.324,19,22,.864,110
235,MEM,2022-03-26,127,,MIL,W 127-102,240,49,102,.480,36,65,.554,13,37,.351,16,23,.696,127,37,93,.398,30,61,.492,7,32,.219,21,26,.808,102
236,DEN,2022-03-22,127,,LAC,W 127-115,240,45,83,.542,29,51,.569,16,32,.500,21,23,.913,127,42,86,.488,32,54,.593,10,32,.313,21,26,.808,115
237,PHO,2022-03-20,127,@,SAC,W 127-124 (OT),265,46,92,.500,34,64,.531,12,28,.429,23,27,.852,127,39,91,.429,23,57,.404,16,34,.471,30,36,.833,124
238,WAS,2022-03-19,127,,LAL,W 127-119,240,44,85,.518,31,54,.574,13,31,.419,26,31,.839,127,48,91,.527,35,56,.625,13,35,.371,10,11,.909,119
239,DEN,2022-03-16,127,@,WAS,W 127-109,240,46,90,.511,31,53,.585,15,37,.405,20,21,.952,127,41,87,.471,36,64,.563,5,23,.217,22,31,.710,109
240,POR,2022-03-12,127,,WAS,W 127-118,240,48,93,.516,37,63,.587,11,30,.367,20,22,.909,127,39,83,.470,25,49,.510,14,34,.412,26,27,.963,118
241,TOR,2022-03-12,127,@,DEN,W 127-115,240,48,102,.471,36,71,.507,12,31,.387,19,25,.760,127,43,78,.551,32,51,.627,11,27,.407,18,24,.750,115
242,CLE,2022-03-08,127,@,IND,W 127-124,240,47,94,.500,38,62,.613,9,32,.281,24,27,.889,127,49,91,.538,33,59,.559,16,32,.500,10,15,.667,124
243,HOU,2022-03-02,127,,UTA,L 127-132 (OT),265,43,86,.500,22,35,.629,21,51,.412,20,30,.667,127,50,91,.549,35,49,.714,15,42,.357,17,24,.708,132
244,MIN,2022-02-28,127,@,CLE,W 127-122,240,47,86,.547,29,44,.659,18,42,.429,15,19,.789,127,39,74,.527,24,37,.649,15,37,.405,29,34,.853,122
245,DET,2022-02-27,127,@,CHO,W 127-126 (OT),265,50,110,.455,36,70,.514,14,40,.350,13,18,.722,127,45,89,.506,32,58,.552,13,31,.419,23,34,.676,126
246,ATL,2022-02-26,127,,TOR,W 127-100,240,48,83,.578,35,52,.673,13,31,.419,18,22,.818,127,38,95,.400,28,63,.444,10,32,.313,14,19,.737,100
247,OKC,2022-02-14,127,@,NYK,W 127-123 (OT),265,48,96,.500,35,62,.565,13,34,.382,18,27,.667,127,45,108,.417,30,58,.517,15,50,.300,18,22,.818,123
248,PHO,2022-02-07,127,@,CHI,W 127-124,240,49,90,.544,37,58,.638,12,32,.375,17,19,.895,127,43,90,.478,33,64,.516,10,26,.385,28,31,.903,124
249,TOR,2022-02-03,127,,CHI,W 127-120 (OT),265,48,113,.425,34,77,.442,14,36,.389,17,19,.895,127,43,90,.478,31,61,.508,12,29,.414,22,24,.917,120
250,SAC,2022-01-22,127,@,MIL,L 127-133,240,51,97,.526,36,60,.600,15,37,.405,10,16,.625,127,45,91,.495,24,49,.490,21,42,.500,22,25,.880,133
251,MEM,2022-01-09,127,@,LAL,W 127-119,240,47,86,.547,36,56,.643,11,30,.367,22,32,.688,127,45,97,.464,31,64,.484,14,33,.424,15,19,.789,119
252,MIL,2021-12-28,127,@,ORL,W 127-110,240,47,85,.553,30,48,.625,17,37,.459,16,22,.727,127,38,83,.458,26,44,.591,12,39,.308,22,26,.846,110
253,MEM,2021-12-26,127,@,SAC,W 127-102,240,47,100,.470,38,70,.543,9,30,.300,24,30,.800,127,34,81,.420,24,52,.462,10,29,.345,24,27,.889,102
254,DEN,2021-12-11,127,@,SAS,W 127-112,240,47,93,.505,27,50,.540,20,43,.465,13,14,.929,127,41,89,.461,31,62,.500,10,27,.370,20,29,.690,112
255,PHI,2021-12-06,127,@,CHO,W 127-124 (OT),265,46,87,.529,31,51,.608,15,36,.417,20,27,.741,127,48,107,.449,32,61,.525,16,46,.348,12,17,.706,124
256,ATL,2021-12-05,127,,CHO,L 127-130,240,48,93,.516,31,56,.554,17,37,.459,14,18,.778,127,46,86,.535,29,49,.592,17,37,.459,21,28,.750,130
257,MIL,2021-12-01,127,,CHO,W 127-125,240,46,94,.489,32,58,.552,14,36,.389,21,26,.808,127,43,87,.494,22,36,.611,21,51,.412,18,21,.857,125
258,UTA,2021-11-27,127,,NOP,W 127-105,240,45,80,.563,25,45,.556,20,35,.571,17,22,.773,127,40,93,.430,32,58,.552,8,35,.229,17,21,.810,105
259,NOP,2021-11-24,127,,WAS,W 127-102,240,44,96,.458,32,67,.478,12,29,.414,27,32,.844,127,36,84,.429,29,53,.547,7,31,.226,23,36,.639,102
260,DET,2021-11-13,127,@,TOR,W 127-121,240,43,79,.544,28,44,.636,15,35,.429,26,30,.867,127,44,87,.506,31,53,.585,13,34,.382,20,31,.645,121
261,GSW,2021-11-08,127,,ATL,W 127-113,240,44,92,.478,26,48,.542,18,44,.409,21,22,.955,127,38,82,.463,21,39,.538,17,43,.395,20,26,.769,113
262,MIL,2021-10-19,127,,BRK,W 127-104,240,48,105,.457,31,60,.517,17,45,.378,14,18,.778,127,37,84,.440,20,52,.385,17,32,.531,13,23,.565,104
263,IND,2022-04-10,126,@,BRK,L 126-134,240,47,104,.452,28,58,.483,19,46,.413,13,19,.684,126,52,81,.642,44,59,.746,8,22,.364,22,25,.880,134
264,NOP,2022-03-24,126,,CHI,W 126-109,240,41,83,.494,29,54,.537,12,29,.414,32,34,.941,126,40,78,.513,26,44,.591,14,34,.412,15,19,.789,109
265,PHI,2022-03-23,126,@,LAL,W 126-121,240,47,91,.516,37,64,.578,10,27,.370,22,28,.786,126,50,97,.515,39,67,.582,11,30,.367,10,16,.625,121
266,MIL,2022-03-22,126,,CHI,W 126-98,240,50,82,.610,38,54,.704,12,28,.429,14,20,.700,126,39,92,.424,26,59,.441,13,33,.394,7,13,.538,98
267,BOS,2022-03-18,126,@,SAC,W 126-97,240,46,82,.561,24,42,.571,22,40,.550,12,17,.706,126,33,79,.418,20,43,.465,13,36,.361,18,24,.750,97
268,SAC,2022-03-16,126,,MIL,L 126-135,240,46,94,.489,30,51,.588,16,43,.372,18,21,.857,126,47,89,.528,29,54,.537,18,35,.514,23,32,.719,135
269,GSW,2022-03-14,126,,WAS,W 126-112,240,45,84,.536,27,39,.692,18,45,.400,18,22,.818,126,42,82,.512,32,56,.571,10,26,.385,18,23,.783,112
270,BOS,2022-03-06,126,,BRK,W 126-120,240,40,83,.482,23,47,.489,17,36,.472,29,38,.763,126,45,89,.506,33,62,.532,12,27,.444,18,20,.900,120
271,CHO,2022-02-27,126,,DET,L 126-127 (OT),265,45,89,.506,32,58,.552,13,31,.419,23,34,.676,126,50,110,.455,36,70,.514,14,40,.350,13,18,.722,127
272,BRK,2022-02-26,126,@,MIL,W 126-123,240,44,92,.478,31,58,.534,13,34,.382,25,33,.758,126,41,78,.526,25,40,.625,16,38,.421,25,38,.658,123
273,MIN,2022-02-15,126,,CHO,W 126-120 (OT),265,43,109,.394,30,54,.556,13,55,.236,27,43,.628,126,42,102,.412,34,69,.493,8,33,.242,28,37,.757,120
274,BOS,2022-02-08,126,@,BRK,W 126-91,240,50,91,.549,36,51,.706,14,40,.350,12,16,.750,126,38,99,.384,28,63,.444,10,36,.278,5,13,.385,91
275,GSW,2022-02-03,126,,SAC,W 126-114,240,47,84,.560,27,42,.643,20,42,.476,12,16,.750,126,42,80,.525,31,49,.633,11,31,.355,19,23,.826,114
276,CHI,2022-02-01,126,,ORL,W 126-115,240,46,90,.511,35,60,.583,11,30,.367,23,29,.793,126,46,93,.495,32,54,.593,14,39,.359,9,11,.818,115
277,MIN,2022-01-30,126,,UTA,W 126-106,240,49,89,.551,36,58,.621,13,31,.419,15,18,.833,126,38,81,.469,23,41,.561,15,40,.375,15,21,.714,106
278,IND,2022-01-26,126,,CHO,L 126-158,240,44,92,.478,34,58,.586,10,34,.294,28,34,.824,126,54,93,.581,30,48,.625,24,45,.533,26,33,.788,158
279,MIL,2022-01-19,126,,MEM,W 126-114,240,46,97,.474,33,60,.550,13,37,.351,21,22,.955,126,44,106,.415,35,66,.530,9,40,.225,17,25,.680,114
280,SAC,2022-01-14,126,,HOU,W 126-114,240,48,96,.500,35,59,.593,13,37,.351,17,24,.708,126,44,101,.436,31,58,.534,13,43,.302,13,16,.813,114
281,DET,2022-01-10,126,,UTA,W 126-116,240,48,93,.516,29,56,.518,19,37,.514,11,12,.917,126,44,86,.512,33,53,.623,11,33,.333,17,22,.773,116
282,MIL,2021-12-22,126,,HOU,W 126-106,240,45,103,.437,28,57,.491,17,46,.370,19,21,.905,126,36,86,.419,23,41,.561,13,45,.289,21,31,.677,106
283,UTA,2021-12-17,126,,SAS,L 126-128,240,46,93,.495,33,56,.589,13,37,.351,21,26,.808,126,50,100,.500,35,59,.593,15,41,.366,13,18,.722,128
284,ATL,2021-12-13,126,,HOU,L 126-132,240,42,85,.494,27,46,.587,15,39,.385,27,31,.871,126,46,96,.479,27,50,.540,19,46,.413,21,27,.778,132
285,MEM,2021-12-13,126,,PHI,W 126-91,240,47,89,.528,33,55,.600,14,34,.412,18,23,.783,126,37,83,.446,33,61,.541,4,22,.182,13,19,.684,91
286,GSW,2021-12-06,126,,ORL,W 126-95,240,43,87,.494,23,47,.489,20,40,.500,20,29,.690,126,33,76,.434,22,38,.579,11,38,.289,18,22,.818,95
287,TOR,2021-11-24,126,@,MEM,W 126-113,240,47,89,.528,33,59,.559,14,30,.467,18,21,.857,126,42,82,.512,33,53,.623,9,29,.310,20,26,.769,113
288,PHO,2021-11-21,126,,DEN,W 126-97,240,46,87,.529,35,51,.686,11,36,.306,23,26,.885,126,33,90,.367,22,52,.423,11,38,.289,20,28,.714,97
289,LAL,2021-11-08,126,,CHO,W 126-123 (OT),265,44,91,.484,31,59,.525,13,32,.406,25,35,.714,126,43,99,.434,29,57,.509,14,42,.333,23,28,.821,123
290,CLE,2021-11-07,126,@,NYK,W 126-109,240,49,90,.544,30,55,.545,19,35,.543,9,11,.818,126,39,85,.459,30,54,.556,9,31,.290,22,24,.917,109
291,GSW,2021-11-05,126,,NOP,W 126-85,240,47,91,.516,27,41,.659,20,50,.400,12,14,.857,126,31,88,.352,20,44,.455,11,44,.250,12,16,.750,85
292,LAC,2021-11-03,126,@,MIN,W 126-115,240,47,78,.603,26,42,.619,21,36,.583,11,12,.917,126,43,94,.457,29,54,.537,14,40,.350,15,16,.938,115
293,ORL,2022-04-10,125,,MIA,W 125-111,240,45,91,.495,22,33,.667,23,58,.397,12,14,.857,125,40,94,.426,21,44,.477,19,50,.380,12,16,.750,111
294,DEN,2022-03-30,125,@,IND,W 125-118,240,50,80,.625,38,52,.731,12,28,.429,13,14,.929,125,44,97,.454,32,57,.561,12,40,.300,18,23,.783,118
295,CHO,2022-03-30,125,@,NYK,W 125-114,240,49,90,.544,37,55,.673,12,35,.343,15,17,.882,125,40,85,.471,24,41,.585,16,44,.364,18,26,.692,114
296,TOR,2022-03-30,125,,MIN,W 125-102,240,48,96,.500,30,60,.500,18,36,.500,11,15,.733,125,37,92,.402,26,55,.473,11,37,.297,17,23,.739,102
297,HOU,2022-03-25,125,@,POR,W 125-106,240,43,83,.518,24,38,.632,19,45,.422,20,23,.870,125,43,85,.506,40,65,.615,3,20,.150,17,23,.739,106
298,BOS,2022-03-23,125,,UTA,W 125-97,240,50,84,.595,31,48,.646,19,36,.528,6,7,.857,125,35,88,.398,27,52,.519,8,36,.222,19,21,.905,97
299,PHO,2022-03-23,125,@,MIN,W 125-116,240,45,86,.523,33,53,.623,12,33,.364,23,29,.793,125,42,95,.442,29,52,.558,13,43,.302,19,22,.864,116
300,UTA,2022-03-16,125,,CHI,W 125-110,240,42,83,.506,23,44,.523,19,39,.487,22,29,.759,125,43,91,.473,31,57,.544,12,34,.353,12,17,.706,110
301,MEM,2022-03-13,125,@,OKC,W 125-118,240,48,102,.471,37,73,.507,11,29,.379,18,20,.900,125,41,97,.423,28,56,.500,13,41,.317,23,28,.821,118
302,SAC,2022-03-12,125,@,UTA,L 125-134,240,47,94,.500,34,61,.557,13,33,.394,18,21,.857,125,48,86,.558,32,45,.711,16,41,.390,22,31,.710,134
303,PHI,2022-03-04,125,,CLE,W 125-119,240,41,75,.547,27,42,.643,14,33,.424,29,32,.906,125,44,82,.537,34,54,.630,10,28,.357,21,24,.875,119
304,NOP,2022-03-02,125,,SAC,W 125-95,240,52,88,.591,41,59,.695,11,29,.379,10,12,.833,125,35,89,.393,27,54,.500,8,35,.229,17,25,.680,95
305,PHI,2022-02-27,125,@,NYK,W 125-109,240,38,78,.487,28,45,.622,10,33,.303,39,44,.886,125,38,85,.447,27,52,.519,11,33,.333,22,35,.629,109
306,IND,2022-02-25,125,,OKC,L 125-129 (OT),265,49,101,.485,35,64,.547,14,37,.378,13,22,.591,125,50,101,.495,39,70,.557,11,31,.355,18,24,.750,129
307,CHO,2022-02-25,125,,TOR,W 125-93,240,52,94,.553,37,54,.685,15,40,.375,6,9,.667,125,37,84,.440,31,61,.508,6,23,.261,13,23,.565,93
308,DAL,2022-02-17,125,@,NOP,W 125-118,240,44,82,.537,25,42,.595,19,40,.475,18,25,.720,125,46,92,.500,34,64,.531,12,28,.429,14,21,.667,118
309,CHI,2022-02-16,125,,SAC,W 125-118,240,47,94,.500,35,65,.538,12,29,.414,19,20,.950,125,43,84,.512,31,54,.574,12,30,.400,20,22,.909,118
310,MEM,2022-02-12,125,@,CHO,W 125-118,240,47,96,.490,36,63,.571,11,33,.333,20,33,.606,125,39,97,.402,25,52,.481,14,45,.311,26,33,.788,118
311,TOR,2022-02-04,125,,ATL,W 125-114,240,46,81,.568,29,54,.537,17,27,.630,16,18,.889,125,43,93,.462,34,64,.531,9,29,.310,19,21,.905,114
312,UTA,2022-02-04,125,,BRK,W 125-102,240,48,85,.565,31,47,.660,17,38,.447,12,14,.857,125,41,99,.414,29,65,.446,12,34,.353,8,11,.727,102
313,POR,2022-01-28,125,@,HOU,W 125-110,240,46,81,.568,29,42,.690,17,39,.436,16,20,.800,125,38,79,.481,28,38,.737,10,41,.244,24,31,.774,110
314,TOR,2022-01-25,125,,CHO,W 125-113,240,43,82,.524,27,48,.563,16,34,.471,23,29,.793,125,40,82,.488,30,51,.588,10,31,.323,23,32,.719,113
315,BRK,2022-01-23,125,@,MIN,L 125-136,240,48,95,.505,33,57,.579,15,38,.395,14,15,.933,125,48,92,.522,34,60,.567,14,32,.438,26,31,.839,136
316,UTA,2022-01-16,125,@,DEN,W 125-102,240,44,84,.524,29,45,.644,15,39,.385,22,29,.759,125,42,95,.442,31,52,.596,11,43,.256,7,8,.875,102
317,SAC,2022-01-12,125,,LAL,W 125-116,240,49,89,.551,38,59,.644,11,30,.367,16,19,.842,125,42,98,.429,26,51,.510,16,47,.340,16,24,.667,116
318,MIN,2022-01-11,125,@,NOP,L 125-128,240,42,86,.488,24,47,.511,18,39,.462,23,31,.742,125,42,76,.553,26,43,.605,16,33,.485,28,37,.757,128
319,IND,2022-01-08,125,,UTA,W 125-113,240,44,80,.550,30,51,.588,14,29,.483,23,32,.719,125,40,84,.476,25,49,.510,15,35,.429,18,19,.947,113
320,MIA,2021-12-21,125,,IND,W 125-96,240,47,95,.495,25,46,.543,22,49,.449,9,11,.818,125,31,87,.356,20,56,.357,11,31,.355,23,28,.821,96
321,POR,2021-12-17,125,,CHO,W 125-116,240,44,85,.518,23,38,.605,21,47,.447,16,18,.889,125,44,92,.478,31,55,.564,13,37,.351,15,18,.833,116
322,CHO,2021-12-01,125,@,MIL,L 125-127,240,43,87,.494,22,36,.611,21,51,.412,18,21,.857,125,46,94,.489,32,58,.552,14,36,.389,21,26,.808,127
323,SAC,2021-11-24,125,,POR,W 125-121,240,45,86,.523,33,53,.623,12,33,.364,23,34,.676,125,44,94,.468,32,56,.571,12,38,.316,21,25,.840,121
324,MEM,2021-11-08,125,,MIN,W 125-118 (OT),265,46,92,.500,35,64,.547,11,28,.393,22,26,.846,125,41,97,.423,24,52,.462,17,45,.378,19,23,.826,118
325,MIA,2021-11-02,125,@,DAL,W 125-110,240,43,83,.518,30,58,.517,13,25,.520,26,30,.867,125,37,84,.440,23,42,.548,14,42,.333,22,31,.710,110
326,CHO,2021-10-31,125,,POR,W 125-113,240,46,89,.517,26,47,.553,20,42,.476,13,21,.619,125,43,97,.443,26,43,.605,17,54,.315,10,11,.909,113
327,LAL,2021-10-26,125,@,SAS,W 125-121 (OT),265,50,105,.476,42,75,.560,8,30,.267,17,22,.773,125,48,108,.444,35,72,.486,13,36,.361,12,22,.545,121
328,CHI,2022-04-10,124,@,MIN,W 124-120,240,44,83,.530,34,62,.548,10,21,.476,26,33,.788,124,46,91,.505,35,60,.583,11,31,.355,17,22,.773,120
329,CHO,2022-04-10,124,,WAS,W 124-108,240,48,89,.539,30,56,.536,18,33,.545,10,14,.714,124,42,94,.447,34,71,.479,8,23,.348,16,26,.615,108
330,BOS,2022-03-20,124,@,DEN,W 124-104,240,47,82,.573,28,42,.667,19,40,.475,11,11,1.000,124,35,87,.402,21,48,.438,14,39,.359,20,25,.800,104
331,SAC,2022-03-20,124,,PHO,L 124-127 (OT),265,39,91,.429,23,57,.404,16,34,.471,30,36,.833,124,46,92,.500,34,64,.531,12,28,.429,23,27,.852,127
332,NOP,2022-03-18,124,@,SAS,W 124-91,240,48,96,.500,34,62,.548,14,34,.412,14,18,.778,124,32,89,.360,21,45,.467,11,44,.250,16,20,.800,91
333,MIN,2022-03-16,124,,LAL,W 124-104,240,40,90,.444,23,48,.479,17,42,.405,27,31,.871,124,39,93,.419,29,49,.592,10,44,.227,16,23,.696,104
334,MIL,2022-03-09,124,,ATL,W 124-115,240,47,94,.500,35,59,.593,12,35,.343,18,23,.783,124,43,86,.500,32,48,.667,11,38,.289,18,22,.818,115
335,IND,2022-03-08,124,,CLE,L 124-127,240,49,91,.538,33,59,.559,16,32,.500,10,15,.667,124,47,94,.500,38,62,.613,9,32,.281,24,27,.889,127
336,GSW,2022-03-07,124,@,DEN,L 124-131,240,45,88,.511,28,48,.583,17,40,.425,17,23,.739,124,46,84,.548,36,52,.692,10,32,.313,29,41,.707,131
337,MIN,2022-03-07,124,,POR,W 124-81,240,38,92,.413,25,49,.510,13,43,.302,35,44,.795,124,23,83,.277,16,55,.291,7,28,.250,28,38,.737,81
338,LAL,2022-03-05,124,,GSW,W 124-116,240,44,89,.494,26,48,.542,18,41,.439,18,21,.857,124,46,92,.500,31,58,.534,15,34,.441,9,19,.474,116
339,MEM,2022-03-05,124,,ORL,W 124-96,240,46,92,.500,32,58,.552,14,34,.412,18,27,.667,124,37,86,.430,26,51,.510,11,35,.314,11,16,.688,96
340,NOP,2022-03-04,124,,UTA,W 124-90,240,50,97,.515,39,61,.639,11,36,.306,13,17,.765,124,31,89,.348,20,48,.417,11,41,.268,17,26,.654,90
341,CHI,2022-03-03,124,@,ATL,L 124-130,240,52,88,.591,38,62,.613,14,26,.538,6,7,.857,124,44,84,.524,26,44,.591,18,40,.450,24,28,.857,130
342,DEN,2022-02-27,124,@,POR,W 124-92,240,44,86,.512,32,49,.653,12,37,.324,24,31,.774,124,34,91,.374,28,55,.509,6,36,.167,18,26,.692,92
343,PHO,2022-02-24,124,@,OKC,W 124-104,240,46,86,.535,33,52,.635,13,34,.382,19,21,.905,124,44,93,.473,38,62,.613,6,31,.194,10,11,.909,104
344,PHO,2022-02-16,124,,HOU,W 124-121,240,44,86,.512,37,62,.597,7,24,.292,29,36,.806,124,42,97,.433,29,53,.547,13,44,.295,24,28,.857,121
345,ATL,2022-02-15,124,,CLE,W 124-116,240,43,80,.538,29,47,.617,14,33,.424,24,27,.889,124,45,88,.511,29,47,.617,16,41,.390,10,12,.833,116
346,SAS,2022-02-12,124,@,NOP,W 124-114,240,47,93,.505,33,56,.589,14,37,.378,16,19,.842,124,43,87,.494,32,55,.582,11,32,.344,17,20,.850,114
347,CHI,2022-02-07,124,,PHO,L 124-127,240,43,90,.478,33,64,.516,10,26,.385,28,31,.903,124,49,90,.544,37,58,.638,12,32,.375,17,19,.895,127
348,DEN,2022-02-06,124,,BRK,W 124-104,240,49,94,.521,39,62,.629,10,32,.313,16,21,.762,124,36,87,.414,20,46,.435,16,41,.390,16,22,.727,104
349,ATL,2022-02-03,124,,PHO,W 124-115,240,44,84,.524,24,44,.545,20,40,.500,16,22,.727,124,46,88,.523,37,56,.661,9,32,.281,14,18,.778,115
350,GSW,2022-02-01,124,@,SAS,W 124-120,240,43,96,.448,23,50,.460,20,46,.435,18,18,1.000,124,46,83,.554,30,50,.600,16,33,.485,12,17,.706,120
351,TOR,2022-01-29,124,@,MIA,W 124-120 (3OT),315,47,107,.439,31,62,.500,16,45,.356,14,18,.778,124,45,110,.409,29,60,.483,16,50,.320,14,20,.700,120
352,MIN,2022-01-28,124,@,PHO,L 124-134,240,44,90,.489,30,51,.588,14,39,.359,22,27,.815,124,43,84,.512,23,45,.511,20,39,.513,28,37,.757,134
353,GSW,2022-01-27,124,,MIN,W 124-115,240,44,82,.537,23,46,.500,21,36,.583,15,21,.714,124,42,95,.442,32,51,.627,10,44,.227,21,27,.778,115
354,DEN,2022-01-26,124,@,BRK,W 124-118,240,42,89,.472,27,53,.509,15,36,.417,25,27,.926,124,43,88,.489,31,59,.525,12,29,.414,20,26,.769,118
355,MIA,2022-01-14,124,,ATL,W 124-118,240,41,77,.532,27,47,.574,14,30,.467,28,30,.933,124,38,79,.481,22,41,.537,16,38,.421,26,30,.867,118
356,SAS,2022-01-12,124,,HOU,L 124-128,240,43,99,.434,26,53,.491,17,46,.370,21,27,.778,124,45,82,.549,29,46,.630,16,36,.444,22,32,.688,128
357,WAS,2022-01-03,124,,CHO,W 124-121,240,40,87,.460,24,49,.490,16,38,.421,28,31,.903,124,50,104,.481,36,66,.545,14,38,.368,7,13,.538,121
358,DEN,2022-01-01,124,@,HOU,W 124-111,240,46,86,.535,36,54,.667,10,32,.313,22,27,.815,124,37,85,.435,21,43,.488,16,42,.381,21,24,.875,111
359,BRK,2021-12-27,124,@,LAC,W 124-108,240,50,88,.568,37,54,.685,13,34,.382,11,16,.688,124,37,97,.381,23,60,.383,14,37,.378,20,27,.741,108
360,WAS,2021-12-23,124,@,NYK,W 124-117,240,42,75,.560,26,38,.684,16,37,.432,24,32,.750,124,42,93,.452,29,51,.569,13,42,.310,20,23,.870,117
361,MEM,2021-12-17,124,@,SAC,W 124-105,240,45,97,.464,32,73,.438,13,24,.542,21,27,.778,124,36,88,.409,23,53,.434,13,35,.371,20,26,.769,105
362,MIN,2021-12-15,124,@,DEN,W 124-107,240,45,88,.511,22,40,.550,23,48,.479,11,16,.688,124,38,84,.452,24,45,.533,14,39,.359,17,23,.739,107
363,CLE,2021-12-15,124,,HOU,W 124-89,240,45,80,.563,27,40,.675,18,40,.450,16,24,.667,124,30,78,.385,25,49,.510,5,29,.172,24,35,.686,89
364,UTA,2021-12-15,124,,LAC,W 124-103,240,47,89,.528,32,52,.615,15,37,.405,15,20,.750,124,40,85,.471,30,55,.545,10,30,.333,13,20,.650,103
365,TOR,2021-12-13,124,,SAC,W 124-101,240,53,98,.541,42,67,.627,11,31,.355,7,10,.700,124,38,94,.404,27,60,.450,11,34,.324,14,21,.667,101
366,CHO,2021-12-10,124,,SAC,W 124-123,240,48,87,.552,34,52,.654,14,35,.400,14,20,.700,124,48,101,.475,34,60,.567,14,41,.341,13,17,.765,123
367,CHO,2021-12-06,124,,PHI,L 124-127 (OT),265,48,107,.449,32,61,.525,16,46,.348,12,17,.706,124,46,87,.529,31,51,.608,15,36,.417,20,27,.741,127
368,MIL,2021-12-04,124,,MIA,W 124-102,240,44,98,.449,26,48,.542,18,50,.360,18,20,.900,124,34,84,.405,17,41,.415,17,43,.395,17,24,.708,102
369,SAC,2021-12-01,124,@,LAC,W 124-115,240,46,88,.523,31,50,.620,15,38,.395,17,20,.850,124,47,100,.470,38,69,.551,9,31,.290,12,16,.750,115
370,ATL,2021-11-24,124,@,SAS,W 124-106,240,45,88,.511,33,62,.532,12,26,.462,22,24,.917,124,43,100,.430,31,67,.463,12,33,.364,8,10,.800,106
371,LAL,2021-11-24,124,@,IND,W 124-116 (OT),265,42,95,.442,27,58,.466,15,37,.405,25,29,.862,124,42,104,.404,29,58,.500,13,46,.283,19,24,.792,116
372,DEN,2021-11-14,124,,POR,W 124-95,240,47,90,.522,28,50,.560,19,40,.475,11,14,.786,124,35,80,.438,22,41,.537,13,39,.333,12,13,.923,95
373,HOU,2021-10-22,124,,OKC,W 124-91,240,48,95,.505,31,57,.544,17,38,.447,11,14,.786,124,34,91,.374,20,48,.417,14,43,.326,9,16,.563,91
374,SAC,2021-10-20,124,@,POR,W 124-121,240,42,92,.457,25,51,.490,17,41,.415,23,29,.793,124,45,93,.484,33,58,.569,12,35,.343,19,22,.864,121
375,MIN,2021-10-20,124,,HOU,W 124-106,240,42,87,.483,26,49,.531,16,38,.421,24,31,.774,124,40,88,.455,29,55,.527,11,33,.333,15,22,.682,106
376,NOP,2022-04-05,123,@,SAC,W 123-109,240,45,88,.511,33,63,.524,12,25,.480,21,26,.808,123,39,76,.513,28,46,.609,11,30,.367,20,22,.909,109
377,IND,2022-04-01,123,@,BOS,L 123-128,240,42,81,.519,25,45,.556,17,36,.472,22,23,.957,123,45,83,.542,33,50,.660,12,33,.364,26,28,.929,128
378,DET,2022-03-29,123,@,BRK,L 123-130,240,48,99,.485,32,61,.525,16,38,.421,11,13,.846,123,42,76,.553,27,48,.563,15,28,.536,31,34,.912,130
379,IND,2022-03-28,123,,ATL,L 123-132,240,45,87,.517,28,51,.549,17,36,.472,16,18,.889,123,47,86,.547,30,51,.588,17,35,.486,21,26,.808,132
380,MEM,2022-03-28,123,,GSW,W 123-95,240,43,92,.467,31,62,.500,12,30,.400,25,35,.714,123,33,81,.407,24,52,.462,9,29,.310,20,26,.769,95
381,MIA,2022-03-28,123,,SAC,W 123-100,240,49,90,.544,30,50,.600,19,40,.475,6,6,1.000,123,37,81,.457,25,46,.543,12,35,.343,14,18,.778,100
382,SAS,2022-03-28,123,@,HOU,W 123-120,240,47,100,.470,40,71,.563,7,29,.241,22,28,.786,123,38,92,.413,18,43,.419,20,49,.408,24,28,.857,120
383,WAS,2022-03-27,123,,GSW,W 123-115,240,44,84,.524,28,56,.500,16,28,.571,19,22,.864,123,38,89,.427,30,56,.536,8,33,.242,31,39,.795,115
384,OKC,2022-03-21,123,,BOS,L 123-132,240,48,93,.516,31,56,.554,17,37,.459,10,14,.714,123,44,86,.512,29,46,.630,15,40,.375,29,34,.853,132
385,POR,2022-03-18,123,@,BRK,L 123-128,240,48,96,.500,35,61,.574,13,35,.371,14,24,.583,123,45,77,.584,35,52,.673,10,25,.400,28,33,.848,128
386,TOR,2022-03-18,123,,LAL,L 123-128 (OT),265,49,97,.505,37,60,.617,12,37,.324,13,20,.650,123,47,96,.490,28,53,.528,19,43,.442,15,21,.714,128
387,UTA,2022-03-09,123,,POR,W 123-85,240,42,81,.519,25,35,.714,17,46,.370,22,27,.815,123,29,89,.326,20,53,.377,9,36,.250,18,22,.818,85
388,MIA,2022-03-07,123,,HOU,W 123-106,240,49,91,.538,35,60,.583,14,31,.452,11,14,.786,123,39,88,.443,26,45,.578,13,43,.302,15,22,.682,106
389,IND,2022-03-06,123,@,WAS,L 123-133,240,44,85,.518,34,54,.630,10,31,.323,25,29,.862,123,45,86,.523,28,44,.636,17,42,.405,26,32,.813,133
390,HOU,2022-03-06,123,,MEM,W 123-112,240,43,82,.524,30,48,.625,13,34,.382,24,36,.667,123,44,97,.454,39,71,.549,5,26,.192,19,27,.704,112
391,CHO,2022-03-05,123,,SAS,W 123-117,240,42,91,.462,26,49,.531,16,42,.381,23,29,.793,123,45,98,.459,34,61,.557,11,37,.297,16,20,.800,117
392,PHI,2022-03-02,123,,NYK,W 123-108,240,39,75,.520,22,39,.564,17,36,.472,28,33,.848,123,39,91,.429,31,63,.492,8,28,.286,22,32,.688,108
393,NOP,2022-02-27,123,@,LAL,W 123-95,240,47,92,.511,34,62,.548,13,30,.433,16,25,.640,123,35,84,.417,28,50,.560,7,34,.206,18,20,.900,95
394,MIL,2022-02-26,123,,BRK,L 123-126,240,41,78,.526,25,40,.625,16,38,.421,25,38,.658,123,44,92,.478,31,58,.534,13,34,.382,25,33,.758,126
395,PHI,2022-02-17,123,@,MIL,W 123-120,240,44,88,.500,32,54,.593,12,34,.353,23,27,.852,123,42,95,.442,28,51,.549,14,44,.318,22,28,.786,120
396,POR,2022-02-16,123,@,MEM,W 123-119,240,43,85,.506,30,53,.566,13,32,.406,24,32,.750,123,37,85,.435,26,55,.473,11,30,.367,34,42,.810,119
397,NYK,2022-02-14,123,,OKC,L 123-127 (OT),265,45,108,.417,30,58,.517,15,50,.300,18,22,.818,123,48,96,.500,35,62,.565,13,34,.382,18,27,.667,127
398,SAC,2022-02-12,123,@,WAS,W 123-110,240,43,76,.566,31,48,.646,12,28,.429,25,29,.862,123,41,88,.466,28,50,.560,13,38,.342,15,21,.714,110
399,MIL,2022-01-28,123,,NYK,W 123-108,240,41,89,.461,27,46,.587,14,43,.326,27,31,.871,123,39,84,.464,25,44,.568,14,40,.350,16,28,.571,108
400,PHI,2022-01-19,123,,ORL,W 123-110,240,45,83,.542,35,55,.636,10,28,.357,23,27,.852,123,40,90,.444,22,55,.400,18,35,.514,12,16,.750,110
401,HOU,2022-01-09,123,,MIN,L 123-141,240,46,97,.474,32,54,.593,14,43,.326,17,28,.607,123,55,108,.509,40,66,.606,15,42,.357,16,21,.762,141
402,MEM,2022-01-08,123,@,LAC,W 123-108,240,44,100,.440,32,62,.516,12,38,.316,23,31,.742,123,39,96,.406,29,64,.453,10,32,.313,20,24,.833,108
403,MIA,2022-01-08,123,@,PHO,W 123-100,240,44,88,.500,22,44,.500,22,44,.500,13,15,.867,123,30,79,.380,16,45,.356,14,34,.412,26,29,.897,100
404,PHO,2022-01-04,123,@,NOP,W 123-110,240,46,85,.541,29,54,.537,17,31,.548,14,20,.700,123,36,89,.404,26,56,.464,10,33,.303,28,32,.875,110
405,GSW,2022-01-01,123,@,UTA,W 123-116,240,46,86,.535,29,54,.537,17,32,.531,14,21,.667,123,40,92,.435,26,48,.542,14,44,.318,22,28,.786,116
406,BOS,2021-12-31,123,,PHO,W 123-108,240,45,83,.542,35,56,.625,10,27,.370,23,26,.885,123,41,100,.410,30,65,.462,11,35,.314,15,16,.938,108
407,HOU,2021-12-28,123,,LAL,L 123-132,240,44,83,.530,28,48,.583,16,35,.457,19,25,.760,123,48,92,.522,34,58,.586,14,34,.412,22,29,.759,132
408,CHO,2021-12-27,123,,HOU,W 123-99,240,47,88,.534,29,47,.617,18,41,.439,11,14,.786,123,36,87,.414,21,41,.512,15,46,.326,12,18,.667,99
409,UTA,2021-12-11,123,@,WAS,W 123-98,240,48,93,.516,35,54,.648,13,39,.333,14,17,.824,123,41,89,.461,33,64,.516,8,25,.320,8,14,.571,98
410,MIL,2021-12-10,123,@,HOU,W 123-114,240,42,83,.506,27,44,.614,15,39,.385,24,32,.750,123,42,89,.472,23,43,.535,19,46,.413,11,20,.550,114
411,CLE,2021-12-10,123,@,MIN,W 123-106,240,46,85,.541,33,52,.635,13,33,.394,18,22,.818,123,36,92,.391,25,53,.472,11,39,.282,23,28,.821,106
412,SAC,2021-12-10,123,@,CHO,L 123-124,240,48,101,.475,34,60,.567,14,41,.341,13,17,.765,123,48,87,.552,34,52,.654,14,35,.400,14,20,.700,124
413,SAS,2021-12-09,123,,DEN,W 123-111,240,46,88,.523,31,53,.585,15,35,.429,16,22,.727,123,42,94,.447,27,55,.491,15,39,.385,12,13,.923,111
414,NOP,2021-11-29,123,@,LAC,W 123-104,240,48,94,.511,34,59,.576,14,35,.400,13,16,.813,123,37,72,.514,23,36,.639,14,36,.389,16,21,.762,104
415,CHI,2021-11-26,123,@,ORL,W 123-88,240,48,86,.558,31,52,.596,17,34,.500,10,16,.625,123,30,80,.375,23,48,.479,7,32,.219,21,30,.700,88
416,BRK,2021-11-24,123,@,BOS,W 123-104,240,43,85,.506,29,50,.580,14,35,.400,23,30,.767,123,34,91,.374,23,43,.535,11,48,.229,25,28,.893,104
417,MIL,2021-11-22,123,,ORL,W 123-92,240,44,94,.468,26,49,.531,18,45,.400,17,24,.708,123,34,93,.366,23,52,.442,11,41,.268,13,18,.722,92
418,UTA,2021-11-20,123,@,SAC,W 123-105,240,46,91,.505,29,52,.558,17,39,.436,14,17,.824,123,41,91,.451,31,60,.517,10,31,.323,13,21,.619,105
419,DAL,2021-11-12,123,@,SAS,W 123-109,240,46,100,.460,28,55,.509,18,45,.400,13,19,.684,123,41,84,.488,28,54,.519,13,30,.433,14,20,.700,109
420,BRK,2021-11-10,123,@,ORL,W 123-90,240,46,91,.505,30,54,.556,16,37,.432,15,17,.882,123,35,92,.380,31,59,.525,4,33,.121,16,24,.667,90
421,GSW,2021-11-10,123,,MIN,W 123-110,240,40,85,.471,29,45,.644,11,40,.275,32,40,.800,123,39,95,.411,22,51,.431,17,44,.386,15,20,.750,110
422,CHO,2021-11-08,123,@,LAL,L 123-126 (OT),265,43,99,.434,29,57,.509,14,42,.333,23,28,.821,123,44,91,.484,31,59,.525,13,32,.406,25,35,.714,126
423,PHO,2021-11-04,123,,HOU,W 123-111,240,44,93,.473,30,62,.484,14,31,.452,21,23,.913,123,38,88,.432,27,56,.482,11,32,.344,24,28,.857,111
424,NYK,2021-10-30,123,@,NOP,W 123-117,240,42,81,.519,23,48,.479,19,33,.576,20,25,.800,123,42,92,.457,31,59,.525,11,33,.333,22,24,.917,117
425,OKC,2021-10-27,123,,LAL,W 123-115,240,43,86,.500,28,49,.571,15,37,.405,22,29,.759,123,46,92,.500,35,57,.614,11,35,.314,12,14,.857,115
426,CHO,2021-10-22,123,@,CLE,W 123-112,240,48,91,.527,35,59,.593,13,32,.406,14,17,.824,123,43,84,.512,34,53,.642,9,31,.290,17,20,.850,112
427,SAS,2021-10-20,123,,ORL,W 123-97,240,49,98,.500,36,68,.529,13,30,.433,12,18,.667,123,35,86,.407,26,57,.456,9,29,.310,18,23,.783,97
428,CHO,2021-10-20,123,,IND,W 123-122,240,46,107,.430,33,76,.434,13,31,.419,18,27,.667,123,42,90,.467,25,43,.581,17,47,.362,21,24,.875,122
429,DEN,2022-04-07,122,,MEM,W 122-109,240,44,80,.550,32,50,.640,12,30,.400,22,25,.880,122,42,89,.472,31,61,.508,11,28,.393,14,19,.737,109
430,IND,2022-04-05,122,,PHI,L 122-131,240,45,95,.474,33,55,.600,12,40,.300,20,21,.952,122,47,87,.540,24,47,.511,23,40,.575,14,18,.778,131
431,ATL,2022-04-02,122,,BRK,W 122-115,240,36,86,.419,23,45,.511,13,41,.317,37,49,.755,122,42,99,.424,25,62,.403,17,37,.459,14,19,.737,115
432,SAC,2022-04-01,122,@,HOU,W 122-117,240,42,81,.519,30,53,.566,12,28,.429,26,34,.765,122,41,97,.423,24,52,.462,17,45,.378,18,26,.692,117
433,MEM,2022-04-01,122,,PHO,W 122-114,240,46,102,.451,39,78,.500,7,24,.292,23,28,.821,122,47,86,.547,37,59,.627,10,27,.370,10,17,.588,114
434,UTA,2022-03-31,122,,LAL,W 122-109,240,46,90,.511,31,46,.674,15,44,.341,15,24,.625,122,41,83,.494,34,58,.586,7,25,.280,20,28,.714,109
435,PHI,2022-03-25,122,@,LAC,W 122-97,240,43,92,.467,28,57,.491,15,35,.429,21,24,.875,122,34,85,.400,26,60,.433,8,25,.320,21,25,.840,97
436,DET,2022-03-23,122,,ATL,W 122-101,240,44,88,.500,32,55,.582,12,33,.364,22,25,.880,122,37,92,.402,23,48,.479,14,44,.318,13,15,.867,101
437,MEM,2022-03-20,122,@,HOU,W 122-98,240,46,96,.479,30,62,.484,16,34,.471,14,17,.824,122,37,86,.430,27,55,.491,10,31,.323,14,24,.583,98
438,SAS,2022-03-16,122,,OKC,W 122-120,240,43,98,.439,24,57,.421,19,41,.463,17,20,.850,122,43,82,.524,30,47,.638,13,35,.371,21,29,.724,120
439,ATL,2022-03-14,122,,POR,W 122-113,240,40,109,.367,28,61,.459,12,48,.250,30,32,.938,122,44,88,.500,34,64,.531,10,24,.417,15,21,.714,113
440,GSW,2022-03-12,122,,MIL,W 122-109,240,45,93,.484,27,48,.563,18,45,.400,14,15,.933,122,38,92,.413,21,48,.438,17,44,.386,16,23,.696,109
441,LAL,2022-03-11,122,,WAS,W 122-109,240,48,91,.527,34,60,.567,14,31,.452,12,17,.706,122,39,85,.459,30,58,.517,9,27,.333,22,33,.667,109
442,PHO,2022-03-06,122,@,MIL,L 122-132,240,50,93,.538,36,62,.581,14,31,.452,8,11,.727,122,47,87,.540,32,55,.582,15,32,.469,23,29,.793,132
443,DAL,2022-03-03,122,,GSW,W 122-113,240,45,85,.529,28,48,.583,17,37,.459,15,20,.750,122,44,81,.543,29,51,.569,15,30,.500,10,13,.769,113
444,IND,2022-03-02,122,@,ORL,W 122-114 (OT),265,41,94,.436,29,57,.509,12,37,.324,28,35,.800,122,44,97,.454,34,65,.523,10,32,.313,16,20,.800,114
445,CLE,2022-02-28,122,,MIN,L 122-127,240,39,74,.527,24,37,.649,15,37,.405,29,34,.853,122,47,86,.547,29,44,.659,18,42,.429,15,19,.789,127
446,POR,2022-02-14,122,@,MIL,W 122-107,240,45,99,.455,27,56,.482,18,43,.419,14,19,.737,122,38,89,.427,25,48,.521,13,41,.317,18,24,.750,107
447,MIN,2022-02-11,122,@,CHI,L 122-134,240,48,96,.500,35,56,.625,13,40,.325,13,16,.813,122,55,87,.632,41,56,.732,14,31,.452,10,13,.769,134
448,LAL,2022-02-05,122,,NYK,W 122-115 (OT),265,48,102,.471,39,68,.574,9,34,.265,17,28,.607,122,39,98,.398,28,60,.467,11,38,.289,26,36,.722,115
449,CHI,2022-02-04,122,@,IND,W 122-115,240,49,90,.544,43,64,.672,6,26,.231,18,23,.783,122,47,95,.495,35,68,.515,12,27,.444,9,9,1.000,115
450,BOS,2022-01-31,122,,MIA,W 122-92,240,44,84,.524,28,42,.667,16,42,.381,18,27,.667,122,34,87,.391,17,43,.395,17,44,.386,7,10,.700,92
451,GSW,2022-01-31,122,@,HOU,W 122-108,240,43,80,.538,26,40,.650,17,40,.425,19,23,.826,122,36,84,.429,20,41,.488,16,43,.372,20,29,.690,108
452,PHI,2022-01-31,122,,MEM,W 122-119 (OT),265,49,100,.490,38,69,.551,11,31,.355,13,15,.867,122,47,102,.461,41,72,.569,6,30,.200,19,28,.679,119
453,IND,2022-01-31,122,,LAC,W 122-116,240,50,95,.526,36,66,.545,14,29,.483,8,12,.667,122,45,96,.469,30,52,.577,15,44,.341,11,13,.846,116
454,CHI,2022-01-28,122,@,SAS,L 122-131,240,46,88,.523,38,58,.655,8,30,.267,22,26,.846,122,50,95,.526,34,58,.586,16,37,.432,15,18,.833,131
455,MEM,2022-01-21,122,@,DEN,W 122-118,240,43,82,.524,32,57,.561,11,25,.440,25,40,.625,122,43,91,.473,30,59,.508,13,32,.406,19,23,.826,118
456,MIN,2022-01-19,122,@,ATL,L 122-134,240,42,97,.433,25,51,.490,17,46,.370,21,29,.724,122,45,86,.523,30,48,.625,15,38,.395,29,33,.879,134
457,WAS,2022-01-11,122,,OKC,W 122-118,240,47,87,.540,36,54,.667,11,33,.333,17,23,.739,122,47,98,.480,36,59,.610,11,39,.282,13,15,.867,118
458,WAS,2022-01-07,122,@,CHI,L 122-130,240,45,88,.511,38,64,.594,7,24,.292,25,26,.962,122,48,91,.527,33,58,.569,15,33,.455,19,21,.905,130
459,TOR,2022-01-07,122,,UTA,W 122-108,240,45,100,.450,33,59,.559,12,41,.293,20,25,.800,122,39,81,.481,22,43,.512,17,38,.447,13,18,.722,108
460,LAL,2022-01-04,122,,SAC,W 122-114,240,49,99,.495,38,67,.567,11,32,.344,13,20,.650,122,43,83,.518,29,49,.592,14,34,.412,14,18,.778,114
461,MIN,2022-01-03,122,@,LAC,W 122-104,240,49,93,.527,33,48,.688,16,45,.356,8,9,.889,122,39,78,.500,28,46,.609,11,32,.344,15,17,.882,104
462,BRK,2021-12-25,122,@,LAL,W 122-115,240,43,89,.483,29,57,.509,14,32,.438,22,27,.815,122,40,96,.417,30,61,.492,10,35,.286,25,28,.893,115
463,IND,2021-12-16,122,,DET,W 122-113,240,45,91,.495,38,59,.644,7,32,.219,25,28,.893,122,40,81,.494,33,56,.589,7,25,.280,26,30,.867,113
464,IND,2021-12-08,122,,NYK,W 122-102,240,46,86,.535,36,59,.610,10,27,.370,20,25,.800,122,36,86,.419,27,56,.482,9,30,.300,21,23,.913,102
465,BOS,2021-11-12,122,,MIL,W 122-113 (OT),265,47,96,.490,35,55,.636,12,41,.293,16,18,.889,122,44,98,.449,28,51,.549,16,47,.340,9,11,.818,113
466,PHI,2021-10-30,122,,ATL,W 122-94,240,46,86,.535,34,48,.708,12,38,.316,18,19,.947,122,36,95,.379,28,73,.384,8,22,.364,14,19,.737,94
467,WAS,2021-10-28,122,,ATL,W 122-111,240,46,99,.465,33,65,.508,13,34,.382,17,21,.810,122,48,88,.545,42,67,.627,6,21,.286,9,14,.643,111
468,UTA,2021-10-28,122,@,HOU,W 122-91,240,41,85,.482,25,39,.641,16,46,.348,24,30,.800,122,31,95,.326,22,51,.431,9,44,.205,20,23,.870,91
469,UTA,2021-10-26,122,,DEN,W 122-110,240,44,85,.518,32,46,.696,12,39,.308,22,29,.759,122,42,83,.506,32,55,.582,10,28,.357,16,24,.667,110
470,ATL,2021-10-25,122,,DET,W 122-104,240,46,90,.511,34,58,.586,12,32,.375,18,21,.857,122,40,91,.440,31,58,.534,9,33,.273,15,18,.833,104
471,IND,2021-10-20,122,@,CHO,L 122-123,240,42,90,.467,25,43,.581,17,47,.362,21,24,.875,122,46,107,.430,33,76,.434,13,31,.419,18,27,.667,123
472,BOS,2022-04-07,121,@,MIL,L 121-127,240,43,87,.494,22,37,.595,21,50,.420,14,19,.737,121,49,97,.505,35,59,.593,14,38,.368,15,21,.714,127
473,SAS,2022-04-07,121,@,MIN,L 121-127,240,43,89,.483,33,61,.541,10,28,.357,25,34,.735,121,41,96,.427,21,43,.488,20,53,.377,25,31,.806,127
474,PHO,2022-04-05,121,,LAL,W 121-110,240,50,102,.490,36,63,.571,14,39,.359,7,9,.778,121,39,86,.453,30,57,.526,9,29,.310,23,30,.767,110
475,UTA,2022-04-05,121,,MEM,W 121-115 (OT),265,40,96,.417,28,58,.483,12,38,.316,29,43,.674,121,39,101,.386,26,70,.371,13,31,.419,24,29,.828,115
476,DET,2022-04-03,121,@,IND,W 121-117,240,43,99,.434,22,58,.379,21,41,.512,14,18,.778,121,45,94,.479,33,56,.589,12,38,.316,15,19,.789,117
477,SAC,2022-03-30,121,@,HOU,W 121-118,240,44,95,.463,37,69,.536,7,26,.269,26,36,.722,121,43,94,.457,30,52,.577,13,42,.310,19,25,.760,118
478,LAC,2022-03-29,121,,UTA,W 121-115,240,41,83,.494,26,47,.553,15,36,.417,24,28,.857,121,43,78,.551,31,47,.660,12,31,.387,17,29,.586,115
479,ATL,2022-03-25,121,,GSW,W 121-110,240,46,89,.517,32,52,.615,14,37,.378,15,19,.789,121,43,90,.478,29,49,.592,14,41,.341,10,13,.769,110
480,NYK,2022-03-23,121,@,CHO,W 121-106,240,43,83,.518,23,38,.605,20,45,.444,15,17,.882,121,42,89,.472,29,43,.674,13,46,.283,9,17,.529,106
481,LAL,2022-03-23,121,,PHI,L 121-126,240,50,97,.515,39,67,.582,11,30,.367,10,16,.625,121,47,91,.516,37,64,.578,10,27,.370,22,28,.786,126
482,UTA,2022-03-18,121,,LAC,W 121-92,240,47,97,.485,31,53,.585,16,44,.364,11,14,.786,121,31,86,.360,20,51,.392,11,35,.314,19,21,.905,92
483,IND,2022-03-18,121,@,HOU,W 121-118,240,47,101,.465,33,58,.569,14,43,.326,13,19,.684,121,39,79,.494,27,52,.519,12,27,.444,28,32,.875,118
484,CHO,2022-03-08,121,,BRK,L 121-132,240,45,92,.489,32,51,.627,13,41,.317,18,22,.818,121,46,82,.561,28,47,.596,18,35,.514,22,29,.759,132
485,PHI,2022-03-07,121,,CHI,W 121-106,240,41,84,.488,29,54,.537,12,30,.400,27,34,.794,121,39,87,.448,31,63,.492,8,24,.333,20,26,.769,106
486,POR,2022-03-05,121,@,MIN,L 121-135,240,40,85,.471,24,47,.511,16,38,.421,25,30,.833,121,48,85,.565,33,48,.688,15,37,.405,24,29,.828,135
487,HOU,2022-02-16,121,@,PHO,L 121-124,240,42,97,.433,29,53,.547,13,44,.295,24,28,.857,121,44,86,.512,37,62,.597,7,24,.292,29,36,.806,124
488,MEM,2022-02-15,121,@,NOP,W 121-109,240,47,94,.500,37,60,.617,10,34,.294,17,27,.630,121,44,88,.500,40,62,.645,4,26,.154,17,20,.850,109
489,DEN,2022-02-14,121,,ORL,W 121-111,240,42,88,.477,26,48,.542,16,40,.400,21,23,.913,121,40,91,.440,29,52,.558,11,39,.282,20,23,.870,111
490,ATL,2022-02-11,121,,SAS,L 121-136,240,47,103,.456,33,60,.550,14,43,.326,13,15,.867,121,50,90,.556,32,58,.552,18,32,.563,18,21,.857,136
491,CHI,2022-02-09,121,@,CHO,W 121-109,240,46,82,.561,30,49,.612,16,33,.485,13,19,.684,121,40,93,.430,27,50,.540,13,43,.302,16,23,.696,109
492,MIA,2022-02-07,121,@,WAS,W 121-100,240,43,76,.566,25,44,.568,18,32,.563,17,21,.810,121,36,80,.450,29,49,.592,7,31,.226,21,23,.913,100
493,PHO,2022-02-01,121,,BRK,W 121-111,240,42,76,.553,31,45,.689,11,31,.355,26,31,.839,121,40,81,.494,24,41,.585,16,40,.400,15,21,.714,111
494,LAL,2022-01-30,121,@,ATL,L 121-129,240,47,87,.540,32,52,.615,15,35,.429,12,23,.522,121,49,84,.583,39,53,.736,10,31,.323,21,32,.656,129
495,MIA,2022-01-28,121,,LAC,W 121-114,240,40,85,.471,25,51,.490,15,34,.441,26,27,.963,121,41,92,.446,32,57,.561,9,35,.257,23,32,.719,114
496,ATL,2022-01-26,121,,SAC,W 121-104,240,48,90,.533,36,54,.667,12,36,.333,13,17,.765,121,39,93,.419,27,53,.509,12,40,.300,14,19,.737,104
497,CHO,2022-01-21,121,,OKC,W 121-98,240,45,99,.455,28,50,.560,17,49,.347,14,20,.700,121,37,98,.378,25,54,.463,12,44,.273,12,15,.800,98
498,IND,2022-01-20,121,@,GSW,W 121-117 (OT),265,41,95,.432,26,60,.433,15,35,.429,24,34,.706,121,42,94,.447,33,52,.635,9,42,.214,24,29,.828,117
499,ATL,2022-01-17,121,,MIL,W 121-114,240,38,86,.442,23,50,.460,15,36,.417,30,32,.938,121,39,88,.443,23,50,.460,16,38,.421,20,24,.833,114
500,PHO,2022-01-17,121,@,SAS,W 121-107,240,49,95,.516,40,63,.635,9,32,.281,14,20,.700,121,41,92,.446,32,62,.516,9,30,.300,16,22,.727,107
501,BRK,2022-01-09,121,,SAS,W 121-119 (OT),265,47,98,.480,39,70,.557,8,28,.286,19,22,.864,121,46,107,.430,33,75,.440,13,32,.406,14,18,.778,119
502,DEN,2022-01-07,121,,SAC,W 121-111,240,47,85,.553,35,51,.686,12,34,.353,15,24,.625,121,40,92,.435,29,63,.460,11,29,.379,20,24,.833,111
503,MIL,2022-01-07,121,@,BRK,W 121-109,240,44,96,.458,28,51,.549,16,45,.356,17,21,.810,121,42,92,.457,36,65,.554,6,27,.222,19,20,.950,109
504,IND,2022-01-05,121,,BRK,L 121-129,240,41,82,.500,28,43,.651,13,39,.333,26,28,.929,121,49,86,.570,44,65,.677,5,21,.238,26,29,.897,129
505,CHO,2022-01-03,121,@,WAS,L 121-124,240,50,104,.481,36,66,.545,14,38,.368,7,13,.538,121,40,87,.460,24,49,.490,16,38,.421,28,31,.903,124
506,ATL,2021-12-31,121,@,CLE,W 121-118,240,43,97,.443,27,59,.458,16,38,.421,19,21,.905,121,48,84,.571,40,59,.678,8,25,.320,14,24,.583,118
507,SAC,2021-12-19,121,,SAS,W 121-114,240,46,91,.505,32,66,.485,14,25,.560,15,18,.833,121,45,91,.495,33,66,.500,12,25,.480,12,13,.923,114
508,NYK,2021-12-07,121,@,SAS,W 121-109,240,43,91,.473,25,53,.472,18,38,.474,17,19,.895,121,41,92,.446,29,61,.475,12,31,.387,15,20,.750,109
509,ATL,2021-12-06,121,@,MIN,W 121-110,240,40,90,.444,15,41,.366,25,49,.510,16,19,.842,121,39,98,.398,22,58,.379,17,40,.425,15,19,.789,110
510,MIN,2021-11-27,121,@,PHI,W 121-120 (2OT),290,48,96,.500,34,60,.567,14,36,.389,11,16,.688,121,39,93,.419,27,59,.458,12,34,.353,30,39,.769,120
511,POR,2021-11-24,121,@,SAC,L 121-125,240,44,94,.468,32,56,.571,12,38,.316,21,25,.840,121,45,86,.523,33,53,.623,12,33,.364,23,34,.676,125
512,LAL,2021-11-21,121,@,DET,W 121-116,240,45,92,.489,35,61,.574,10,31,.323,21,27,.778,121,43,97,.443,29,57,.509,14,40,.350,16,21,.762,116
513,CHO,2021-11-19,121,,IND,W 121-118,240,44,81,.543,32,50,.640,12,31,.387,21,28,.750,121,41,88,.466,30,52,.577,11,36,.306,25,32,.781,118
514,CHI,2021-11-15,121,@,LAL,W 121-103,240,49,89,.551,34,55,.618,15,34,.441,8,11,.727,121,36,79,.456,30,47,.638,6,32,.188,25,31,.806,103
515,TOR,2021-11-13,121,,DET,L 121-127,240,44,87,.506,31,53,.585,13,34,.382,20,31,.645,121,43,79,.544,28,44,.636,15,35,.429,26,30,.867,127
516,PHO,2021-11-06,121,,ATL,W 121-117,240,45,88,.511,31,45,.689,14,43,.326,17,21,.810,121,42,97,.433,29,64,.453,13,33,.394,20,23,.870,117
517,SAS,2021-10-26,121,,LAL,L 121-125 (OT),265,48,108,.444,35,72,.486,13,36,.361,12,22,.545,121,50,105,.476,42,75,.560,8,30,.267,17,22,.773,125
518,LAL,2021-10-24,121,,MEM,W 121-118,240,45,84,.536,29,54,.537,16,30,.533,15,22,.682,121,45,100,.450,32,65,.492,13,35,.371,15,18,.833,118
519,MIL,2021-10-23,121,@,SAS,W 121-111,240,44,83,.530,29,48,.604,15,35,.429,18,22,.818,121,48,99,.485,38,60,.633,10,39,.256,5,6,.833,111
520,NYK,2021-10-22,121,@,ORL,W 121-96,240,44,88,.500,20,34,.588,24,54,.444,9,17,.529,121,33,83,.398,16,40,.400,17,43,.395,13,15,.867,96
521,CLE,2021-10-20,121,@,MEM,L 121-132,240,47,93,.505,33,55,.600,14,38,.368,13,18,.722,121,53,100,.530,39,67,.582,14,33,.424,12,12,1.000,132
522,POR,2021-10-20,121,,SAC,L 121-124,240,45,93,.484,33,58,.569,12,35,.343,19,22,.864,121,42,92,.457,25,51,.490,17,41,.415,23,29,.793,124
523,GSW,2021-10-19,121,@,LAL,W 121-114,240,41,93,.441,27,54,.500,14,39,.359,25,30,.833,121,45,95,.474,30,53,.566,15,42,.357,9,19,.474,114
524,SAS,2022-04-10,120,@,DAL,L 120-130,240,43,89,.483,32,58,.552,11,31,.355,23,23,1.000,120,46,85,.541,26,49,.531,20,36,.556,18,23,.783,130
525,MIN,2022-04-10,120,,CHI,L 120-124,240,46,91,.505,35,60,.583,11,31,.355,17,22,.773,120,44,83,.530,34,62,.548,10,21,.476,26,33,.788,124
526,IND,2022-04-09,120,@,PHI,L 120-133,240,41,78,.526,31,55,.564,10,23,.435,28,36,.778,120,50,90,.556,38,56,.679,12,34,.353,21,27,.778,133
527,LAL,2022-04-08,120,,OKC,W 120-101,240,41,82,.500,32,51,.627,9,31,.290,29,39,.744,120,40,88,.455,34,59,.576,6,29,.207,15,19,.789,101
528,ORL,2022-04-05,120,,CLE,W 120-115,240,47,93,.505,31,58,.534,16,35,.457,10,15,.667,120,42,86,.488,26,50,.520,16,36,.444,15,22,.682,115
529,MIL,2022-03-31,120,@,BRK,W 120-119 (OT),265,40,89,.449,28,48,.583,12,41,.293,28,34,.824,120,45,97,.464,27,60,.450,18,37,.486,11,16,.688,119
530,DAL,2022-03-30,120,@,CLE,W 120-112,240,46,88,.523,30,46,.652,16,42,.381,12,15,.800,120,42,83,.506,31,58,.534,11,25,.440,17,22,.773,112
531,HOU,2022-03-28,120,,SAS,L 120-123,240,38,92,.413,18,43,.419,20,49,.408,24,28,.857,120,47,100,.470,40,71,.563,7,29,.241,22,28,.786,123
532,BRK,2022-03-23,120,@,MEM,L 120-132,240,43,87,.494,34,62,.548,9,25,.360,25,27,.926,120,47,101,.465,28,63,.444,19,38,.500,19,22,.864,132
533,CLE,2022-03-21,120,,LAL,L 120-131,240,45,86,.523,31,47,.660,14,39,.359,16,19,.842,120,53,94,.564,41,62,.661,12,32,.375,13,16,.813,131
534,ATL,2022-03-18,120,,MEM,W 120-105,240,45,91,.495,32,63,.508,13,28,.464,17,21,.810,120,40,86,.465,32,64,.500,8,22,.364,17,23,.739,105
535,MIA,2022-03-18,120,,OKC,W 120-108,240,46,95,.484,28,44,.636,18,51,.353,10,12,.833,120,40,84,.476,30,50,.600,10,34,.294,18,23,.783,108
536,ORL,2022-03-17,120,,DET,L 120-134,240,47,97,.485,36,67,.537,11,30,.367,15,21,.714,120,47,94,.500,27,51,.529,20,43,.465,20,31,.645,134
537,OKC,2022-03-16,120,@,SAS,L 120-122,240,43,82,.524,30,47,.638,13,35,.371,21,29,.724,120,43,98,.439,24,57,.421,19,41,.463,17,20,.850,122
538,CLE,2022-03-14,120,,LAC,W 120-111 (OT),265,41,86,.477,26,56,.464,15,30,.500,23,32,.719,120,43,98,.439,31,62,.500,12,36,.333,13,17,.765,111
539,NOP,2022-03-11,120,,CHO,L 120-142,240,43,86,.500,28,47,.596,15,39,.385,19,25,.760,120,52,87,.598,30,40,.750,22,47,.468,16,20,.800,142
540,BRK,2022-03-06,120,@,BOS,L 120-126,240,45,89,.506,33,62,.532,12,27,.444,18,20,.900,120,40,83,.482,23,47,.489,17,36,.472,29,38,.763,126
541,BOS,2022-03-03,120,,MEM,W 120-107,240,46,89,.517,30,52,.577,16,37,.432,12,15,.800,120,42,99,.424,29,59,.492,13,40,.325,10,13,.769,107
542,PHO,2022-03-02,120,,POR,W 120-90,240,40,80,.500,26,44,.591,14,36,.389,26,31,.839,120,30,78,.385,19,47,.404,11,31,.355,19,25,.760,90
543,MIL,2022-03-02,120,,MIA,W 120-119,240,41,91,.451,27,55,.491,14,36,.389,24,27,.889,120,44,97,.454,23,53,.434,21,44,.477,10,12,.833,119
544,MIL,2022-02-17,120,,PHI,L 120-123,240,42,95,.442,28,51,.549,14,44,.318,22,28,.786,120,44,88,.500,32,54,.593,12,34,.353,23,27,.852,123
545,CHO,2022-02-15,120,@,MIN,L 120-126 (OT),265,42,102,.412,34,69,.493,8,33,.242,28,37,.757,120,43,109,.394,30,54,.556,13,55,.236,27,43,.628,126
546,CHI,2022-02-14,120,,SAS,W 120-109,240,46,88,.523,36,64,.563,10,24,.417,18,21,.857,120,44,92,.478,38,72,.528,6,20,.300,15,21,.714,109
547,NOP,2022-02-14,120,,TOR,W 120-90,240,45,77,.584,29,42,.690,16,35,.457,14,16,.875,120,29,95,.305,21,61,.344,8,34,.235,24,31,.774,90
548,IND,2022-02-13,120,,MIN,L 120-129,240,45,102,.441,32,57,.561,13,45,.289,17,22,.773,120,43,84,.512,25,50,.500,18,34,.529,25,28,.893,129
549,CLE,2022-02-11,120,@,IND,W 120-113,240,43,81,.531,34,57,.596,9,24,.375,25,30,.833,120,42,89,.472,24,51,.471,18,38,.474,11,16,.688,113
550,HOU,2022-02-10,120,,TOR,L 120-139,240,43,82,.524,27,44,.614,16,38,.421,18,30,.600,120,53,97,.546,38,58,.655,15,39,.385,18,22,.818,139
551,NOP,2022-02-06,120,@,HOU,W 120-107,240,41,77,.532,29,48,.604,12,29,.414,26,36,.722,120,40,84,.476,24,39,.615,16,45,.356,11,16,.688,107
552,CHI,2022-02-03,120,@,TOR,L 120-127 (OT),265,43,90,.478,31,61,.508,12,29,.414,22,24,.917,120,48,113,.425,34,77,.442,14,36,.389,17,19,.895,127
553,MEM,2022-02-02,120,@,NYK,W 120-108,240,44,102,.431,28,63,.444,16,39,.410,16,23,.696,120,38,88,.432,26,52,.500,12,36,.333,20,26,.769,108
554,OKC,2022-02-02,120,@,DAL,W 120-114 (OT),265,41,86,.477,24,49,.490,17,37,.459,21,25,.840,120,46,98,.469,32,55,.582,14,43,.326,8,10,.800,114
555,SAS,2022-02-01,120,,GSW,L 120-124,240,46,83,.554,30,50,.600,16,33,.485,12,17,.706,120,43,96,.448,23,50,.460,20,46,.435,18,18,1.000,124
556,MIA,2022-01-29,120,,TOR,L 120-124 (3OT),315,45,110,.409,29,60,.483,16,50,.320,14,20,.700,120,47,107,.439,31,62,.500,16,45,.356,14,18,.778,124
557,BRK,2022-01-15,120,,NOP,W 120-105,240,46,84,.548,34,57,.596,12,27,.444,16,17,.941,120,40,87,.460,31,56,.554,9,31,.290,16,24,.667,105
558,TOR,2022-01-02,120,,NYK,W 120-105,240,41,86,.477,28,52,.538,13,34,.382,25,30,.833,120,35,78,.449,23,42,.548,12,36,.333,23,28,.821,105
559,LAC,2022-01-01,120,@,BRK,W 120-116,240,42,86,.488,28,50,.560,14,36,.389,22,31,.710,120,42,97,.433,31,64,.484,11,33,.333,21,25,.840,116
560,CHI,2022-01-01,120,@,WAS,W 120-119,240,41,84,.488,24,50,.480,17,34,.500,21,25,.840,120,46,87,.529,40,60,.667,6,27,.222,21,26,.808,119
561,UTA,2021-12-31,120,,MIN,W 120-108,240,37,78,.474,26,49,.531,11,29,.379,35,41,.854,120,40,93,.430,26,52,.500,14,41,.341,14,22,.636,108
562,MIA,2021-12-31,120,@,HOU,W 120-110,240,40,86,.465,26,53,.491,14,33,.424,26,31,.839,120,41,93,.441,27,51,.529,14,42,.333,14,17,.824,110
563,UTA,2021-12-29,120,@,POR,W 120-105,240,46,87,.529,38,58,.655,8,29,.276,20,32,.625,120,37,88,.420,23,48,.479,14,40,.350,17,24,.708,105
564,UTA,2021-12-25,120,,DAL,W 120-116,240,40,90,.444,28,54,.519,12,36,.333,28,37,.757,120,38,89,.427,28,59,.475,10,30,.333,30,35,.857,116
565,DAL,2021-12-13,120,,CHO,W 120-96,240,43,83,.518,24,42,.571,19,41,.463,15,17,.882,120,34,86,.395,21,49,.429,13,37,.351,15,24,.625,96
566,DEN,2021-12-08,120,@,NOP,W 120-114 (OT),265,45,88,.511,36,56,.643,9,32,.281,21,27,.778,120,47,90,.522,36,60,.600,11,30,.367,9,12,.750,114
567,DEN,2021-11-29,120,@,MIA,W 120-111,240,43,74,.581,25,39,.641,18,35,.514,16,21,.762,120,43,91,.473,28,47,.596,15,44,.341,10,15,.667,111
568,WAS,2021-11-27,120,@,DAL,W 120-114,240,45,78,.577,36,54,.667,9,24,.375,21,26,.808,120,42,89,.472,28,51,.549,14,38,.368,16,22,.727,114
569,PHI,2021-11-27,120,,MIN,L 120-121 (2OT),290,39,93,.419,27,59,.458,12,34,.353,30,39,.769,120,48,96,.500,34,60,.567,14,36,.389,11,16,.688,121
570,MIL,2021-11-26,120,@,DEN,W 120-109,240,46,73,.630,30,40,.750,16,33,.485,12,20,.600,120,40,92,.435,23,45,.511,17,47,.362,12,14,.857,109
571,PHO,2021-11-24,120,@,CLE,W 120-115,240,45,86,.523,37,64,.578,8,22,.364,22,28,.786,120,43,97,.443,31,58,.534,12,39,.308,17,25,.680,115
572,MEM,2021-11-18,120,,LAC,W 120-108,240,52,96,.542,41,70,.586,11,26,.423,5,6,.833,120,42,90,.467,26,51,.510,16,39,.410,8,8,1.000,108
573,UTA,2021-11-16,120,,PHI,W 120-85,240,46,89,.517,30,51,.588,16,38,.421,12,19,.632,120,33,90,.367,27,61,.443,6,29,.207,13,17,.765,85
574,ATL,2021-11-14,120,,MIL,W 120-100,240,47,97,.485,32,62,.516,15,35,.429,11,13,.846,120,38,84,.452,24,43,.558,14,41,.341,10,16,.625,100
575,BRK,2021-11-14,120,@,OKC,W 120-96,240,41,82,.500,23,39,.590,18,43,.419,20,21,.952,120,36,90,.400,22,45,.489,14,45,.311,10,11,.909,96
576,BRK,2021-11-12,120,@,NOP,W 120-112,240,41,82,.500,23,48,.479,18,34,.529,20,27,.741,120,43,88,.489,30,56,.536,13,32,.406,13,16,.813,112
577,LAL,2021-11-10,120,,MIA,W 120-117 (OT),265,46,92,.500,28,54,.519,18,38,.474,10,16,.625,120,40,96,.417,30,59,.508,10,37,.270,27,35,.771,117
578,LAC,2021-11-07,120,,CHO,W 120-106,240,41,86,.477,23,38,.605,18,48,.375,20,21,.952,120,41,101,.406,31,68,.456,10,33,.303,14,18,.778,106
579,GSW,2021-11-07,120,,HOU,W 120-107,240,44,85,.518,29,39,.744,15,46,.326,17,20,.850,120,36,79,.456,26,46,.565,10,33,.303,25,37,.676,107
580,CHO,2021-10-27,120,@,ORL,W 120-111,240,43,83,.518,29,53,.547,14,30,.467,20,24,.833,120,43,88,.489,28,48,.583,15,40,.375,10,13,.769,111
581,MEM,2021-10-23,120,@,LAC,W 120-114,240,42,90,.467,27,54,.500,15,36,.417,21,25,.840,120,43,99,.434,30,60,.500,13,39,.333,15,17,.882,114
582,TOR,2022-04-07,119,,PHI,W 119-114,240,45,91,.495,30,58,.517,15,33,.455,14,18,.778,119,37,75,.493,18,39,.462,19,36,.528,21,25,.840,114
583,LAC,2022-04-03,119,,NOP,W 119-100,240,45,95,.474,24,51,.471,21,44,.477,8,10,.800,119,35,87,.402,26,63,.413,9,24,.375,21,27,.778,100
584,CLE,2022-04-02,119,@,NYK,W 119-101,240,44,81,.543,29,47,.617,15,34,.441,16,21,.762,119,31,77,.403,18,47,.383,13,30,.433,26,34,.765,101
585,MIL,2022-04-01,119,,LAC,L 119-153,240,50,94,.532,42,69,.609,8,25,.320,11,18,.611,119,56,92,.609,33,49,.673,23,43,.535,18,24,.750,153
586,BRK,2022-03-31,119,,MIL,L 119-120 (OT),265,45,97,.464,27,60,.450,18,37,.486,11,16,.688,119,40,89,.449,28,48,.583,12,41,.293,28,34,.824,120
587,CHO,2022-03-27,119,@,BRK,W 119-110,240,42,98,.429,25,66,.379,17,32,.531,18,23,.783,119,43,97,.443,36,63,.571,7,34,.206,17,26,.654,110
588,POR,2022-03-21,119,@,DET,W 119-115,240,37,88,.420,29,60,.483,8,28,.286,37,49,.755,119,36,85,.424,27,50,.540,9,35,.257,34,41,.829,115
589,MIL,2022-03-19,119,@,MIN,L 119-138,240,43,97,.443,24,45,.533,19,52,.365,14,17,.824,119,47,92,.511,25,45,.556,22,47,.468,22,26,.846,138
590,LAL,2022-03-19,119,@,WAS,L 119-127,240,48,91,.527,35,56,.625,13,35,.371,10,11,.909,119,44,85,.518,31,54,.574,13,31,.419,26,31,.839,127
591,CLE,2022-03-18,119,,DEN,W 119-116 (OT),265,44,98,.449,30,61,.492,14,37,.378,17,26,.654,119,46,92,.500,36,59,.610,10,33,.303,14,18,.778,116
592,IND,2022-03-12,119,@,SAS,W 119-108,240,45,92,.489,31,56,.554,14,36,.389,15,15,1.000,119,42,102,.412,31,68,.456,11,34,.324,13,16,.813,108
593,TOR,2022-03-09,119,@,SAS,W 119-104,240,41,85,.482,30,55,.545,11,30,.367,26,28,.929,119,38,84,.452,29,52,.558,9,32,.281,19,20,.950,104
594,CLE,2022-03-04,119,@,PHI,L 119-125,240,44,82,.537,34,54,.630,10,28,.357,21,24,.875,119,41,75,.547,27,42,.643,14,33,.424,29,32,.906,125
595,OKC,2022-03-02,119,@,DEN,W 119-107,240,44,87,.506,28,58,.483,16,29,.552,15,21,.714,119,40,90,.444,28,44,.636,12,46,.261,15,17,.882,107
596,CHO,2022-03-02,119,@,CLE,W 119-98,240,43,85,.506,26,47,.553,17,38,.447,16,22,.727,119,37,79,.468,27,48,.563,10,31,.323,14,21,.667,98
597,MIA,2022-03-02,119,@,MIL,L 119-120,240,44,97,.454,23,53,.434,21,44,.477,10,12,.833,119,41,91,.451,27,55,.491,14,36,.389,24,27,.889,120
598,ORL,2022-02-28,119,,IND,W 119-103,240,45,96,.469,33,59,.559,12,37,.324,17,22,.773,119,35,72,.486,20,36,.556,15,36,.417,18,25,.720,103
599,ORL,2022-02-25,119,,HOU,W 119-111,240,42,83,.506,29,47,.617,13,36,.361,22,29,.759,119,44,94,.468,30,47,.638,14,47,.298,9,20,.450,111
600,MIN,2022-02-24,119,,MEM,W 119-114,240,43,93,.462,27,51,.529,16,42,.381,17,25,.680,119,38,98,.388,29,67,.433,9,31,.290,29,40,.725,114
601,MEM,2022-02-16,119,,POR,L 119-123,240,37,85,.435,26,55,.473,11,30,.367,34,42,.810,119,43,85,.506,30,53,.566,13,32,.406,24,32,.750,123
602,IND,2022-02-15,119,@,MIL,L 119-128,240,47,93,.505,30,52,.577,17,41,.415,8,19,.421,119,48,86,.558,38,57,.667,10,29,.345,22,30,.733,128
603,LAC,2022-02-14,119,,GSW,W 119-104,240,48,85,.565,33,51,.647,15,34,.441,8,15,.533,119,39,86,.453,23,45,.511,16,41,.390,10,13,.769,104
604,DET,2022-02-11,119,,CHO,L 119-141,240,48,102,.471,36,67,.537,12,35,.343,11,18,.611,119,54,97,.557,36,55,.655,18,42,.429,15,23,.652,141
605,MIN,2022-02-09,119,@,SAC,L 119-132,240,44,98,.449,28,52,.538,16,46,.348,15,18,.833,119,48,93,.516,36,63,.571,12,30,.400,24,27,.889,132
606,PHI,2022-02-06,119,@,CHI,W 119-108,240,45,84,.536,33,60,.550,12,24,.500,17,21,.810,119,39,81,.481,32,55,.582,7,26,.269,23,26,.885,108
607,ORL,2022-02-02,119,@,IND,W 119-118,240,42,95,.442,31,60,.517,11,35,.314,24,26,.923,119,44,98,.449,30,66,.455,14,32,.438,16,23,.696,118
608,MEM,2022-01-31,119,@,PHI,L 119-122 (OT),265,47,102,.461,41,72,.569,6,30,.200,19,28,.679,119,49,100,.490,38,69,.551,11,31,.355,13,15,.867,122
609,MEM,2022-01-28,119,,UTA,W 119-109,240,46,82,.561,37,59,.627,9,23,.391,18,24,.750,119,37,85,.435,20,39,.513,17,46,.370,18,21,.857,109
610,ORL,2022-01-28,119,,DET,W 119-103,240,41,83,.494,29,58,.500,12,25,.480,25,26,.962,119,32,87,.368,22,58,.379,10,29,.345,29,37,.784,103
611,BRK,2022-01-19,119,@,WAS,W 119-118,240,47,89,.528,39,64,.609,8,25,.320,17,20,.850,119,41,86,.477,31,57,.544,10,29,.345,26,32,.813,118
612,MEM,2022-01-17,119,,CHI,W 119-106,240,47,92,.511,37,67,.552,10,25,.400,15,20,.750,119,40,92,.435,27,61,.443,13,31,.419,13,15,.867,106
613,MIN,2022-01-16,119,,GSW,W 119-99,240,45,91,.495,29,48,.604,16,43,.372,13,20,.650,119,32,82,.390,19,40,.475,13,42,.310,22,29,.759,99
614,BOS,2022-01-12,119,@,IND,W 119-100,240,40,78,.513,22,40,.550,18,38,.474,21,25,.840,119,40,86,.465,33,50,.660,7,36,.194,13,20,.650,100
615,LAL,2022-01-09,119,,MEM,L 119-127,240,45,97,.464,31,64,.484,14,33,.424,15,19,.789,119,47,86,.547,36,56,.643,11,30,.367,22,32,.688,127
616,SAS,2022-01-09,119,@,BRK,L 119-121 (OT),265,46,107,.430,33,75,.440,13,32,.406,14,18,.778,119,47,98,.480,39,70,.557,8,28,.286,19,22,.864,121
617,PHI,2022-01-07,119,,SAS,W 119-100,240,45,87,.517,37,64,.578,8,23,.348,21,27,.778,119,38,92,.413,29,62,.468,9,30,.300,15,20,.750,100
618,WAS,2022-01-01,119,,CHI,L 119-120,240,46,87,.529,40,60,.667,6,27,.222,21,26,.808,119,41,84,.488,24,50,.480,17,34,.500,21,25,.840,120
619,MIA,2021-12-28,119,,WAS,W 119-112,240,41,92,.446,25,58,.431,16,34,.471,21,23,.913,119,42,85,.494,25,43,.581,17,42,.405,11,14,.786,112
620,CLE,2021-12-18,119,@,MIL,W 119-90,240,45,90,.500,29,45,.644,16,45,.356,13,14,.929,119,35,89,.393,23,51,.451,12,38,.316,8,11,.727,90
621,TOR,2021-12-18,119,,GSW,W 119-100,240,45,90,.500,31,52,.596,14,38,.368,15,23,.652,119,37,79,.468,26,43,.605,11,36,.306,15,21,.714,100
622,SAC,2021-12-15,119,,WAS,W 119-105,240,45,82,.549,37,56,.661,8,26,.308,21,29,.724,119,42,89,.472,37,65,.569,5,24,.208,16,21,.762,105
623,WAS,2021-12-08,119,@,DET,W 119-116 (OT),265,42,88,.477,30,56,.536,12,32,.375,23,28,.821,119,37,79,.468,24,55,.436,13,24,.542,29,35,.829,116
624,LAC,2021-12-03,119,@,LAL,W 119-115,240,41,81,.506,25,46,.543,16,35,.457,21,24,.875,119,45,90,.500,33,57,.579,12,33,.364,13,21,.619,115
625,CHI,2021-12-02,119,@,NYK,W 119-115,240,44,89,.494,33,60,.550,11,29,.379,20,21,.952,119,42,82,.512,33,56,.589,9,26,.346,22,27,.815,115
626,CHO,2021-11-29,119,@,CHI,L 119-133,240,42,88,.477,24,49,.490,18,39,.462,17,21,.810,119,53,89,.596,39,59,.661,14,30,.467,13,19,.684,133
627,POR,2021-11-23,119,,DEN,W 119-100,240,45,88,.511,30,49,.612,15,39,.385,14,20,.700,119,38,78,.487,23,45,.511,15,33,.455,9,11,.818,100
628,MEM,2021-11-22,119,@,UTA,W 119-118,240,42,95,.442,29,60,.483,13,35,.371,22,27,.815,119,41,87,.471,24,44,.545,17,43,.395,19,25,.760,118
629,GSW,2021-11-21,119,,TOR,W 119-104,240,39,79,.494,17,34,.500,22,45,.489,19,24,.792,119,39,99,.394,24,62,.387,15,37,.405,11,20,.550,104
630,UTA,2021-11-18,119,,TOR,W 119-103,240,44,80,.550,25,34,.735,19,46,.413,12,13,.923,119,39,94,.415,29,56,.518,10,38,.263,15,17,.882,103
631,GSW,2021-11-12,119,,CHI,W 119-93,240,45,93,.484,30,47,.638,15,46,.326,14,16,.875,119,34,78,.436,26,51,.510,8,27,.296,17,22,.773,93
632,PHO,2021-11-12,119,@,MEM,W 119-94,240,46,94,.489,28,57,.491,18,37,.486,9,9,1.000,119,37,98,.378,30,65,.462,7,33,.212,13,23,.565,94
633,PHO,2021-11-10,119,,POR,W 119-109,240,49,94,.521,38,66,.576,11,28,.393,10,12,.833,119,44,91,.484,37,61,.607,7,30,.233,14,16,.875,109
634,LAL,2021-11-02,119,,HOU,W 119-117,240,49,93,.527,43,68,.632,6,25,.240,15,20,.750,119,48,91,.527,32,49,.653,16,42,.381,5,12,.417,117
635,UTA,2021-11-02,119,,SAC,W 119-113,240,43,98,.439,29,50,.580,14,48,.292,19,27,.704,119,42,93,.452,30,62,.484,12,31,.387,17,24,.708,113
636,MIL,2021-10-25,119,@,IND,W 119-109,240,41,85,.482,30,53,.566,11,32,.344,26,31,.839,119,40,90,.444,26,54,.481,14,36,.389,15,17,.882,109
637,GSW,2021-10-24,119,@,SAC,W 119-107,240,43,97,.443,30,60,.500,13,37,.351,20,24,.833,119,42,86,.488,27,40,.675,15,46,.326,8,13,.615,107
638,PHI,2022-04-10,118,,DET,W 118-106,240,46,88,.523,41,63,.651,5,25,.200,21,23,.913,118,38,83,.458,27,49,.551,11,34,.324,19,29,.655,106
639,BRK,2022-04-08,118,,CLE,W 118-107,240,43,92,.467,31,60,.517,12,32,.375,20,21,.952,118,40,82,.488,32,55,.582,8,27,.296,19,24,.792,107
640,ATL,2022-04-06,118,,WAS,W 118-103,240,43,92,.467,27,53,.509,16,39,.410,16,19,.842,118,42,86,.488,32,51,.627,10,35,.286,9,11,.818,103
641,TOR,2022-04-05,118,,ATL,W 118-108,240,44,101,.436,35,66,.530,9,35,.257,21,31,.677,118,43,94,.457,29,57,.509,14,37,.378,8,12,.667,108
642,BRK,2022-04-05,118,,HOU,W 118-105,240,39,86,.453,24,49,.490,15,37,.405,25,27,.926,118,40,99,.404,29,56,.518,11,43,.256,14,25,.560,105
643,LAL,2022-04-03,118,,DEN,L 118-129,240,49,92,.533,43,72,.597,6,20,.300,14,21,.667,118,47,82,.573,35,51,.686,12,31,.387,23,29,.793,129
644,NYK,2022-04-03,118,@,ORL,W 118-88,240,45,93,.484,30,49,.612,15,44,.341,13,16,.813,118,30,85,.353,18,41,.439,12,44,.273,16,27,.593,88
645,DAL,2022-04-03,118,@,MIL,W 118-112,240,39,76,.513,23,38,.605,16,38,.421,24,27,.889,118,42,95,.442,27,55,.491,15,40,.375,13,18,.722,112
646,HOU,2022-03-30,118,,SAC,L 118-121,240,43,94,.457,30,52,.577,13,42,.310,19,25,.760,118,44,95,.463,37,69,.536,7,26,.269,26,36,.722,121
647,IND,2022-03-30,118,,DEN,L 118-125,240,44,97,.454,32,57,.561,12,40,.300,18,23,.783,118,50,80,.625,38,52,.731,12,28,.429,13,14,.929,125
648,OKC,2022-03-30,118,,ATL,L 118-136,240,41,87,.471,24,46,.522,17,41,.415,19,27,.704,118,49,91,.538,31,52,.596,18,39,.462,20,22,.909,136
649,MIL,2022-03-29,118,@,PHI,W 118-116,240,44,88,.500,30,50,.600,14,38,.368,16,23,.696,118,43,89,.483,27,48,.563,16,41,.390,14,18,.778,116
650,OKC,2022-03-23,118,,ORL,W 118-102,240,38,79,.481,21,38,.553,17,41,.415,25,30,.833,118,36,93,.387,19,42,.452,17,51,.333,13,16,.813,102
651,GSW,2022-03-23,118,@,MIA,W 118-104,240,40,77,.519,25,41,.610,15,36,.417,23,27,.852,118,37,85,.435,23,49,.469,14,36,.389,16,21,.762,104
652,HOU,2022-03-18,118,,IND,L 118-121,240,39,79,.494,27,52,.519,12,27,.444,28,32,.875,118,47,101,.465,33,58,.569,14,43,.326,13,19,.684,121
653,PHI,2022-03-16,118,@,CLE,W 118-114,240,41,79,.519,29,47,.617,12,32,.375,24,28,.857,118,39,80,.488,30,52,.577,9,28,.321,27,32,.844,114
654,OKC,2022-03-13,118,,MEM,L 118-125,240,41,97,.423,28,56,.500,13,41,.317,23,28,.821,118,48,102,.471,37,73,.507,11,29,.379,18,20,.900,125
655,WAS,2022-03-12,118,@,POR,L 118-127,240,39,83,.470,25,49,.510,14,34,.412,26,27,.963,118,48,93,.516,37,63,.587,11,30,.367,20,22,.909,127
656,MEM,2022-03-11,118,,NYK,W 118-114,240,46,104,.442,37,78,.474,9,26,.346,17,29,.586,118,38,90,.422,28,65,.431,10,25,.400,28,37,.757,114
657,ORL,2022-03-11,118,,MIN,W 118-110,240,40,86,.465,24,46,.522,16,40,.400,22,25,.880,118,41,90,.456,26,45,.578,15,45,.333,13,13,1.000,110
658,MIL,2022-03-04,118,@,CHI,W 118-112,240,43,88,.489,33,57,.579,10,31,.323,22,33,.667,118,47,94,.500,37,68,.544,10,26,.385,8,11,.727,112
659,MEM,2022-02-28,118,,SAS,W 118-105,240,48,89,.539,37,63,.587,11,26,.423,11,19,.579,118,41,99,.414,32,67,.478,9,32,.281,14,19,.737,105
660,UTA,2022-02-27,118,@,PHO,W 118-114,240,44,94,.468,27,54,.500,17,40,.425,13,20,.650,118,44,86,.512,31,58,.534,13,28,.464,13,16,.813,114
661,NOP,2022-02-17,118,,DAL,L 118-125,240,46,92,.500,34,64,.531,12,28,.429,14,21,.667,118,44,82,.537,25,42,.595,19,40,.475,18,25,.720,125
662,SAC,2022-02-16,118,@,CHI,L 118-125,240,43,84,.512,31,54,.574,12,30,.400,20,22,.909,118,47,94,.500,35,65,.538,12,29,.414,19,20,.950,125
663,CHO,2022-02-12,118,,MEM,L 118-125,240,39,97,.402,25,52,.481,14,45,.311,26,33,.788,118,47,96,.490,36,63,.571,11,33,.333,20,33,.606,125
664,MIN,2022-02-06,118,,DET,W 118-105,240,42,91,.462,25,55,.455,17,36,.472,17,21,.810,118,40,95,.421,28,63,.444,12,32,.375,13,19,.684,105
665,IND,2022-02-02,118,,ORL,L 118-119,240,44,98,.449,30,66,.455,14,32,.438,16,23,.696,118,42,95,.442,31,60,.517,11,35,.314,24,26,.923,119
666,MEM,2022-01-26,118,@,SAS,W 118-110,240,46,90,.511,39,67,.582,7,23,.304,19,26,.731,118,43,94,.457,34,57,.596,9,37,.243,15,19,.789,110
667,BRK,2022-01-26,118,,DEN,L 118-124,240,43,88,.489,31,59,.525,12,29,.414,20,26,.769,118,42,89,.472,27,53,.509,15,36,.417,25,27,.926,124
668,DEN,2022-01-21,118,,MEM,L 118-122,240,43,91,.473,30,59,.508,13,32,.406,19,23,.826,118,43,82,.524,32,57,.561,11,25,.440,25,40,.625,122
669,SAS,2022-01-19,118,,OKC,W 118-96,240,47,96,.490,32,56,.571,15,40,.375,9,14,.643,118,38,98,.388,30,67,.448,8,31,.258,12,15,.800,96
670,WAS,2022-01-19,118,,BRK,L 118-119,240,41,86,.477,31,57,.544,10,29,.345,26,32,.813,118,47,89,.528,39,64,.609,8,25,.320,17,20,.850,119
671,HOU,2022-01-16,118,@,SAC,W 118-112,240,41,76,.539,25,36,.694,16,40,.400,20,24,.833,118,41,91,.451,29,53,.547,12,38,.316,18,24,.750,112
672,ATL,2022-01-14,118,@,MIA,L 118-124,240,38,79,.481,22,41,.537,16,38,.421,26,30,.867,118,41,77,.532,27,47,.574,14,30,.467,28,30,.933,124
673,MIL,2022-01-13,118,,GSW,W 118-99,240,44,86,.512,26,45,.578,18,41,.439,12,18,.667,118,33,95,.347,17,47,.362,16,48,.333,17,24,.708,99
674,OKC,2022-01-11,118,@,WAS,L 118-122,240,47,98,.480,36,59,.610,11,39,.282,13,15,.867,118,47,87,.540,36,54,.667,11,33,.333,17,23,.739,122
675,ATL,2022-01-07,118,@,LAL,L 118-134,240,43,96,.448,30,60,.500,13,36,.361,19,27,.704,118,50,101,.495,33,60,.550,17,41,.415,17,19,.895,134
676,MEM,2022-01-06,118,,DET,W 118-88,240,48,98,.490,38,66,.576,10,32,.313,12,19,.632,118,34,99,.343,24,55,.436,10,44,.227,10,13,.769,88
677,MEM,2022-01-03,118,@,BRK,W 118-104,240,48,102,.471,38,67,.567,10,35,.286,12,21,.571,118,37,82,.451,28,51,.549,9,31,.290,21,26,.808,104
678,MEM,2021-12-31,118,,SAS,W 118-105,240,49,102,.480,39,76,.513,10,26,.385,10,16,.625,118,39,90,.433,27,55,.491,12,35,.343,15,24,.625,105
679,CLE,2021-12-31,118,,ATL,L 118-121,240,48,84,.571,40,59,.678,8,25,.320,14,24,.583,118,43,97,.443,27,59,.458,16,38,.421,19,21,.905,121
680,ORL,2021-12-30,118,,MIL,L 118-136,240,42,87,.483,29,51,.569,13,36,.361,21,27,.778,118,45,91,.495,32,58,.552,13,33,.394,33,36,.917,136
681,ATL,2021-12-27,118,,CHI,L 118-130,240,40,89,.449,25,55,.455,15,34,.441,23,26,.885,118,51,94,.543,33,57,.579,18,37,.486,10,14,.714,130
682,IND,2021-12-23,118,,HOU,W 118-106,240,46,88,.523,33,50,.660,13,38,.342,13,19,.684,118,35,80,.438,20,43,.465,15,37,.405,21,26,.808,106
683,HOU,2021-12-20,118,@,CHI,L 118-133,240,44,78,.564,32,45,.711,12,33,.364,18,24,.750,118,47,88,.534,31,53,.585,16,35,.457,23,24,.958,133
684,PHO,2021-12-16,118,,WAS,W 118-98,240,42,79,.532,33,50,.660,9,29,.310,25,26,.962,118,40,82,.488,34,61,.557,6,21,.286,12,19,.632,98
685,MIA,2021-12-11,118,,CHI,W 118-92,240,46,93,.495,27,50,.540,19,43,.442,7,9,.778,118,31,83,.373,14,43,.326,17,40,.425,13,20,.650,92
686,UTA,2021-12-09,118,@,PHI,W 118-96,240,43,91,.473,28,51,.549,15,40,.375,17,24,.708,118,38,88,.432,32,55,.582,6,33,.182,14,15,.933,96
687,HOU,2021-12-05,118,,NOP,W 118-108,240,39,79,.494,22,39,.564,17,40,.425,23,29,.793,118,40,94,.426,30,56,.536,10,38,.263,18,25,.720,108
688,GSW,2021-12-03,118,,PHO,W 118-96,240,45,92,.489,26,53,.491,19,39,.487,9,12,.750,118,31,81,.383,23,59,.390,8,22,.364,26,35,.743,96
689,HOU,2021-12-03,118,,ORL,W 118-116,240,44,92,.478,27,45,.600,17,47,.362,13,15,.867,118,42,86,.488,29,49,.592,13,37,.351,19,21,.905,116
690,MIL,2021-11-28,118,@,IND,W 118-100,240,46,90,.511,38,55,.691,8,35,.229,18,22,.818,118,38,92,.413,26,47,.553,12,45,.267,12,16,.750,100
691,PHO,2021-11-26,118,@,NYK,W 118-97,240,44,79,.557,31,51,.608,13,28,.464,17,21,.810,118,34,92,.370,22,53,.415,12,39,.308,17,22,.773,97
692,GSW,2021-11-26,118,,POR,W 118-103,240,47,87,.540,35,50,.700,12,37,.324,12,16,.750,118,36,86,.419,23,48,.479,13,38,.342,18,23,.783,103
693,HOU,2021-11-24,118,,CHI,W 118-113,240,42,84,.500,25,48,.521,17,36,.472,17,22,.773,118,44,96,.458,29,61,.475,15,35,.429,10,12,.833,113
694,UTA,2021-11-22,118,,MEM,L 118-119,240,41,87,.471,24,44,.545,17,43,.395,19,25,.760,118,42,95,.442,29,60,.483,13,35,.371,22,27,.815,119
695,POR,2021-11-20,118,,PHI,W 118-111,240,40,80,.500,25,46,.543,15,34,.441,23,23,1.000,118,41,81,.506,31,53,.585,10,28,.357,19,21,.905,111
696,IND,2021-11-19,118,@,CHO,L 118-121,240,41,88,.466,30,52,.577,11,36,.306,25,32,.781,118,44,81,.543,32,50,.640,12,31,.387,21,28,.750,121
697,POR,2021-11-15,118,,TOR,W 118-113,240,46,82,.561,30,46,.652,16,36,.444,10,14,.714,118,41,89,.461,26,56,.464,15,33,.455,16,18,.889,113
698,IND,2021-11-13,118,,PHI,W 118-113,240,47,82,.573,33,54,.611,14,28,.500,10,15,.667,118,38,89,.427,26,66,.394,12,23,.522,25,29,.862,113
699,CHO,2021-11-10,118,@,MEM,W 118-108,240,41,90,.456,26,54,.481,15,36,.417,21,24,.875,118,45,107,.421,36,69,.522,9,38,.237,9,15,.600,108
700,MIL,2021-11-09,118,@,PHI,W 118-109,240,44,95,.463,29,56,.518,15,39,.385,15,21,.714,118,42,103,.408,28,60,.467,14,43,.326,11,12,.917,109
701,MIN,2021-11-08,118,@,MEM,L 118-125 (OT),265,41,97,.423,24,52,.462,17,45,.378,19,23,.826,118,46,92,.500,35,64,.547,11,28,.393,22,26,.846,125
702,CHI,2021-11-08,118,,BRK,W 118-95,240,46,98,.469,37,67,.552,9,31,.290,17,20,.850,118,34,86,.395,23,53,.434,11,33,.333,16,19,.842,95
703,MIA,2021-11-06,118,,UTA,W 118-115,240,47,78,.603,36,57,.632,11,21,.524,13,17,.765,118,43,83,.518,28,38,.737,15,45,.333,14,19,.737,115
704,ATL,2021-11-01,118,,WAS,W 118-111,240,38,83,.458,25,49,.510,13,34,.382,29,29,1.000,118,41,86,.477,28,47,.596,13,39,.333,16,16,1.000,111
705,SAS,2021-11-01,118,@,IND,L 118-131,240,47,89,.528,33,61,.541,14,28,.500,10,14,.714,118,52,91,.571,34,53,.642,18,38,.474,9,12,.750,131
706,TOR,2021-10-27,118,,IND,W 118-100,240,46,100,.460,32,70,.457,14,30,.467,12,19,.632,118,38,79,.481,28,50,.560,10,29,.345,14,17,.824,100
707,MEM,2021-10-24,118,@,LAL,L 118-121,240,45,100,.450,32,65,.492,13,35,.371,15,18,.833,118,45,84,.536,29,54,.537,16,30,.533,15,22,.682,121
708,LAC,2022-04-09,117,,SAC,W 117-98,240,42,86,.488,21,43,.488,21,43,.488,12,15,.800,117,38,86,.442,31,58,.534,7,28,.250,15,24,.625,98
709,TOR,2022-04-08,117,,HOU,W 117-115,240,44,96,.458,37,67,.552,7,29,.241,22,23,.957,117,43,81,.531,33,52,.635,10,29,.345,19,24,.792,115
710,CHI,2022-04-08,117,,CHO,L 117-133,240,44,82,.537,31,58,.534,13,24,.542,16,20,.800,117,52,86,.605,33,46,.717,19,40,.475,10,10,1.000,133
711,BOS,2022-04-06,117,@,CHI,W 117-94,240,43,88,.489,26,51,.510,17,37,.459,14,22,.636,117,35,80,.438,28,57,.491,7,23,.304,17,23,.739,94
712,IND,2022-04-03,117,,DET,L 117-121,240,45,94,.479,33,56,.589,12,38,.316,15,19,.789,117,43,99,.434,22,58,.379,21,41,.512,14,18,.778,121
713,OKC,2022-04-03,117,,PHO,W 117-96,240,43,87,.494,26,46,.565,17,41,.415,14,18,.778,117,37,89,.416,30,51,.588,7,38,.184,15,17,.882,96
714,HOU,2022-04-01,117,,SAC,L 117-122,240,41,97,.423,24,52,.462,17,45,.378,18,26,.692,117,42,81,.519,30,53,.566,12,28,.429,26,34,.765,122
715,NOP,2022-03-30,117,@,POR,W 117-107,240,40,78,.513,34,54,.630,6,24,.250,31,39,.795,117,39,85,.459,25,43,.581,14,42,.333,15,18,.833,107
716,TOR,2022-03-24,117,,CLE,W 117-104,240,42,89,.472,26,52,.500,16,37,.432,17,19,.895,117,37,79,.468,25,49,.510,12,30,.400,18,22,.818,104
717,ATL,2022-03-22,117,@,NYK,W 117-111,240,40,81,.494,25,45,.556,15,36,.417,22,27,.815,117,42,86,.488,29,52,.558,13,34,.382,14,26,.538,111
718,NOP,2022-03-20,117,@,ATL,W 117-112,240,43,96,.448,36,75,.480,7,21,.333,24,27,.889,117,41,87,.471,31,55,.564,10,32,.313,20,23,.870,112
719,MIL,2022-03-14,117,@,UTA,W 117-111,240,40,86,.465,28,55,.509,12,31,.387,25,29,.862,117,37,93,.398,20,45,.444,17,48,.354,20,24,.833,111
720,MIA,2022-03-11,117,,CLE,W 117-105,240,41,86,.477,30,51,.588,11,35,.314,24,27,.889,117,35,79,.443,27,54,.500,8,25,.320,27,29,.931,105
721,TOR,2022-03-11,117,@,PHO,W 117-112,240,42,94,.447,28,62,.452,14,32,.438,19,21,.905,117,44,88,.500,33,52,.635,11,36,.306,13,17,.765,112
722,SAS,2022-03-07,117,,LAL,W 117-110,240,46,84,.548,37,58,.638,9,26,.346,16,30,.533,117,43,91,.473,35,65,.538,8,26,.308,16,23,.696,110
723,SAS,2022-03-05,117,@,CHO,L 117-123,240,45,98,.459,34,61,.557,11,37,.297,16,20,.800,117,42,91,.462,26,49,.531,16,42,.381,23,29,.793,123
724,ATL,2022-03-04,117,@,WAS,W 117-114,240,38,91,.418,25,55,.455,13,36,.361,28,34,.824,117,46,85,.541,32,56,.571,14,29,.483,8,9,.889,114
725,NOP,2022-02-25,117,@,PHO,W 117-102,240,38,87,.437,30,58,.517,8,29,.276,33,41,.805,117,36,82,.439,24,42,.571,12,40,.300,18,24,.750,102
726,WAS,2022-02-17,117,@,BRK,W 117-103,240,46,83,.554,34,59,.576,12,24,.500,13,16,.813,117,36,89,.404,22,51,.431,14,38,.368,17,24,.708,103
727,DEN,2022-02-16,117,@,GSW,W 117-116,240,43,91,.473,29,55,.527,14,36,.389,17,21,.810,117,45,87,.517,35,53,.660,10,34,.294,16,24,.667,116
728,GSW,2022-02-12,117,,LAL,W 117-115,240,40,90,.444,28,52,.538,12,38,.316,25,34,.735,117,41,88,.466,30,61,.492,11,27,.407,22,33,.667,115
729,TOR,2022-02-09,117,@,OKC,W 117-98,240,45,88,.511,32,53,.604,13,35,.371,14,14,1.000,117,36,87,.414,22,40,.550,14,47,.298,12,14,.857,98
730,DET,2022-02-03,117,,MIN,L 117-128,240,40,91,.440,25,45,.556,15,46,.326,22,28,.786,117,44,87,.506,29,53,.547,15,34,.441,25,28,.893,128
731,CHO,2022-01-28,117,,LAL,W 117-114,240,43,83,.518,32,47,.681,11,36,.306,20,28,.714,117,38,91,.418,23,51,.451,15,40,.375,23,32,.719,114
732,PHI,2022-01-25,117,,NOP,W 117-107,240,39,84,.464,29,53,.547,10,31,.323,29,31,.935,117,40,83,.482,31,61,.508,9,22,.409,18,26,.692,107
733,NOP,2022-01-24,117,,IND,W 117-113,240,41,88,.466,35,58,.603,6,30,.200,29,31,.935,117,38,87,.437,19,41,.463,19,46,.413,18,25,.720,113
734,DEN,2022-01-23,117,,DET,W 117-111,240,44,85,.518,32,50,.640,12,35,.343,17,23,.739,117,42,75,.560,31,46,.674,11,29,.379,16,19,.842,111
735,BRK,2022-01-21,117,@,SAS,W 117-102,240,48,100,.480,39,75,.520,9,25,.360,12,12,1.000,117,37,95,.389,29,66,.439,8,29,.276,20,24,.833,102
736,GSW,2022-01-20,117,,IND,L 117-121 (OT),265,42,94,.447,33,52,.635,9,42,.214,24,29,.828,117,41,95,.432,26,60,.433,15,35,.429,24,34,.706,121
737,CHI,2022-01-19,117,,CLE,W 117-104,240,47,86,.547,37,64,.578,10,22,.455,13,18,.722,117,40,77,.519,31,50,.620,9,27,.333,15,22,.682,104
738,WAS,2022-01-17,117,,PHI,W 117-98,240,42,87,.483,33,57,.579,9,30,.300,24,32,.750,117,35,86,.407,28,60,.467,7,26,.269,21,25,.840,98
739,NYK,2022-01-15,117,@,ATL,W 117-108,240,42,83,.506,29,52,.558,13,31,.419,20,26,.769,117,40,80,.500,24,36,.667,16,44,.364,12,17,.706,108
740,TOR,2022-01-05,117,@,MIL,W 117-111,240,42,89,.472,26,53,.491,16,36,.444,17,25,.680,117,38,85,.447,21,46,.457,17,39,.436,18,26,.692,111
741,DET,2022-01-01,117,,SAS,W 117-116 (OT),265,41,101,.406,32,66,.485,9,35,.257,26,33,.788,117,42,102,.412,30,62,.484,12,40,.300,20,28,.714,116
742,ATL,2021-12-29,117,@,CHI,L 117-131,240,44,92,.478,33,66,.500,11,26,.423,18,26,.692,117,52,84,.619,42,62,.677,10,22,.455,17,22,.773,131
743,SAC,2021-12-28,117,,OKC,W 117-111,240,40,95,.421,23,56,.411,17,39,.436,20,27,.741,117,35,90,.389,24,57,.421,11,33,.333,30,36,.833,111
744,POR,2021-12-27,117,,DAL,L 117-132,240,35,82,.427,23,42,.548,12,40,.300,35,42,.833,117,48,84,.571,36,51,.706,12,33,.364,24,33,.727,132
745,OKC,2021-12-26,117,,NOP,W 117-112,240,41,86,.477,28,50,.560,13,36,.361,22,31,.710,117,39,94,.415,29,53,.547,10,41,.244,24,28,.857,112
746,PHI,2021-12-26,117,@,WAS,W 117-96,240,43,86,.500,31,55,.564,12,31,.387,19,22,.864,117,35,90,.389,27,57,.474,8,33,.242,18,28,.643,96
747,MIL,2021-12-25,117,,BOS,W 117-113,240,43,91,.473,31,58,.534,12,33,.364,19,27,.704,117,38,89,.427,21,44,.477,17,45,.378,20,24,.833,113
748,NYK,2021-12-23,117,,WAS,L 117-124,240,42,93,.452,29,51,.569,13,42,.310,20,23,.870,117,42,75,.560,26,38,.684,16,37,.432,24,32,.750,124
749,BOS,2021-12-13,117,,MIL,W 117-103,240,43,86,.500,23,39,.590,20,47,.426,11,13,.846,117,40,90,.444,29,54,.537,11,36,.306,12,15,.800,103
750,CLE,2021-12-11,117,,SAC,W 117-103,240,41,88,.466,29,57,.509,12,31,.387,23,28,.821,117,41,93,.441,34,65,.523,7,28,.250,14,22,.636,103
751,LAL,2021-12-07,117,,BOS,W 117-102,240,48,93,.516,40,66,.606,8,27,.296,13,17,.765,117,36,82,.439,26,49,.531,10,33,.303,20,29,.690,102
752,POR,2021-12-04,117,,BOS,L 117-145,240,42,89,.472,34,60,.567,8,29,.276,25,32,.781,117,49,87,.563,28,50,.560,21,37,.568,26,29,.897,145
753,LAL,2021-11-30,117,@,SAC,W 117-92,240,46,92,.500,35,64,.547,11,28,.393,14,20,.700,117,35,79,.443,29,50,.580,6,29,.207,16,22,.727,92
754,BRK,2021-11-22,117,@,CLE,W 117-112,240,45,95,.474,34,60,.567,11,35,.314,16,18,.889,117,36,93,.387,22,49,.449,14,44,.318,26,29,.897,112
755,MIL,2021-11-20,117,,ORL,W 117-108,240,37,82,.451,18,42,.429,19,40,.475,24,37,.649,117,39,98,.398,20,47,.426,19,51,.373,11,14,.786,108
756,GSW,2021-11-16,117,@,BRK,W 117-99,240,41,79,.519,28,39,.718,13,40,.325,22,28,.786,117,34,88,.386,24,52,.462,10,36,.278,21,27,.778,99
757,CHI,2021-11-10,117,,DAL,W 117-107,240,45,89,.506,30,58,.517,15,31,.484,12,14,.857,117,38,83,.458,26,50,.520,12,33,.364,19,24,.792,107
758,MIA,2021-11-10,117,@,LAL,L 117-120 (OT),265,40,96,.417,30,59,.508,10,37,.270,27,35,.771,117,46,92,.500,28,54,.519,18,38,.474,10,16,.625,120
759,SAC,2021-11-10,117,@,SAS,L 117-136,240,47,91,.516,37,55,.673,10,36,.278,13,16,.813,117,49,92,.533,31,60,.517,18,32,.563,20,31,.645,136
760,LAC,2021-11-09,117,,POR,W 117-109,240,44,85,.518,28,55,.509,16,30,.533,13,19,.684,117,43,91,.473,29,54,.537,14,37,.378,9,12,.750,109
761,ATL,2021-11-06,117,@,PHO,L 117-121,240,42,97,.433,29,64,.453,13,33,.394,20,23,.870,117,45,88,.511,31,45,.689,14,43,.326,17,21,.810,121
762,BRK,2021-11-03,117,,ATL,W 117-108,240,43,88,.489,21,40,.525,22,48,.458,9,12,.750,117,41,94,.436,28,59,.475,13,35,.371,13,15,.867,108
763,MIL,2021-11-02,117,@,DET,W 117-89,240,42,84,.500,25,47,.532,17,37,.459,16,21,.762,117,30,93,.323,22,46,.478,8,47,.170,21,30,.700,89
764,HOU,2021-11-02,117,@,LAL,L 117-119,240,48,91,.527,32,49,.653,16,42,.381,5,12,.417,117,49,93,.527,43,68,.632,6,25,.240,15,20,.750,119
765,BRK,2021-10-31,117,,DET,W 117-91,240,47,72,.653,34,47,.723,13,25,.520,10,16,.625,117,32,79,.405,20,46,.435,12,33,.364,15,22,.682,91
766,NOP,2021-10-30,117,,NYK,L 117-123,240,42,92,.457,31,59,.525,11,33,.333,22,24,.917,117,42,81,.519,23,48,.479,19,33,.576,20,25,.800,123
767,PHI,2021-10-20,117,@,NOP,W 117-97,240,44,85,.518,31,60,.517,13,25,.520,16,20,.800,117,39,93,.419,26,63,.413,13,30,.433,6,9,.667,97
768,SAC,2022-04-10,116,@,PHO,W 116-109,240,40,76,.526,26,50,.520,14,26,.538,22,30,.733,116,42,103,.408,28,56,.500,14,47,.298,11,15,.733,109
769,SAS,2022-04-05,116,@,DEN,W 116-97,240,44,89,.494,32,63,.508,12,26,.462,16,24,.667,116,41,98,.418,34,65,.523,7,33,.212,8,12,.667,97
770,PHI,2022-03-29,116,,MIL,L 116-118,240,43,89,.483,27,48,.563,16,41,.390,14,18,.778,116,44,88,.500,30,50,.600,14,38,.368,16,23,.696,118
771,NOP,2022-03-27,116,,LAL,W 116-108,240,44,91,.484,35,64,.547,9,27,.333,19,24,.792,116,42,80,.525,28,45,.622,14,35,.400,10,16,.625,108
772,MIN,2022-03-25,116,,DAL,W 116-95,240,43,84,.512,32,52,.615,11,32,.344,19,24,.792,116,35,90,.389,25,47,.532,10,43,.233,15,19,.789,95
773,MIN,2022-03-23,116,,PHO,L 116-125,240,42,95,.442,29,52,.558,13,43,.302,19,22,.864,116,45,86,.523,33,53,.623,12,33,.364,23,29,.793,125
774,DEN,2022-03-18,116,@,CLE,L 116-119 (OT),265,46,92,.500,36,59,.610,10,33,.303,14,18,.778,116,44,98,.449,30,61,.492,14,37,.378,17,26,.654,119
775,CHO,2022-03-16,116,,ATL,W 116-106,240,43,87,.494,32,52,.615,11,35,.314,19,23,.826,116,40,93,.430,27,56,.482,13,37,.351,13,14,.929,106
776,OKC,2022-03-14,116,,CHO,L 116-134,240,42,90,.467,26,46,.565,16,44,.364,16,19,.842,116,49,91,.538,29,56,.518,20,35,.571,16,21,.762,134
777,PHI,2022-03-13,116,@,ORL,W 116-114 (OT),265,35,92,.380,21,55,.382,14,37,.378,32,37,.865,116,41,91,.451,23,48,.479,18,43,.419,14,20,.700,114
778,NYK,2022-03-06,116,@,LAC,W 116-93,240,42,89,.472,29,60,.483,13,29,.448,19,30,.633,116,33,88,.375,22,54,.407,11,34,.324,16,22,.727,93
779,UTA,2022-03-06,116,@,OKC,W 116-103,240,40,89,.449,17,37,.459,23,52,.442,13,17,.765,116,39,92,.424,31,52,.596,8,40,.200,17,19,.895,103
780,GSW,2022-03-05,116,@,LAL,L 116-124,240,46,92,.500,31,58,.534,15,34,.441,9,19,.474,116,44,89,.494,26,48,.542,18,41,.439,18,21,.857,124
781,DEN,2022-03-04,116,,HOU,W 116-101,240,39,86,.453,26,53,.491,13,33,.394,25,31,.806,116,38,83,.458,28,47,.596,10,36,.278,15,22,.682,101
782,WAS,2022-03-01,116,,DET,W 116-113,240,41,82,.500,28,56,.500,13,26,.500,21,26,.808,116,43,90,.478,35,63,.556,8,27,.296,19,23,.826,113
783,MEM,2022-02-26,116,@,CHI,W 116-110,240,44,100,.440,37,77,.481,7,23,.304,21,26,.808,116,39,93,.419,30,73,.411,9,20,.450,23,30,.767,110
784,GSW,2022-02-16,116,,DEN,L 116-117,240,45,87,.517,35,53,.660,10,34,.294,16,24,.667,116,43,91,.473,29,55,.527,14,36,.389,17,21,.810,117
785,CLE,2022-02-15,116,@,ATL,L 116-124,240,45,88,.511,29,47,.617,16,41,.390,10,12,.833,116,43,80,.538,29,47,.617,14,33,.424,24,27,.889,124
786,NYK,2022-02-10,116,@,GSW,W 116-114,240,39,90,.433,25,54,.463,14,36,.389,24,33,.727,116,42,91,.462,27,46,.587,15,45,.333,15,17,.882,114
787,LAL,2022-02-08,116,,MIL,L 116-131,240,44,85,.518,34,53,.642,10,32,.313,18,30,.600,116,52,96,.542,37,60,.617,15,36,.417,12,20,.600,131
788,DAL,2022-02-08,116,,DET,W 116-86,240,40,79,.506,22,43,.512,18,36,.500,18,23,.783,116,33,87,.379,28,57,.491,5,30,.167,15,22,.682,86
789,TOR,2022-02-07,116,@,CHO,W 116-101,240,41,84,.488,26,49,.531,15,35,.429,19,29,.655,116,39,95,.411,30,55,.545,9,40,.225,14,16,.875,101
790,BOS,2022-02-06,116,@,ORL,W 116-83,240,45,99,.455,32,53,.604,13,46,.283,13,14,.929,116,29,81,.358,24,55,.436,5,26,.192,20,21,.952,83
791,LAC,2022-01-31,116,@,IND,L 116-122,240,45,96,.469,30,52,.577,15,44,.341,11,13,.846,116,50,95,.526,36,66,.545,14,29,.483,8,12,.667,122
792,NYK,2022-01-31,116,,SAC,W 116-96,240,40,80,.500,27,45,.600,13,35,.371,23,29,.793,116,37,86,.430,26,48,.542,11,38,.289,11,22,.500,96
793,POR,2022-01-30,116,@,CHI,L 116-130,240,43,83,.518,25,44,.568,18,39,.462,12,16,.750,116,50,90,.556,37,58,.638,13,32,.406,17,18,.944,130
794,DEN,2022-01-28,116,@,NOP,W 116-105,240,41,82,.500,29,49,.592,12,33,.364,22,25,.880,116,35,90,.389,30,56,.536,5,34,.147,30,33,.909,105
795,LAC,2022-01-25,116,@,WAS,W 116-115,240,39,94,.415,28,65,.431,11,29,.379,27,31,.871,116,37,80,.463,28,53,.528,9,27,.333,32,40,.800,115
796,BOS,2022-01-23,116,@,WAS,W 116-87,240,40,90,.444,21,51,.412,19,39,.487,17,21,.810,116,33,93,.355,25,59,.424,8,34,.235,13,16,.813,87
797,LAL,2022-01-21,116,@,ORL,W 116-105,240,42,85,.494,29,55,.527,13,30,.433,19,23,.826,116,36,81,.444,25,41,.610,11,40,.275,22,29,.759,105
798,HOU,2022-01-19,116,@,UTA,W 116-111,240,41,96,.427,19,51,.373,22,45,.489,12,17,.706,116,42,89,.472,32,51,.627,10,38,.263,17,20,.850,111
799,ORL,2022-01-14,116,@,CHO,W 116-109,240,45,87,.517,30,42,.714,15,45,.333,11,15,.733,116,40,97,.412,28,55,.509,12,42,.286,17,21,.810,109
800,MEM,2022-01-13,116,,MIN,W 116-108,240,42,92,.457,34,60,.567,8,32,.250,24,35,.686,116,41,96,.427,26,48,.542,15,48,.313,11,14,.786,108
801,LAL,2022-01-12,116,@,SAC,L 116-125,240,42,98,.429,26,51,.510,16,47,.340,16,24,.667,116,49,89,.551,38,59,.644,11,30,.367,16,19,.842,125
802,MEM,2022-01-11,116,,GSW,W 116-108,240,44,100,.440,30,66,.455,14,34,.412,14,18,.778,116,35,82,.427,22,46,.478,13,36,.361,25,29,.862,108
803,UTA,2022-01-10,116,@,DET,L 116-126,240,44,86,.512,33,53,.623,11,33,.333,17,22,.773,116,48,93,.516,29,56,.518,19,37,.514,11,12,.917,126
804,PHI,2022-01-05,116,@,ORL,W 116-106,240,43,85,.506,31,57,.544,12,28,.429,18,24,.750,116,40,90,.444,28,51,.549,12,39,.308,14,20,.700,106
805,BOS,2022-01-02,116,,ORL,W 116-111 (OT),265,39,86,.453,26,50,.520,13,36,.361,25,28,.893,116,40,95,.421,31,68,.456,9,27,.333,22,27,.815,111
806,BRK,2022-01-01,116,,LAC,L 116-120,240,42,97,.433,31,64,.484,11,33,.333,21,25,.840,116,42,86,.488,28,50,.560,14,36,.389,22,31,.710,120
807,SAS,2022-01-01,116,@,DET,L 116-117 (OT),265,42,102,.412,30,62,.484,12,40,.300,20,28,.714,116,41,101,.406,32,66,.485,9,35,.257,26,33,.788,117
808,UTA,2022-01-01,116,,GSW,L 116-123,240,40,92,.435,26,48,.542,14,44,.318,22,28,.786,116,46,86,.535,29,54,.537,17,32,.531,14,21,.667,123
809,TOR,2021-12-31,116,,LAC,W 116-108,240,40,96,.417,29,61,.475,11,35,.314,25,33,.758,116,38,78,.487,23,44,.523,15,34,.441,17,19,.895,108
810,CHO,2021-12-29,116,@,IND,W 116-108,240,44,85,.518,35,59,.593,9,26,.346,19,32,.594,116,36,86,.419,19,41,.463,17,45,.378,19,29,.655,108
811,DAL,2021-12-25,116,@,UTA,L 116-120,240,38,89,.427,28,59,.475,10,30,.333,30,35,.857,116,40,90,.444,28,54,.519,12,36,.333,28,37,.757,120
812,GSW,2021-12-25,116,@,PHO,W 116-107,240,42,85,.494,28,48,.583,14,37,.378,18,21,.857,116,40,83,.482,29,53,.547,11,30,.367,16,16,1.000,107
813,MIN,2021-12-23,116,@,UTA,L 116-128,240,45,101,.446,28,56,.500,17,45,.378,9,12,.750,116,48,90,.533,32,51,.627,16,39,.410,16,22,.727,128
814,SAS,2021-12-20,116,@,LAC,W 116-92,240,50,114,.439,38,77,.494,12,37,.324,4,6,.667,116,34,87,.391,25,55,.455,9,32,.281,15,20,.750,92
815,HOU,2021-12-18,116,@,DET,W 116-107,240,46,93,.495,32,55,.582,14,38,.368,10,17,.588,116,43,93,.462,33,57,.579,10,36,.278,11,16,.688,107
816,CHO,2021-12-17,116,@,POR,L 116-125,240,44,92,.478,31,55,.564,13,37,.351,15,18,.833,116,44,85,.518,23,38,.605,21,47,.447,16,18,.889,125
817,NOP,2021-12-17,116,,MIL,W 116-112 (OT),265,42,89,.472,29,52,.558,13,37,.351,19,30,.633,116,45,104,.433,31,57,.544,14,47,.298,8,10,.800,112
818,NYK,2021-12-16,116,@,HOU,W 116-103,240,39,83,.470,22,47,.468,17,36,.472,21,25,.840,116,34,68,.500,23,36,.639,11,32,.344,24,30,.800,103
819,MIN,2021-12-12,116,@,POR,W 116-111,240,38,85,.447,24,49,.490,14,36,.389,26,32,.813,116,37,81,.457,19,33,.576,18,48,.375,19,28,.679,111
820,BRK,2021-12-12,116,@,DET,W 116-104,240,41,87,.471,30,59,.508,11,28,.393,23,25,.920,116,39,92,.424,25,55,.455,14,37,.378,12,18,.667,104
821,LAL,2021-12-10,116,@,OKC,W 116-95,240,41,87,.471,22,45,.489,19,42,.452,15,20,.750,116,38,96,.396,28,52,.538,10,44,.227,9,14,.643,95
822,DET,2021-12-08,116,,WAS,L 116-119 (OT),265,37,79,.468,24,55,.436,13,24,.542,29,35,.829,116,42,88,.477,30,56,.536,12,32,.375,23,28,.821,119
823,IND,2021-12-06,116,,WAS,W 116-110,240,43,82,.524,34,59,.576,9,23,.391,21,22,.955,116,43,81,.531,36,66,.545,7,15,.467,17,21,.810,110
824,CLE,2021-12-03,116,@,WAS,W 116-101,240,42,89,.472,29,59,.492,13,30,.433,19,25,.760,116,38,82,.463,28,51,.549,10,31,.323,15,19,.789,101
825,ORL,2021-12-03,116,@,HOU,L 116-118,240,42,86,.488,29,49,.592,13,37,.351,19,21,.905,116,44,92,.478,27,45,.600,17,47,.362,13,15,.867,118
826,SAS,2021-11-29,116,,WAS,W 116-99,240,49,92,.533,41,74,.554,8,18,.444,10,16,.625,116,41,92,.446,32,61,.525,9,31,.290,8,13,.615,99
827,GSW,2021-11-24,116,,PHI,W 116-96,240,42,80,.525,27,42,.643,15,38,.395,17,24,.708,116,34,80,.425,26,52,.500,8,28,.286,20,22,.909,96
828,IND,2021-11-24,116,,LAL,L 116-124 (OT),265,42,104,.404,29,58,.500,13,46,.283,19,24,.792,116,42,95,.442,27,58,.466,15,37,.405,25,29,.862,124
829,DET,2021-11-21,116,,LAL,L 116-121,240,43,97,.443,29,57,.509,14,40,.350,16,21,.762,116,45,92,.489,35,61,.574,10,31,.323,21,27,.778,121
830,BRK,2021-11-07,116,@,TOR,W 116-103,240,41,80,.513,24,42,.571,17,38,.447,17,20,.850,116,41,87,.471,34,57,.596,7,30,.233,14,18,.778,103
831,UTA,2021-11-04,116,@,ATL,W 116-98,240,41,81,.506,24,40,.600,17,41,.415,17,23,.739,116,35,82,.427,28,54,.519,7,28,.250,21,26,.808,98
832,POR,2021-10-27,116,,MEM,W 116-96,240,39,84,.464,24,48,.500,15,36,.417,23,31,.742,116,35,96,.365,18,46,.391,17,50,.340,9,19,.474,96
833,WAS,2021-10-27,116,@,BOS,W 116-107,240,43,84,.512,34,59,.576,9,25,.360,21,29,.724,116,37,85,.435,27,56,.482,10,29,.345,23,28,.821,107
834,DAL,2021-10-26,116,,HOU,W 116-106,240,43,93,.462,31,50,.620,12,43,.279,18,25,.720,116,36,86,.419,20,47,.426,16,39,.410,18,26,.692,106
835,LAC,2021-10-25,116,,POR,W 116-86,240,44,93,.473,30,50,.600,14,43,.326,14,19,.737,116,32,85,.376,24,48,.500,8,37,.216,14,18,.778,86
836,MIL,2022-04-10,115,@,CLE,L 115-133,240,39,88,.443,27,58,.466,12,30,.400,25,32,.781,115,51,94,.543,32,56,.571,19,38,.500,12,17,.706,133
837,HOU,2022-04-08,115,@,TOR,L 115-117,240,43,81,.531,33,52,.635,10,29,.345,19,24,.792,115,44,96,.458,37,67,.552,7,29,.241,22,23,.957,117
838,CHO,2022-04-05,115,@,MIA,L 115-144,240,45,85,.529,33,47,.702,12,38,.316,13,18,.722,115,48,84,.571,25,42,.595,23,42,.548,25,29,.862,144
839,CLE,2022-04-05,115,@,ORL,L 115-120,240,42,86,.488,26,50,.520,16,36,.444,15,22,.682,115,47,93,.505,31,58,.534,16,35,.457,10,15,.667,120
840,MEM,2022-04-05,115,@,UTA,L 115-121 (OT),265,39,101,.386,26,70,.371,13,31,.419,24,29,.828,115,40,96,.417,28,58,.483,12,38,.316,29,43,.674,121
841,BRK,2022-04-02,115,@,ATL,L 115-122,240,42,99,.424,25,62,.403,17,37,.459,14,19,.737,115,36,86,.419,23,45,.511,13,41,.317,37,49,.755,122
842,UTA,2022-03-29,115,@,LAC,L 115-121,240,43,78,.551,31,47,.660,12,31,.387,17,29,.586,115,41,83,.494,26,47,.553,15,36,.417,24,28,.857,121
843,TOR,2022-03-28,115,,BOS,W 115-112 (OT),265,46,106,.434,36,67,.537,10,39,.256,13,18,.722,115,39,95,.411,27,55,.491,12,40,.300,22,28,.786,112
844,GSW,2022-03-27,115,@,WAS,L 115-123,240,38,89,.427,30,56,.536,8,33,.242,31,39,.795,115,44,84,.524,28,56,.500,16,28,.571,19,22,.864,123
845,HOU,2022-03-26,115,@,POR,W 115-98,240,44,84,.524,29,49,.592,15,35,.429,12,18,.667,115,37,93,.398,25,53,.472,12,40,.300,12,17,.706,98
846,LAC,2022-03-22,115,@,DEN,L 115-127,240,42,86,.488,32,54,.593,10,32,.313,21,26,.808,115,45,83,.542,29,51,.569,16,32,.500,21,23,.913,127
847,DET,2022-03-21,115,,POR,L 115-119,240,36,85,.424,27,50,.540,9,35,.257,34,41,.829,115,37,88,.420,29,60,.483,8,28,.286,37,49,.755,119
848,HOU,2022-03-21,115,,WAS,W 115-97,240,42,85,.494,22,46,.478,20,39,.513,11,13,.846,115,35,85,.412,29,56,.518,6,29,.207,21,24,.875,97
849,NOP,2022-03-15,115,,PHO,L 115-131,240,43,86,.500,31,52,.596,12,34,.353,17,24,.708,115,49,90,.544,31,56,.554,18,34,.529,15,15,1.000,131
850,DEN,2022-03-12,115,,TOR,L 115-127,240,43,78,.551,32,51,.627,11,27,.407,18,24,.750,115,48,102,.471,36,71,.507,12,31,.387,19,25,.760,127
851,ATL,2022-03-09,115,@,MIL,L 115-124,240,43,86,.500,32,48,.667,11,38,.289,18,22,.818,115,47,94,.500,35,59,.593,12,35,.343,18,23,.783,124
852,BOS,2022-03-09,115,@,CHO,W 115-101,240,46,93,.495,34,56,.607,12,37,.324,11,14,.786,115,36,85,.424,28,52,.538,8,33,.242,21,28,.750,101
853,LAC,2022-03-09,115,,WAS,W 115-109,240,43,86,.500,27,54,.500,16,32,.500,13,13,1.000,115,41,87,.471,31,60,.517,10,27,.370,17,20,.850,109
854,OKC,2022-03-08,115,,MIL,L 115-142,240,42,84,.500,26,45,.578,16,39,.410,15,21,.714,115,53,100,.530,33,60,.550,20,40,.500,16,20,.800,142
855,SAC,2022-03-07,115,,NYK,L 115-131,240,39,80,.488,28,48,.583,11,32,.344,26,36,.722,115,47,92,.511,29,50,.580,18,42,.429,19,23,.826,131
856,PHO,2022-03-04,115,,NYK,W 115-114,240,38,85,.447,21,51,.412,17,34,.500,22,27,.815,115,40,86,.465,27,57,.474,13,29,.448,21,30,.700,114
857,SAC,2022-03-03,115,@,SAS,W 115-112,240,39,85,.459,29,53,.547,10,32,.313,27,32,.844,115,46,93,.495,34,61,.557,12,32,.375,8,16,.500,112
858,DEN,2022-02-26,115,,SAC,W 115-110,240,38,82,.463,22,39,.564,16,43,.372,23,29,.793,115,38,89,.427,29,59,.492,9,30,.300,25,33,.758,110
859,MIA,2022-02-25,115,@,NYK,W 115-100,240,39,83,.470,28,51,.549,11,32,.344,26,35,.743,115,30,75,.400,16,35,.457,14,40,.350,26,36,.722,100
860,LAL,2022-02-12,115,@,GSW,L 115-117,240,41,88,.466,30,61,.492,11,27,.407,22,33,.667,115,40,90,.444,28,52,.538,12,38,.316,25,34,.735,117
861,MIA,2022-02-12,115,,BRK,W 115-111,240,41,82,.500,31,53,.585,10,29,.345,23,29,.793,115,42,93,.452,30,53,.566,12,40,.300,15,22,.682,111
862,NYK,2022-02-08,115,@,DEN,L 115-132,240,45,101,.446,30,58,.517,15,43,.349,10,12,.833,115,46,85,.541,30,46,.652,16,39,.410,24,31,.774,132
863,NYK,2022-02-05,115,@,LAL,L 115-122 (OT),265,39,98,.398,28,60,.467,11,38,.289,26,36,.722,115,48,102,.471,39,68,.574,9,34,.265,17,28,.607,122
864,ORL,2022-02-05,115,,MEM,L 115-135,240,39,90,.433,22,42,.524,17,48,.354,20,29,.690,115,53,105,.505,40,66,.606,13,39,.333,16,22,.727,135
865,IND,2022-02-04,115,,CHI,L 115-122,240,47,95,.495,35,68,.515,12,27,.444,9,9,1.000,115,49,90,.544,43,64,.672,6,26,.231,18,23,.783,122
866,PHO,2022-02-03,115,@,ATL,L 115-124,240,46,88,.523,37,56,.661,9,32,.281,14,18,.778,115,44,84,.524,24,44,.545,20,40,.500,16,22,.727,124
867,HOU,2022-02-02,115,,CLE,W 115-104,240,39,82,.476,25,42,.595,14,40,.350,23,33,.697,115,41,80,.513,34,59,.576,7,21,.333,15,27,.556,104
868,DEN,2022-02-01,115,@,MIN,L 115-130,240,38,89,.427,24,45,.533,14,44,.318,25,28,.893,115,46,93,.495,27,48,.563,19,45,.422,19,25,.760,130
869,ORL,2022-02-01,115,@,CHI,L 115-126,240,46,93,.495,32,54,.593,14,39,.359,9,11,.818,115,46,90,.511,35,60,.583,11,30,.367,23,29,.793,126
870,LAC,2022-01-30,115,@,CHO,W 115-90,240,44,84,.524,33,56,.589,11,28,.393,16,19,.842,115,32,98,.327,24,64,.375,8,34,.235,18,27,.667,90
871,DET,2022-01-30,115,,CLE,W 115-105,240,42,91,.462,32,65,.492,10,26,.385,21,25,.840,115,38,82,.463,25,48,.521,13,34,.382,16,25,.640,105
872,PHO,2022-01-30,115,,SAS,W 115-110,240,48,97,.495,37,65,.569,11,32,.344,8,12,.667,115,45,100,.450,32,63,.508,13,37,.351,7,8,.875,110
873,MEM,2022-01-29,115,,WAS,W 115-95,240,46,100,.460,33,69,.478,13,31,.419,10,12,.833,115,35,84,.417,25,55,.455,10,29,.345,15,21,.714,95
874,MIN,2022-01-27,115,@,GSW,L 115-124,240,42,95,.442,32,51,.627,10,44,.227,21,27,.778,115,44,82,.537,23,46,.500,21,36,.583,15,21,.714,124
875,CLE,2022-01-26,115,,MIL,W 115-99,240,41,87,.471,22,45,.489,19,42,.452,14,17,.824,115,37,80,.463,28,48,.583,9,32,.281,16,18,.889,99
876,WAS,2022-01-25,115,,LAC,L 115-116,240,37,80,.463,28,53,.528,9,27,.333,32,40,.800,115,39,94,.415,28,65,.431,11,29,.379,27,31,.871,116
877,PHO,2022-01-24,115,,UTA,W 115-109,240,47,99,.475,34,63,.540,13,36,.361,8,15,.533,115,40,81,.494,26,50,.520,14,31,.452,15,22,.682,109
878,PHI,2022-01-23,115,@,SAS,W 115-109,240,44,92,.478,37,76,.487,7,16,.438,20,23,.870,115,42,89,.472,32,59,.542,10,30,.333,15,22,.682,109
879,POR,2022-01-15,115,@,WAS,W 115-110,240,39,85,.459,26,46,.565,13,39,.333,24,35,.686,115,39,90,.433,27,53,.509,12,37,.324,20,23,.870,110
880,MIA,2022-01-12,115,@,ATL,W 115-91,240,43,90,.478,27,45,.600,16,45,.356,13,14,.929,115,31,82,.378,18,37,.486,13,45,.289,16,23,.696,91
881,MIA,2022-01-05,115,@,POR,W 115-109,240,37,82,.451,18,41,.439,19,41,.463,22,29,.759,115,33,78,.423,18,40,.450,15,38,.395,28,36,.778,109
882,UTA,2022-01-05,115,@,DEN,W 115-109,240,43,92,.467,29,51,.569,14,41,.341,15,18,.833,115,42,88,.477,31,52,.596,11,36,.306,14,15,.933,109
883,UTA,2022-01-03,115,@,NOP,W 115-104,240,41,85,.482,22,46,.478,19,39,.487,14,17,.824,115,39,97,.402,27,51,.529,12,46,.261,14,22,.636,104
884,DET,2022-01-03,115,@,MIL,W 115-106,240,44,91,.484,26,48,.542,18,43,.419,9,14,.643,115,39,92,.424,28,46,.609,11,46,.239,17,22,.773,106
885,GSW,2022-01-03,115,,MIA,W 115-108,240,45,92,.489,31,54,.574,14,38,.368,11,13,.846,115,37,90,.411,20,48,.417,17,42,.405,17,19,.895,108
886,SAC,2022-01-02,115,,MIA,W 115-113,240,40,78,.513,27,44,.614,13,34,.382,22,27,.815,115,46,105,.438,37,72,.514,9,33,.273,12,12,1.000,113
887,PHO,2021-12-29,115,,OKC,W 115-97,240,41,89,.461,29,55,.527,12,34,.353,21,28,.750,115,38,96,.396,31,61,.508,7,35,.200,14,16,.875,97
888,LAL,2021-12-25,115,,BRK,L 115-122,240,40,96,.417,30,61,.492,10,35,.286,25,28,.893,115,43,89,.483,29,57,.509,14,32,.438,22,27,.815,122
889,MIA,2021-12-23,115,,DET,W 115-112,240,43,88,.489,31,56,.554,12,32,.375,17,19,.895,115,36,80,.450,18,40,.450,18,40,.450,22,25,.880,112
890,CHO,2021-12-23,115,@,DEN,W 115-107,240,39,94,.415,23,47,.489,16,47,.340,21,24,.875,115,40,96,.417,26,56,.464,14,40,.350,13,17,.765,107
891,CHI,2021-12-19,115,,LAL,W 115-110,240,40,93,.430,30,63,.476,10,30,.333,25,31,.806,115,42,82,.512,30,48,.625,12,34,.353,14,22,.636,110
892,ATL,2021-12-17,115,,DEN,L 115-133,240,41,88,.466,34,64,.531,7,24,.292,26,34,.765,115,50,86,.581,33,48,.688,17,38,.447,16,18,.889,133
893,MIA,2021-12-17,115,@,ORL,W 115-105,240,41,82,.500,22,47,.468,19,35,.543,14,19,.737,115,43,89,.483,32,57,.561,11,32,.344,8,10,.800,105
894,SAS,2021-12-15,115,,CHO,L 115-131,240,39,90,.433,27,53,.509,12,37,.324,25,25,1.000,115,51,86,.593,33,52,.635,18,34,.529,11,16,.688,131
895,CLE,2021-12-08,115,,CHI,W 115-92,240,44,80,.550,31,52,.596,13,28,.464,14,16,.875,115,35,84,.417,28,58,.483,7,26,.269,15,21,.714,92
896,LAL,2021-12-03,115,,LAC,L 115-119,240,45,90,.500,33,57,.579,12,33,.364,13,21,.619,115,41,81,.506,25,46,.543,16,35,.457,21,24,.875,119
897,NYK,2021-12-02,115,,CHI,L 115-119,240,42,82,.512,33,56,.589,9,26,.346,22,27,.815,115,44,89,.494,33,60,.550,11,29,.379,20,21,.952,119
898,WAS,2021-12-01,115,,MIN,W 115-107,240,45,91,.495,35,59,.593,10,32,.313,15,21,.714,115,37,88,.420,26,51,.510,11,37,.297,22,26,.846,107
899,LAC,2021-12-01,115,,SAC,L 115-124,240,47,100,.470,38,69,.551,9,31,.290,12,16,.750,115,46,88,.523,31,50,.620,15,38,.395,17,20,.850,124
900,MIN,2021-11-26,115,@,CHO,L 115-133,240,45,100,.450,34,65,.523,11,35,.314,14,19,.737,115,49,88,.557,26,48,.542,23,40,.575,12,15,.800,133
901,CLE,2021-11-24,115,,PHO,L 115-120,240,43,97,.443,31,58,.534,12,39,.308,17,25,.680,115,45,86,.523,37,64,.578,8,22,.364,22,28,.786,120
902,PHO,2021-11-22,115,@,SAS,W 115-111,240,45,88,.511,33,61,.541,12,27,.444,13,16,.813,115,49,93,.527,44,73,.603,5,20,.250,8,16,.500,111
903,ATL,2021-11-20,115,,CHO,W 115-105,240,43,82,.524,31,48,.646,12,34,.353,17,21,.810,115,43,102,.422,33,62,.532,10,40,.250,9,15,.600,105
904,BRK,2021-11-19,115,,ORL,W 115-113,240,41,91,.451,31,58,.534,10,33,.303,23,25,.920,115,40,89,.449,26,51,.510,14,38,.368,19,25,.760,113
905,MIN,2021-11-18,115,,SAS,W 115-90,240,41,86,.477,20,37,.541,21,49,.429,12,15,.800,115,35,84,.417,29,52,.558,6,32,.188,14,19,.737,90
906,PHO,2021-11-14,115,@,HOU,W 115-89,240,42,97,.433,28,57,.491,14,40,.350,17,20,.850,115,35,85,.412,28,53,.528,7,32,.219,12,18,.667,89
907,TOR,2021-11-11,115,@,PHI,W 115-109,240,42,96,.438,28,63,.444,14,33,.424,17,17,1.000,115,40,88,.455,29,54,.537,11,34,.324,18,19,.947,109
908,UTA,2021-11-06,115,@,MIA,L 115-118,240,43,83,.518,28,38,.737,15,45,.333,14,19,.737,115,47,78,.603,36,57,.632,11,21,.524,13,17,.765,118
909,WAS,2021-11-05,115,,MEM,W 115-87,240,49,84,.583,39,59,.661,10,25,.400,7,13,.538,115,34,96,.354,28,65,.431,6,31,.194,13,17,.765,87
910,MIN,2021-11-03,115,,LAC,L 115-126,240,43,94,.457,29,54,.537,14,40,.350,15,16,.938,115,47,78,.603,26,42,.619,21,36,.583,11,12,.917,126
911,ORL,2021-11-01,115,@,MIN,W 115-97,240,37,82,.451,20,39,.513,17,43,.395,24,30,.800,115,36,97,.371,22,46,.478,14,51,.275,11,19,.579,97
912,WAS,2021-10-30,115,,BOS,W 115-112 (2OT),290,38,104,.365,28,68,.412,10,36,.278,29,36,.806,115,44,107,.411,42,81,.519,2,26,.077,22,25,.880,112
913,LAL,2021-10-27,115,@,OKC,L 115-123,240,46,92,.500,35,57,.614,11,35,.314,12,14,.857,115,43,86,.500,28,49,.571,15,37,.405,22,29,.759,123
914,PHI,2021-10-24,115,@,OKC,W 115-103,240,41,88,.466,24,47,.511,17,41,.415,16,20,.800,115,40,84,.476,32,53,.604,8,31,.258,15,19,.789,103
915,PHO,2021-10-22,115,@,LAL,W 115-105,240,42,86,.488,32,54,.593,10,32,.313,21,28,.750,115,34,86,.395,19,52,.365,15,34,.441,22,29,.759,105
916,TOR,2021-10-22,115,@,BOS,W 115-83,240,42,100,.420,32,65,.492,10,35,.286,21,21,1.000,115,32,82,.390,21,48,.438,11,34,.324,8,11,.727,83
917,GSW,2021-10-21,115,,LAC,W 115-113,240,43,83,.518,28,52,.538,15,31,.484,14,22,.636,115,42,96,.438,28,56,.500,14,40,.350,15,21,.714,113
918,HOU,2022-04-10,114,,ATL,L 114-130,240,41,89,.461,24,43,.558,17,46,.370,15,20,.750,114,45,87,.517,24,49,.490,21,38,.553,19,24,.792,130
919,NOP,2022-04-09,114,@,MEM,L 114-141,240,41,91,.451,35,61,.574,6,30,.200,26,35,.743,114,53,90,.589,35,55,.636,18,35,.514,17,23,.739,141
920,NYK,2022-04-08,114,@,WAS,W 114-92,240,41,88,.466,25,49,.510,16,39,.410,16,20,.800,114,35,69,.507,26,41,.634,9,28,.321,13,17,.765,92
921,PHI,2022-04-07,114,@,TOR,L 114-119,240,37,75,.493,18,39,.462,19,36,.528,21,25,.840,114,45,91,.495,30,58,.517,15,33,.455,14,18,.778,119
922,MIN,2022-04-05,114,,WAS,L 114-132,240,41,91,.451,27,50,.540,14,41,.341,18,25,.720,114,56,101,.554,43,71,.606,13,30,.433,7,14,.500,132
923,MIA,2022-04-03,114,@,TOR,W 114-109,240,41,79,.519,23,41,.561,18,38,.474,14,22,.636,114,35,83,.422,23,44,.523,12,39,.308,27,34,.794,109
924,CHO,2022-04-02,114,@,PHI,L 114-144,240,42,87,.483,31,57,.544,11,30,.367,19,24,.792,114,53,87,.609,32,44,.727,21,43,.488,17,21,.810,144
925,PHO,2022-04-01,114,@,MEM,L 114-122,240,47,86,.547,37,59,.627,10,27,.370,10,17,.588,114,46,102,.451,39,78,.500,7,24,.292,23,28,.821,122
926,NOP,2022-04-01,114,@,LAL,W 114-111,240,41,79,.519,34,53,.642,7,26,.269,25,29,.862,114,39,82,.476,28,55,.509,11,27,.407,22,31,.710,111
927,NYK,2022-03-30,114,,CHO,L 114-125,240,40,85,.471,24,41,.585,16,44,.364,18,26,.692,114,49,90,.544,37,55,.673,12,35,.343,15,17,.882,125
928,DAL,2022-03-27,114,,UTA,W 114-100,240,40,77,.519,23,43,.535,17,34,.500,17,24,.708,114,41,89,.461,29,55,.527,12,34,.353,6,10,.600,100
929,PHO,2022-03-27,114,,PHI,W 114-104,240,45,87,.517,32,60,.533,13,27,.481,11,17,.647,114,37,89,.416,27,53,.509,10,36,.278,20,26,.769,104
930,SAC,2022-03-26,114,@,ORL,W 114-110 (OT),265,42,98,.429,31,62,.500,11,36,.306,19,24,.792,114,45,106,.425,32,70,.457,13,36,.361,7,7,1.000,110
931,MIL,2022-03-24,114,,WAS,W 114-102,240,42,81,.519,26,46,.565,16,35,.457,14,16,.875,114,43,92,.467,32,54,.593,11,38,.289,5,9,.556,102
932,BRK,2022-03-21,114,,UTA,W 114-106,240,45,83,.542,34,53,.642,11,30,.367,13,15,.867,114,37,83,.446,23,44,.523,14,39,.359,18,22,.818,106
933,CLE,2022-03-16,114,,PHI,L 114-118,240,39,80,.488,30,52,.577,9,28,.321,27,32,.844,114,41,79,.519,29,47,.617,12,32,.375,24,28,.857,118
934,DEN,2022-03-14,114,@,PHI,W 114-110,240,44,82,.537,31,49,.633,13,33,.394,13,20,.650,114,36,84,.429,24,51,.471,12,33,.364,26,32,.813,110
935,TOR,2022-03-14,114,@,LAL,W 114-103,240,39,96,.406,29,59,.492,10,37,.270,26,36,.722,114,34,87,.391,21,45,.467,13,42,.310,22,29,.759,103
936,ORL,2022-03-13,114,,PHI,L 114-116 (OT),265,41,91,.451,23,48,.479,18,43,.419,14,20,.700,114,35,92,.380,21,55,.382,14,37,.378,32,37,.865,116
937,NYK,2022-03-11,114,@,MEM,L 114-118,240,38,90,.422,28,65,.431,10,25,.400,28,37,.757,114,46,104,.442,37,78,.474,9,26,.346,17,29,.586,118
938,BOS,2022-03-11,114,,DET,W 114-103,240,42,90,.467,36,58,.621,6,32,.188,24,30,.800,114,35,83,.422,25,49,.510,10,34,.294,23,24,.958,103
939,CHI,2022-03-09,114,@,DET,W 114-108,240,40,76,.526,37,61,.607,3,15,.200,31,35,.886,114,42,82,.512,31,51,.608,11,31,.355,13,17,.765,108
940,DAL,2022-03-05,114,,SAC,W 114-113,240,40,84,.476,26,48,.542,14,36,.389,20,27,.741,114,46,94,.489,37,69,.536,9,25,.360,12,18,.667,113
941,NYK,2022-03-04,114,@,PHO,L 114-115,240,40,86,.465,27,57,.474,13,29,.448,21,30,.700,114,38,85,.447,21,51,.412,17,34,.500,22,27,.815,115
942,WAS,2022-03-04,114,,ATL,L 114-117,240,46,85,.541,32,56,.571,14,29,.483,8,9,.889,114,38,91,.418,25,55,.455,13,36,.361,28,34,.824,117
943,ORL,2022-03-02,114,,IND,L 114-122 (OT),265,44,97,.454,34,65,.523,10,32,.313,16,20,.800,114,41,94,.436,29,57,.509,12,37,.324,28,35,.800,122
944,GSW,2022-03-01,114,@,MIN,L 114-129,240,41,90,.456,28,45,.622,13,45,.289,19,22,.864,114,47,89,.528,31,49,.633,16,40,.400,19,23,.826,129
945,PHO,2022-02-27,114,,UTA,L 114-118,240,44,86,.512,31,58,.534,13,28,.464,13,16,.813,114,44,94,.468,27,54,.500,17,40,.425,13,20,.650,118
946,UTA,2022-02-25,114,,DAL,W 114-109,240,40,74,.541,24,36,.667,16,38,.421,18,22,.818,114,42,88,.477,25,49,.510,17,39,.436,8,8,1.000,109
947,MEM,2022-02-24,114,@,MIN,L 114-119,240,38,98,.388,29,67,.433,9,31,.290,29,40,.725,114,43,93,.462,27,51,.529,16,42,.381,17,25,.680,119
948,SAS,2022-02-16,114,@,OKC,W 114-106,240,43,98,.439,33,64,.516,10,34,.294,18,22,.818,114,41,105,.390,30,73,.411,11,32,.344,13,19,.684,106
949,NOP,2022-02-12,114,,SAS,L 114-124,240,43,87,.494,32,55,.582,11,32,.344,17,20,.850,114,47,93,.505,33,56,.589,14,37,.378,16,19,.842,124
950,UTA,2022-02-11,114,,ORL,W 114-99,240,40,89,.449,27,48,.563,13,41,.317,21,24,.875,114,37,84,.440,24,49,.490,13,35,.371,12,16,.750,99
951,GSW,2022-02-10,114,,NYK,L 114-116,240,42,91,.462,27,46,.587,15,45,.333,15,17,.882,114,39,90,.433,25,54,.463,14,36,.389,24,33,.727,116
952,PHO,2022-02-08,114,@,PHI,W 114-109,240,43,95,.453,37,69,.536,6,26,.231,22,24,.917,114,41,89,.461,31,57,.544,10,32,.313,17,18,.944,109
953,SAC,2022-02-08,114,,MIN,L 114-134,240,41,83,.494,32,58,.552,9,25,.360,23,26,.885,114,50,104,.481,28,60,.467,22,44,.500,12,17,.706,134
954,ATL,2022-02-04,114,@,TOR,L 114-125,240,43,93,.462,34,64,.531,9,29,.310,19,21,.905,114,46,81,.568,29,54,.537,17,27,.630,16,18,.889,125
955,SAC,2022-02-03,114,@,GSW,L 114-126,240,42,80,.525,31,49,.633,11,31,.355,19,23,.826,114,47,84,.560,27,42,.643,20,42,.476,12,16,.750,126
956,DAL,2022-02-02,114,,OKC,L 114-120 (OT),265,46,98,.469,32,55,.582,14,43,.326,8,10,.800,114,41,86,.477,24,49,.490,17,37,.459,21,25,.840,120
957,LAC,2022-01-28,114,@,MIA,L 114-121,240,41,92,.446,32,57,.561,9,35,.257,23,32,.719,114,40,85,.471,25,51,.490,15,34,.441,26,27,.963,121
958,LAL,2022-01-28,114,@,CHO,L 114-117,240,38,91,.418,23,51,.451,15,40,.375,23,32,.719,114,43,83,.518,32,47,.681,11,36,.306,20,28,.714,117
959,ORL,2022-01-23,114,,CHI,W 114-95,240,42,80,.525,30,54,.556,12,26,.462,18,23,.783,114,33,76,.434,28,55,.509,5,21,.238,24,32,.750,95
960,POR,2022-01-23,114,@,TOR,W 114-105,240,45,85,.529,27,53,.509,18,32,.563,6,13,.462,114,39,98,.398,21,44,.477,18,54,.333,9,14,.643,105
961,MEM,2022-01-19,114,@,MIL,L 114-126,240,44,106,.415,35,66,.530,9,40,.225,17,25,.680,114,46,97,.474,33,60,.550,13,37,.351,21,22,.955,126
962,MIL,2022-01-17,114,@,ATL,L 114-121,240,39,88,.443,23,50,.460,16,38,.421,20,24,.833,114,38,86,.442,23,50,.460,15,36,.417,30,32,.938,121
963,CLE,2022-01-17,114,,BRK,W 114-107,240,42,81,.519,31,49,.633,11,32,.344,19,21,.905,114,41,83,.494,29,53,.547,12,30,.400,13,18,.722,107
964,BOS,2022-01-15,114,,CHI,W 114-112,240,44,90,.489,35,64,.547,9,26,.346,17,19,.895,114,44,87,.506,32,58,.552,12,29,.414,12,15,.800,112
965,CLE,2022-01-14,114,@,SAS,W 114-109,240,46,95,.484,38,75,.507,8,20,.400,14,24,.583,114,42,92,.457,27,58,.466,15,34,.441,10,13,.769,109
966,HOU,2022-01-14,114,@,SAC,L 114-126,240,44,101,.436,31,58,.534,13,43,.302,13,16,.813,114,48,96,.500,35,59,.593,13,37,.351,17,24,.708,126
967,POR,2022-01-10,114,,BRK,W 114-108,240,40,86,.465,25,48,.521,15,38,.395,19,26,.731,114,42,91,.462,30,59,.508,12,32,.375,12,15,.800,108
968,CHO,2022-01-08,114,,MIL,W 114-106,240,44,99,.444,28,51,.549,16,48,.333,10,17,.588,114,35,90,.389,23,53,.434,12,37,.324,24,26,.923,106
969,CLE,2022-01-07,114,@,POR,W 114-101,240,39,80,.488,22,41,.537,17,39,.436,19,29,.655,114,37,92,.402,21,57,.368,16,35,.457,11,19,.579,101
970,HOU,2022-01-05,114,@,WAS,W 114-111,240,40,85,.471,31,59,.525,9,26,.346,25,32,.781,114,40,91,.440,30,52,.577,10,39,.256,21,26,.808,111
971,SAC,2022-01-04,114,@,LAL,L 114-122,240,43,83,.518,29,49,.592,14,34,.412,14,18,.778,114,49,99,.495,38,67,.567,11,32,.344,13,20,.650,122
972,PHI,2021-12-28,114,@,TOR,W 114-109,240,34,77,.442,20,47,.426,14,30,.467,32,38,.842,114,38,87,.437,23,46,.500,15,41,.366,18,22,.818,109
973,MEM,2021-12-27,114,@,PHO,W 114-113,240,45,88,.511,34,59,.576,11,29,.379,13,17,.765,114,41,90,.456,30,59,.508,11,31,.355,20,23,.870,113
974,DAL,2021-12-21,114,,MIN,W 114-102,240,42,86,.488,31,52,.596,11,34,.324,19,23,.826,114,36,79,.456,23,39,.590,13,40,.325,17,20,.850,102
975,SAS,2021-12-19,114,@,SAC,L 114-121,240,45,91,.495,33,66,.500,12,25,.480,12,13,.923,114,46,91,.505,32,66,.485,14,25,.560,15,18,.833,121
976,BOS,2021-12-18,114,,NYK,W 114-107,240,42,89,.472,25,44,.568,17,45,.378,13,17,.765,114,35,80,.438,22,44,.500,13,36,.361,24,30,.800,107
977,BRK,2021-12-16,114,,PHI,W 114-105,240,44,89,.494,33,66,.500,11,23,.478,15,16,.938,114,39,89,.438,29,55,.527,10,34,.294,17,20,.850,105
978,MIL,2021-12-15,114,,IND,W 114-99,240,44,90,.489,30,61,.492,14,29,.483,12,15,.800,114,39,83,.470,28,45,.622,11,38,.289,10,11,.909,99
979,HOU,2021-12-10,114,,MIL,L 114-123,240,42,89,.472,23,43,.535,19,46,.413,11,20,.550,114,42,83,.506,27,44,.614,15,39,.385,24,32,.750,123
980,HOU,2021-12-08,114,,BRK,W 114-104,240,40,81,.494,26,40,.650,14,41,.341,20,29,.690,114,35,89,.393,27,56,.482,8,33,.242,26,31,.839,104
981,LAC,2021-12-08,114,,BOS,W 114-111,240,40,85,.471,26,53,.491,14,32,.438,20,22,.909,114,41,86,.477,31,54,.574,10,32,.313,19,21,.905,111
982,NOP,2021-12-08,114,,DEN,L 114-120 (OT),265,47,90,.522,36,60,.600,11,30,.367,9,12,.750,114,45,88,.511,36,56,.643,9,32,.281,21,27,.778,120
983,OKC,2021-12-06,114,@,DET,W 114-103,240,41,82,.500,32,57,.561,9,25,.360,23,30,.767,114,41,99,.414,25,58,.431,16,41,.390,5,6,.833,103
984,PHO,2021-12-02,114,,DET,W 114-103,240,43,79,.544,31,58,.534,12,21,.571,16,23,.696,114,36,80,.450,25,53,.472,11,27,.407,20,26,.769,103
985,SAS,2021-12-02,114,@,POR,W 114-83,240,44,91,.484,30,55,.545,14,36,.389,12,16,.750,114,29,82,.354,17,48,.354,12,34,.353,13,17,.765,83
986,ATL,2021-12-01,114,@,IND,W 114-111,240,44,86,.512,28,53,.528,16,33,.485,10,12,.833,114,44,90,.489,34,57,.596,10,33,.303,13,16,.813,111
987,HOU,2021-12-01,114,@,OKC,W 114-110,240,40,79,.506,25,42,.595,15,37,.405,19,22,.864,114,40,85,.471,32,53,.604,8,32,.250,22,29,.759,110
988,CLE,2021-11-29,114,@,DAL,W 114-96,240,45,80,.563,35,61,.574,10,19,.526,14,18,.778,114,39,89,.438,27,50,.540,12,39,.308,6,15,.400,96
989,DAL,2021-11-27,114,,WAS,L 114-120,240,42,89,.472,28,51,.549,14,38,.368,16,22,.727,114,45,78,.577,36,54,.667,9,24,.375,21,26,.808,120
990,IND,2021-11-26,114,,TOR,W 114-97,240,47,97,.485,36,58,.621,11,39,.282,9,11,.818,114,37,89,.416,30,59,.508,7,30,.233,16,22,.727,97
991,MIL,2021-11-24,114,,DET,W 114-93,240,42,87,.483,27,51,.529,15,36,.417,15,17,.882,114,34,95,.358,23,50,.460,11,45,.244,14,19,.737,93
992,CHI,2021-11-19,114,@,DEN,W 114-108,240,41,93,.441,33,62,.532,8,31,.258,24,24,1.000,114,39,82,.476,25,45,.556,14,37,.378,16,20,.800,108
993,LAL,2021-11-14,114,,SAS,W 114-106,240,43,83,.518,28,52,.538,15,31,.484,13,17,.765,114,40,90,.444,24,54,.444,16,36,.444,10,15,.667,106
994,PHI,2021-11-06,114,@,CHI,W 114-105,240,43,81,.531,30,55,.545,13,26,.500,15,19,.789,114,37,92,.402,30,63,.476,7,29,.241,24,30,.800,105
995,GSW,2021-11-03,114,,CHO,W 114-92,240,42,86,.488,24,41,.585,18,45,.400,12,18,.667,114,34,91,.374,24,55,.436,10,36,.278,14,19,.737,92
996,BOS,2021-11-01,114,,CHI,L 114-128,240,42,96,.438,27,63,.429,15,33,.455,15,20,.750,114,49,86,.570,36,55,.655,13,31,.419,17,18,.944,128
997,MIA,2021-10-29,114,,CHO,W 114-99,240,43,91,.473,34,56,.607,9,35,.257,19,19,1.000,114,35,90,.389,22,53,.415,13,37,.351,16,22,.727,99
998,LAC,2021-10-23,114,,MEM,L 114-120,240,43,99,.434,30,60,.500,13,39,.333,15,17,.882,114,42,90,.467,27,54,.500,15,36,.417,21,25,.840,120
999,BRK,2021-10-22,114,@,PHI,W 114-109,240,41,88,.466,29,50,.580,12,38,.316,20,24,.833,114,43,91,.473,29,55,.527,14,36,.389,9,11,.818,109
1000,LAL,2021-10-19,114,,GSW,L 114-121,240,45,95,.474,30,53,.566,15,42,.357,9,19,.474,114,41,93,.441,27,54,.500,14,39,.359,25,30,.833,121
1001,MIA,2022-04-08,113,,ATL,W 113-109,240,40,72,.556,29,46,.630,11,26,.423,22,28,.786,113,42,88,.477,34,54,.630,8,34,.235,17,19,.895,109
1002,LAC,2022-04-06,113,,PHO,W 113-109,240,33,75,.440,21,41,.512,12,34,.353,35,44,.795,113,42,108,.389,25,60,.417,17,48,.354,8,12,.667,109
1003,DET,2022-04-06,113,,DAL,L 113-131,240,35,82,.427,24,52,.462,11,30,.367,32,35,.914,113,45,80,.563,30,47,.638,15,33,.455,26,34,.765,131
1004,SAS,2022-04-03,113,,POR,W 113-92,240,38,84,.452,24,42,.571,14,42,.333,23,30,.767,113,33,84,.393,17,39,.436,16,45,.356,10,15,.667,92
1005,DEN,2022-03-28,113,@,CHO,W 113-109,240,40,86,.465,28,53,.528,12,33,.364,21,28,.750,113,44,93,.473,31,51,.608,13,42,.310,8,12,.667,109
1006,DEN,2022-03-26,113,,OKC,W 113-107,240,41,85,.482,33,54,.611,8,31,.258,23,24,.958,113,39,84,.464,25,48,.521,14,36,.389,15,16,.938,107
1007,CHI,2022-03-21,113,,TOR,W 113-99,240,44,90,.489,33,62,.532,11,28,.393,14,24,.583,113,40,91,.440,34,59,.576,6,32,.188,13,15,.867,99
1008,PHI,2022-03-21,113,,MIA,W 113-106,240,43,86,.500,28,49,.571,15,37,.405,12,16,.750,113,38,80,.475,28,47,.596,10,33,.303,20,20,1.000,106
1009,CLE,2022-03-19,113,,DET,W 113-109,240,45,88,.511,35,62,.565,10,26,.385,13,23,.565,113,41,85,.482,28,55,.509,13,30,.433,14,19,.737,109
1010,DAL,2022-03-16,113,@,BRK,W 113-111,240,41,83,.494,29,49,.592,12,34,.353,19,19,1.000,113,45,91,.495,36,65,.554,9,26,.346,12,15,.800,111
1011,POR,2022-03-14,113,@,ATL,L 113-122,240,44,88,.500,34,64,.531,10,24,.417,15,21,.714,113,40,109,.367,28,61,.459,12,48,.250,30,32,.938,122
1012,MIN,2022-03-12,113,@,MIA,W 113-104,240,35,83,.422,20,41,.488,15,42,.357,28,32,.875,113,35,88,.398,20,43,.465,15,45,.333,19,25,.760,104
1013,DAL,2022-03-11,113,@,HOU,W 113-100,240,40,88,.455,29,52,.558,11,36,.306,22,28,.786,113,41,86,.477,35,56,.625,6,30,.200,12,19,.632,100
1014,GSW,2022-03-10,113,@,DEN,W 113-102,240,42,88,.477,28,46,.609,14,42,.333,15,20,.750,113,35,84,.417,28,53,.528,7,31,.226,25,32,.781,102
1015,DET,2022-03-07,113,,ATL,W 113-110 (OT),265,43,93,.462,31,60,.517,12,33,.364,15,23,.652,113,42,93,.452,31,55,.564,11,38,.289,15,22,.682,110
1016,SAC,2022-03-05,113,@,DAL,L 113-114,240,46,94,.489,37,69,.536,9,25,.360,12,18,.667,113,40,84,.476,26,48,.542,14,36,.389,20,27,.741,114
1017,GSW,2022-03-03,113,@,DAL,L 113-122,240,44,81,.543,29,51,.569,15,30,.500,10,13,.769,113,45,85,.529,28,48,.583,17,37,.459,15,20,.750,122
1018,MIA,2022-03-03,113,@,BRK,W 113-107,240,40,77,.519,30,47,.638,10,30,.333,23,28,.821,113,39,83,.470,27,52,.519,12,31,.387,17,22,.773,107
1019,LAC,2022-03-01,113,@,HOU,W 113-100,240,42,96,.438,29,65,.446,13,31,.419,16,17,.941,113,38,96,.396,25,57,.439,13,39,.333,11,17,.647,100
1020,DET,2022-03-01,113,@,WAS,L 113-116,240,43,90,.478,35,63,.556,8,27,.296,19,23,.826,113,41,82,.500,28,56,.500,13,26,.500,21,26,.808,116
1021,BOS,2022-02-26,113,@,DET,W 113-104,240,42,88,.477,32,62,.516,10,26,.385,19,21,.905,113,39,87,.448,32,60,.533,7,27,.259,19,22,.864,104
1022,IND,2022-02-16,113,,WAS,W 113-108,240,45,83,.542,41,63,.651,4,20,.200,19,29,.655,113,39,91,.429,22,54,.407,17,37,.459,13,16,.813,108
1023,IND,2022-02-11,113,,CLE,L 113-120,240,42,89,.472,24,51,.471,18,38,.474,11,16,.688,113,43,81,.531,34,57,.596,9,24,.375,25,30,.833,120
1024,WAS,2022-02-10,113,,BRK,W 113-112,240,43,85,.506,32,54,.593,11,31,.355,16,18,.889,113,39,84,.464,29,55,.527,10,29,.345,24,28,.857,112
1025,ORL,2022-02-08,113,@,POR,W 113-95,240,44,90,.489,25,52,.481,19,38,.500,6,8,.750,113,32,91,.352,21,53,.396,11,38,.289,20,26,.769,95
1026,UTA,2022-02-07,113,,NYK,W 113-104,240,39,93,.419,27,45,.600,12,48,.250,23,27,.852,113,36,95,.379,28,62,.452,8,33,.242,24,35,.686,104
1027,LAC,2022-02-06,113,,MIL,L 113-137,240,40,96,.417,22,50,.440,18,46,.391,15,16,.938,113,48,88,.545,29,50,.580,19,38,.500,22,27,.815,137
1028,SAC,2022-02-05,113,,OKC,W 113-103,240,43,83,.518,31,51,.608,12,32,.375,15,22,.682,113,42,87,.483,33,57,.579,9,30,.300,10,16,.625,103
1029,NOP,2022-02-04,113,@,DEN,W 113-105,240,42,75,.560,34,50,.680,8,25,.320,21,23,.913,113,35,78,.449,16,37,.432,19,41,.463,16,17,.941,105
1030,BOS,2022-02-02,113,,CHO,W 113-107,240,42,82,.512,28,46,.609,14,36,.389,15,17,.882,113,37,87,.425,25,47,.532,12,40,.300,21,27,.778,107
1031,IND,2022-01-28,113,@,OKC,W 113-110 (OT),265,41,95,.432,28,56,.500,13,39,.333,18,29,.621,113,43,95,.453,29,52,.558,14,43,.326,10,17,.588,110
1032,CHO,2022-01-25,113,@,TOR,L 113-125,240,40,82,.488,30,51,.588,10,31,.323,23,32,.719,113,43,82,.524,27,48,.563,16,34,.471,23,29,.793,125
1033,IND,2022-01-24,113,@,NOP,L 113-117,240,38,87,.437,19,41,.463,19,46,.413,18,25,.720,113,41,88,.466,35,58,.603,6,30,.200,29,31,.935,117
1034,MIA,2022-01-23,113,,LAL,W 113-107,240,40,81,.494,25,48,.521,15,33,.455,18,20,.900,113,36,79,.456,25,39,.641,11,40,.275,24,30,.800,107
1035,ATL,2022-01-23,113,@,CHO,W 113-91,240,40,88,.455,25,49,.510,15,39,.385,18,24,.750,113,34,87,.391,30,51,.588,4,36,.111,19,27,.704,91
1036,PHO,2022-01-22,113,,IND,W 113-103,240,47,96,.490,40,71,.563,7,25,.280,12,14,.857,113,37,84,.440,27,55,.491,10,29,.345,19,27,.704,103
1037,NOP,2022-01-13,113,,LAC,W 113-89,240,43,97,.443,29,58,.500,14,39,.359,13,16,.813,113,31,81,.383,21,47,.447,10,34,.294,17,20,.850,89
1038,DAL,2022-01-09,113,,CHI,W 113-99,240,44,88,.500,28,52,.538,16,36,.444,9,9,1.000,113,39,90,.433,28,57,.491,11,33,.333,10,13,.769,99
1039,UTA,2022-01-08,113,@,IND,L 113-125,240,40,84,.476,25,49,.510,15,35,.429,18,19,.947,113,44,80,.550,30,51,.588,14,29,.483,23,32,.719,125
1040,HOU,2022-01-03,113,@,PHI,L 113-133,240,37,89,.416,22,45,.489,15,44,.341,24,33,.727,113,50,96,.521,33,56,.589,17,40,.425,16,17,.941,133
1041,MIA,2022-01-02,113,@,SAC,L 113-115,240,46,105,.438,37,72,.514,9,33,.273,12,12,1.000,113,40,78,.513,27,44,.614,13,34,.382,22,27,.815,115
1042,NOP,2022-01-01,113,@,MIL,L 113-136,240,39,95,.411,23,44,.523,16,51,.314,19,30,.633,113,49,92,.533,26,44,.591,23,48,.479,15,18,.833,136
1043,PHO,2021-12-27,113,,MEM,L 113-114,240,41,90,.456,30,59,.508,11,31,.355,20,23,.870,113,45,88,.511,34,59,.576,11,29,.379,13,17,.765,114
1044,CHI,2021-12-26,113,,IND,W 113-105,240,43,76,.566,32,53,.604,11,23,.478,16,22,.727,113,41,94,.436,33,64,.516,8,30,.267,15,21,.714,105
1045,BOS,2021-12-25,113,@,MIL,L 113-117,240,38,89,.427,21,44,.477,17,45,.378,20,24,.833,113,43,91,.473,31,58,.534,12,33,.364,19,27,.704,117
1046,GSW,2021-12-23,113,,MEM,W 113-104,240,40,82,.488,21,42,.500,19,40,.475,14,18,.778,113,38,90,.422,30,64,.469,8,26,.308,20,24,.833,104
1047,PHO,2021-12-23,113,,OKC,W 113-101,240,45,93,.484,30,54,.556,15,39,.385,8,13,.615,113,37,96,.385,26,55,.473,11,41,.268,16,21,.762,101
1048,GSW,2021-12-20,113,,SAC,W 113-98,240,46,88,.523,31,51,.608,15,37,.405,6,9,.667,113,37,83,.446,24,51,.471,13,32,.406,11,16,.688,98
1049,DET,2021-12-16,113,@,IND,L 113-122,240,40,81,.494,33,56,.589,7,25,.280,26,30,.867,113,45,91,.495,38,59,.644,7,32,.219,25,28,.893,122
1050,NOP,2021-12-15,113,@,OKC,W 113-110,240,39,80,.488,28,52,.538,11,28,.393,24,36,.667,113,39,93,.419,26,58,.448,13,35,.371,19,19,1.000,110
1051,MEM,2021-12-15,113,@,POR,W 113-103,240,39,82,.476,28,50,.560,11,32,.344,24,30,.800,113,31,82,.378,16,44,.364,15,38,.395,26,28,.929,103
1052,DEN,2021-12-13,113,,WAS,W 113-107,240,37,79,.468,27,47,.574,10,32,.313,29,33,.879,113,41,90,.456,29,56,.518,12,34,.353,13,21,.619,107
1053,MEM,2021-12-11,113,,HOU,W 113-106,240,40,80,.500,29,51,.569,11,29,.379,22,36,.611,113,38,77,.494,27,44,.614,11,33,.333,19,29,.655,106
1054,BRK,2021-12-10,113,@,ATL,W 113-105,240,46,93,.495,40,70,.571,6,23,.261,15,16,.938,113,37,94,.394,26,60,.433,11,34,.324,20,24,.833,105
1055,MIA,2021-12-08,113,,MIL,W 113-104,240,40,77,.519,18,30,.600,22,47,.468,11,12,.917,113,36,85,.424,24,46,.522,12,39,.308,20,27,.741,104
1056,DEN,2021-12-04,113,@,NYK,W 113-99,240,44,84,.524,24,41,.585,20,43,.465,5,5,1.000,113,35,88,.398,23,48,.479,12,40,.300,17,21,.810,99
1057,MIA,2021-12-03,113,@,IND,W 113-104,240,43,81,.531,27,47,.574,16,34,.471,11,13,.846,113,35,80,.438,26,44,.591,9,36,.250,25,33,.758,104
1058,PHO,2021-11-27,113,@,BRK,W 113-107,240,41,92,.446,28,54,.519,13,38,.342,18,21,.857,113,42,84,.500,35,61,.574,7,23,.304,16,21,.762,107
1059,MEM,2021-11-24,113,,TOR,L 113-126,240,42,82,.512,33,53,.623,9,29,.310,20,26,.769,113,47,89,.528,33,59,.559,14,30,.467,18,21,.857,126
1060,MIN,2021-11-24,113,,MIA,W 113-101,240,38,93,.409,20,38,.526,18,55,.327,19,21,.905,113,33,74,.446,18,32,.563,15,42,.357,20,29,.690,101
1061,CHI,2021-11-24,113,@,HOU,L 113-118,240,44,96,.458,29,61,.475,15,35,.429,10,12,.833,113,42,84,.500,25,48,.521,17,36,.472,17,22,.773,118
1062,ATL,2021-11-22,113,,OKC,W 113-101,240,42,87,.483,28,53,.528,14,34,.412,15,16,.938,113,39,97,.402,29,59,.492,10,38,.263,13,14,.929,101
1063,ORL,2021-11-19,113,@,BRK,L 113-115,240,40,89,.449,26,51,.510,14,38,.368,19,25,.760,113,41,91,.451,31,58,.534,10,33,.303,23,25,.920,115
1064,MIA,2021-11-17,113,,NOP,W 113-98,240,42,87,.483,27,47,.574,15,40,.375,14,17,.824,113,33,75,.440,23,40,.575,10,35,.286,22,28,.786,98
1065,TOR,2021-11-15,113,@,POR,L 113-118,240,41,89,.461,26,56,.464,15,33,.455,16,18,.889,113,46,82,.561,30,46,.652,16,36,.444,10,14,.714,118
1066,PHI,2021-11-13,113,@,IND,L 113-118,240,38,89,.427,26,66,.394,12,23,.522,25,29,.862,113,47,82,.573,33,54,.611,14,28,.500,10,15,.667,118
1067,MIL,2021-11-12,113,@,BOS,L 113-122 (OT),265,44,98,.449,28,51,.549,16,47,.340,9,11,.818,113,47,96,.490,35,55,.636,12,41,.293,16,18,.889,122
1068,DEN,2021-11-08,113,,MIA,W 113-96,240,42,91,.462,30,50,.600,12,41,.293,17,24,.708,113,31,78,.397,18,42,.429,13,36,.361,21,25,.840,96
1069,ATL,2021-11-08,113,@,GSW,L 113-127,240,38,82,.463,21,39,.538,17,43,.395,20,26,.769,113,44,92,.478,26,48,.542,18,44,.409,21,22,.955,127
1070,NYK,2021-11-05,113,@,MIL,W 113-98,240,41,96,.427,31,56,.554,10,40,.250,21,26,.808,113,33,82,.402,17,39,.436,16,43,.372,16,21,.762,98
1071,SAC,2021-11-02,113,@,UTA,L 113-119,240,42,93,.452,30,62,.484,12,31,.387,17,24,.708,113,43,98,.439,29,50,.580,14,48,.292,19,27,.704,119
1072,CLE,2021-11-01,113,@,CHO,W 113-110,240,39,90,.433,30,62,.484,9,28,.321,26,38,.684,113,42,101,.416,27,62,.435,15,39,.385,11,15,.733,110
1073,TOR,2021-11-01,113,@,NYK,W 113-104,240,43,99,.434,29,57,.509,14,42,.333,13,14,.929,113,35,76,.461,19,38,.500,16,38,.421,18,24,.750,104
1074,PHI,2021-11-01,113,,POR,W 113-103,240,43,83,.518,30,47,.638,13,36,.361,14,16,.875,113,40,84,.476,28,50,.560,12,34,.353,11,18,.611,103
1075,POR,2021-10-31,113,@,CHO,L 113-125,240,43,97,.443,26,43,.605,17,54,.315,10,11,.909,113,46,89,.517,26,47,.553,20,42,.476,13,21,.619,125
1076,LAL,2021-10-29,113,,CLE,W 113-101,240,46,84,.548,34,57,.596,12,27,.444,9,10,.900,113,37,87,.425,25,53,.472,12,34,.353,15,22,.682,101
1077,SAC,2021-10-29,113,@,NOP,W 113-109,240,40,80,.500,31,53,.585,9,27,.333,24,25,.960,113,42,98,.429,33,64,.516,9,34,.265,16,25,.640,109
1078,MIN,2021-10-27,113,@,MIL,W 113-108,240,43,91,.473,30,46,.652,13,45,.289,14,17,.824,113,39,95,.411,25,44,.568,14,51,.275,16,21,.762,108
1079,LAC,2021-10-21,113,@,GSW,L 113-115,240,42,96,.438,28,56,.500,14,40,.350,15,21,.714,113,43,83,.518,28,52,.538,15,31,.484,14,22,.636,115
1080,ATL,2021-10-21,113,,DAL,W 113-87,240,45,94,.479,30,59,.508,15,35,.429,8,9,.889,113,31,93,.333,18,50,.360,13,43,.302,12,13,.923,87
1081,LAL,2022-04-07,112,@,GSW,L 112-128,240,37,83,.446,28,51,.549,9,32,.281,29,38,.763,112,51,97,.526,35,65,.538,16,32,.500,10,10,1.000,128
1082,MIL,2022-04-03,112,,DAL,L 112-118,240,42,95,.442,27,55,.491,15,40,.375,13,18,.722,112,39,76,.513,23,38,.605,16,38,.421,24,27,.889,118
1083,PHI,2022-04-03,112,@,CLE,W 112-108,240,33,80,.413,22,49,.449,11,31,.355,35,42,.833,112,35,78,.449,20,45,.444,15,33,.455,23,31,.742,108
1084,MEM,2022-03-30,112,@,SAS,W 112-111,240,44,91,.484,28,52,.538,16,39,.410,8,11,.727,112,42,83,.506,28,48,.583,14,35,.400,13,16,.813,111
1085,CLE,2022-03-30,112,,DAL,L 112-120,240,42,83,.506,31,58,.534,11,25,.440,17,22,.773,112,46,88,.523,30,46,.652,16,42,.381,12,15,.800,120
1086,BOS,2022-03-28,112,@,TOR,L 112-115 (OT),265,39,95,.411,27,55,.491,12,40,.300,22,28,.786,112,46,106,.434,36,67,.537,10,39,.256,13,18,.722,115
1087,MIN,2022-03-27,112,@,BOS,L 112-134,240,45,84,.536,31,52,.596,14,32,.438,8,12,.667,112,49,87,.563,32,48,.667,17,39,.436,19,21,.905,134
1088,ATL,2022-03-20,112,,NOP,L 112-117,240,41,87,.471,31,55,.564,10,32,.313,20,23,.870,112,43,96,.448,36,75,.480,7,21,.333,24,27,.889,117
1089,HOU,2022-03-16,112,,PHO,L 112-129,240,42,85,.494,26,46,.565,16,39,.410,12,19,.632,112,53,95,.558,40,62,.645,13,33,.394,10,13,.769,129
1090,SAC,2022-03-14,112,,CHI,W 112-103,240,39,82,.476,29,57,.509,10,25,.400,24,26,.923,112,36,88,.409,26,54,.481,10,34,.294,21,22,.955,103
1091,WAS,2022-03-14,112,@,GSW,L 112-126,240,42,82,.512,32,56,.571,10,26,.385,18,23,.783,112,45,84,.536,27,39,.692,18,45,.400,18,22,.818,126
1092,PHO,2022-03-11,112,,TOR,L 112-117,240,44,88,.500,33,52,.635,11,36,.306,13,17,.765,112,42,94,.447,28,62,.452,14,32,.438,19,21,.905,117
1093,ATL,2022-03-11,112,,LAC,W 112-106,240,43,90,.478,34,59,.576,9,31,.290,17,19,.895,112,40,82,.488,28,50,.560,12,32,.375,14,17,.824,106
1094,GSW,2022-03-08,112,,LAC,W 112-97,240,44,92,.478,31,58,.534,13,34,.382,11,13,.846,112,33,93,.355,21,54,.389,12,39,.308,19,23,.826,97
1095,MEM,2022-03-06,112,@,HOU,L 112-123,240,44,97,.454,39,71,.549,5,26,.192,19,27,.704,112,43,82,.524,30,48,.625,13,34,.382,24,36,.667,123
1096,CHI,2022-03-04,112,,MIL,L 112-118,240,47,94,.500,37,68,.544,10,26,.385,8,11,.727,112,43,88,.489,33,57,.579,10,31,.323,22,33,.667,118
1097,SAS,2022-03-03,112,,SAC,L 112-115,240,46,93,.495,34,61,.557,12,32,.375,8,16,.500,112,39,85,.459,29,53,.547,10,32,.313,27,32,.844,115
1098,MIA,2022-02-28,112,,CHI,W 112-99,240,40,81,.494,28,50,.560,12,31,.387,20,26,.769,112,41,84,.488,34,55,.618,7,29,.241,10,15,.667,99
1099,CHI,2022-02-24,112,,ATL,W 112-108,240,41,84,.488,33,57,.579,8,27,.296,22,27,.815,112,41,97,.423,33,69,.478,8,28,.286,18,27,.667,108
1100,DET,2022-02-16,112,@,BOS,W 112-111,240,43,93,.462,27,63,.429,16,30,.533,10,13,.769,112,42,77,.545,29,45,.644,13,32,.406,14,18,.778,111
1101,POR,2022-02-12,112,,NYK,W 112-103,240,40,84,.476,25,44,.568,15,40,.375,17,20,.850,112,31,81,.383,19,42,.452,12,39,.308,29,34,.853,103
1102,MIA,2022-02-10,112,@,NOP,W 112-97,240,39,81,.481,29,49,.592,10,32,.313,24,28,.857,112,36,85,.424,25,44,.568,11,41,.268,14,16,.875,97
1103,DAL,2022-02-10,112,,LAC,W 112-105,240,38,78,.487,25,39,.641,13,39,.333,23,27,.852,112,39,81,.481,30,58,.517,9,23,.391,18,25,.720,105
1104,BRK,2022-02-10,112,@,WAS,L 112-113,240,39,84,.464,29,55,.527,10,29,.345,24,28,.857,112,43,85,.506,32,54,.593,11,31,.355,16,18,.889,113
1105,IND,2022-02-08,112,@,ATL,L 112-133,240,37,93,.398,27,62,.435,10,31,.323,28,33,.848,112,52,90,.578,35,57,.614,17,33,.515,12,16,.750,133
1106,MIA,2022-02-03,112,@,SAS,W 112-95,240,42,83,.506,30,53,.566,12,30,.400,16,18,.889,112,30,80,.375,22,47,.468,8,33,.242,27,38,.711,95
1107,SAC,2022-02-02,112,,BRK,W 112-101,240,41,93,.441,27,51,.529,14,42,.333,16,18,.889,112,41,84,.488,33,59,.559,8,25,.320,11,14,.786,101
1108,MIL,2022-02-01,112,,WAS,W 112-98,240,46,92,.500,34,54,.630,12,38,.316,8,9,.889,112,36,82,.439,24,47,.511,12,35,.343,14,20,.700,98
1109,POR,2022-01-26,112,,DAL,L 112-132,240,42,82,.512,28,44,.636,14,38,.368,14,23,.609,112,48,88,.545,32,52,.615,16,36,.444,20,26,.769,132
1110,MIN,2022-01-18,112,@,NYK,W 112-110,240,35,81,.432,22,40,.550,13,41,.317,29,38,.763,112,37,80,.463,25,42,.595,12,38,.316,24,33,.727,110
1111,SAC,2022-01-16,112,,HOU,L 112-118,240,41,91,.451,29,53,.547,12,38,.316,18,24,.750,112,41,76,.539,25,36,.694,16,40,.400,20,24,.833,118
1112,CHI,2022-01-15,112,@,BOS,L 112-114,240,44,87,.506,32,58,.552,12,29,.414,12,15,.800,112,44,90,.489,35,64,.547,9,26,.346,17,19,.895,114
1113,PHO,2022-01-14,112,@,IND,W 112-94,240,40,88,.455,29,60,.483,11,28,.393,21,23,.913,112,34,88,.386,21,45,.467,13,43,.302,13,18,.722,94
1114,DAL,2022-01-14,112,@,MEM,W 112-85,240,47,91,.516,39,59,.661,8,32,.250,10,16,.625,112,34,89,.382,27,58,.466,7,31,.226,10,13,.769,85
1115,WAS,2022-01-12,112,,ORL,W 112-106,240,43,82,.524,33,51,.647,10,31,.323,16,21,.762,112,41,99,.414,30,64,.469,11,35,.314,13,16,.813,106
1116,CHI,2022-01-12,112,,BRK,L 112-138,240,38,81,.469,27,51,.529,11,30,.367,25,31,.806,112,49,87,.563,32,55,.582,17,32,.531,23,28,.821,138
1117,DAL,2021-12-31,112,@,SAC,W 112-96,240,42,81,.519,33,59,.559,9,22,.409,19,22,.864,112,38,91,.418,28,62,.452,10,29,.345,10,12,.833,96
1118,WAS,2021-12-28,112,@,MIA,L 112-119,240,42,85,.494,25,43,.581,17,42,.405,11,14,.786,112,41,92,.446,25,58,.431,16,34,.471,21,23,.913,119
1119,NOP,2021-12-26,112,@,OKC,L 112-117,240,39,94,.415,29,53,.547,10,41,.244,24,28,.857,112,41,86,.477,28,50,.560,13,36,.361,22,31,.710,117
1120,DET,2021-12-23,112,@,MIA,L 112-115,240,36,80,.450,18,40,.450,18,40,.450,22,25,.880,112,43,88,.489,31,56,.554,12,32,.375,17,19,.895,115
1121,UTA,2021-12-20,112,,CHO,W 112-102,240,34,96,.354,18,43,.419,16,53,.302,28,37,.757,112,39,101,.386,24,58,.414,15,43,.349,9,9,1.000,102
1122,MIL,2021-12-17,112,@,NOP,L 112-116 (OT),265,45,104,.433,31,57,.544,14,47,.298,8,10,.800,112,42,89,.472,29,52,.558,13,37,.351,19,30,.633,116
1123,MIL,2021-12-12,112,@,NYK,W 112-97,240,42,88,.477,28,47,.596,14,41,.341,14,17,.824,112,35,82,.427,18,33,.545,17,49,.347,10,13,.769,97
1124,SAS,2021-12-12,112,,NOP,W 112-97,240,45,91,.495,38,66,.576,7,25,.280,15,20,.750,112,40,94,.426,32,65,.492,8,29,.276,9,15,.600,97
1125,SAS,2021-12-11,112,,DEN,L 112-127,240,41,89,.461,31,62,.500,10,27,.370,20,29,.690,112,47,93,.505,27,50,.540,20,43,.465,13,14,.929,127
1126,MIL,2021-12-06,112,,CLE,W 112-104,240,40,86,.465,27,54,.500,13,32,.406,19,24,.792,112,35,90,.389,20,44,.455,15,46,.326,19,20,.950,104
1127,SAS,2021-12-04,112,@,GSW,W 112-107,240,42,88,.477,30,53,.566,12,35,.343,16,19,.842,112,40,90,.444,27,51,.529,13,39,.333,14,21,.667,107
1128,BRK,2021-11-30,112,,NYK,W 112-110,240,41,85,.482,33,57,.579,8,28,.286,22,25,.880,112,44,91,.484,33,59,.559,11,32,.344,11,12,.917,110
1129,DAL,2021-11-23,112,@,LAC,W 112-104 (OT),265,39,89,.438,27,50,.540,12,39,.308,22,27,.815,112,35,85,.412,25,53,.472,10,32,.313,24,29,.828,104
1130,CLE,2021-11-22,112,,BRK,L 112-117,240,36,93,.387,22,49,.449,14,44,.318,26,29,.897,112,45,95,.474,34,60,.567,11,35,.314,16,18,.889,117
1131,PHO,2021-11-19,112,,DAL,W 112-104,240,44,85,.518,30,56,.536,14,29,.483,10,14,.714,112,37,90,.411,25,50,.500,12,40,.300,18,23,.783,104
1132,MIA,2021-11-18,112,,WAS,W 112-97,240,41,82,.500,31,56,.554,10,26,.385,20,24,.833,112,38,77,.494,23,41,.561,15,36,.417,6,10,.600,97
1133,POR,2021-11-17,112,,CHI,W 112-107,240,37,84,.440,26,53,.491,11,31,.355,27,28,.964,112,39,83,.470,26,54,.481,13,29,.448,16,20,.800,107
1134,NOP,2021-11-13,112,,MEM,W 112-101,240,38,79,.481,24,50,.480,14,29,.483,22,25,.880,112,38,88,.432,30,64,.469,8,24,.333,17,21,.810,101
1135,NOP,2021-11-12,112,,BRK,L 112-120,240,43,88,.489,30,56,.536,13,32,.406,13,16,.813,112,41,82,.500,23,48,.479,18,34,.529,20,27,.741,120
1136,LAC,2021-11-11,112,,MIA,W 112-109,240,43,91,.473,32,54,.593,11,37,.297,15,17,.882,112,43,97,.443,34,56,.607,9,41,.220,14,17,.824,109
1137,MIL,2021-11-10,112,@,NYK,W 112-100,240,40,90,.444,14,40,.350,26,50,.520,6,9,.667,112,36,83,.434,20,46,.435,16,37,.432,12,17,.706,100
1138,DET,2021-11-10,112,@,HOU,W 112-104,240,42,97,.433,26,49,.531,16,48,.333,12,18,.667,112,35,82,.427,23,48,.479,12,34,.353,22,34,.647,104
1139,SAC,2021-11-03,112,,NOP,W 112-99,240,42,80,.525,32,50,.640,10,30,.333,18,22,.818,112,37,86,.430,25,52,.481,12,34,.353,13,15,.867,99
1140,PHO,2021-11-02,112,,NOP,W 112-100,240,43,82,.524,34,56,.607,9,26,.346,17,18,.944,112,36,91,.396,23,52,.442,13,39,.333,15,16,.938,100
1141,BOS,2021-10-30,112,@,WAS,L 112-115 (2OT),290,44,107,.411,42,81,.519,2,26,.077,22,25,.880,112,38,104,.365,28,68,.412,10,36,.278,29,36,.806,115
1142,NYK,2021-10-26,112,,PHI,W 112-99,240,41,87,.471,25,50,.500,16,37,.432,14,15,.933,112,36,82,.439,24,41,.585,12,41,.293,15,17,.882,99
1143,CLE,2021-10-22,112,,CHO,L 112-123,240,43,84,.512,34,53,.642,9,31,.290,17,20,.850,112,48,91,.527,35,59,.593,13,32,.406,14,17,.824,123
1144,NOP,2021-10-22,112,@,CHI,L 112-128,240,42,87,.483,27,58,.466,15,29,.517,13,16,.813,112,47,89,.528,33,61,.541,14,28,.500,20,25,.800,128
1145,UTA,2022-04-10,111,@,POR,W 111-80,240,37,82,.451,28,46,.609,9,36,.250,28,38,.737,111,31,83,.373,22,49,.449,9,34,.265,9,12,.750,80
1146,MIA,2022-04-10,111,@,ORL,L 111-125,240,40,94,.426,21,44,.477,19,50,.380,12,16,.750,111,45,91,.495,22,33,.667,23,58,.397,12,14,.857,125
1147,PHO,2022-04-08,111,@,UTA,W 111-105,240,46,92,.500,40,73,.548,6,19,.316,13,15,.867,111,35,88,.398,24,50,.480,11,38,.289,24,33,.727,105
1148,GSW,2022-04-02,111,,UTA,W 111-107,240,40,84,.476,20,36,.556,20,48,.417,11,12,.917,111,38,89,.427,23,43,.535,15,46,.326,16,22,.727,107
1149,POR,2022-04-01,111,@,SAS,L 111-130,240,41,92,.446,26,57,.456,15,35,.429,14,20,.700,111,46,81,.568,30,44,.682,16,37,.432,22,28,.786,130
1150,LAL,2022-04-01,111,,NOP,L 111-114,240,39,82,.476,28,55,.509,11,27,.407,22,31,.710,111,41,79,.519,34,53,.642,7,26,.269,25,29,.862,114
1151,SAS,2022-03-30,111,,MEM,L 111-112,240,42,83,.506,28,48,.583,14,35,.400,13,16,.813,111,44,91,.484,28,52,.538,16,39,.410,8,11,.727,112
1152,NYK,2022-03-25,111,@,MIA,W 111-103,240,36,82,.439,19,32,.594,17,50,.340,22,28,.786,111,35,70,.500,23,37,.622,12,33,.364,21,25,.840,103
1153,NYK,2022-03-22,111,,ATL,L 111-117,240,42,86,.488,29,52,.558,13,34,.382,14,26,.538,111,40,81,.494,25,45,.556,15,36,.417,22,27,.815,117
1154,PHI,2022-03-18,111,,DAL,W 111-101,240,37,75,.493,21,37,.568,16,38,.421,21,23,.913,111,37,80,.463,25,48,.521,12,32,.375,15,21,.714,101
1155,BRK,2022-03-16,111,,DAL,L 111-113,240,45,91,.495,36,65,.554,9,26,.346,12,15,.800,111,41,83,.494,29,49,.592,12,34,.353,19,19,1.000,113
1156,LAC,2022-03-14,111,@,CLE,L 111-120 (OT),265,43,98,.439,31,62,.500,12,36,.333,13,17,.765,111,41,86,.477,26,56,.464,15,30,.500,23,32,.719,120
1157,UTA,2022-03-14,111,,MIL,L 111-117,240,37,93,.398,20,45,.444,17,48,.354,20,24,.833,111,40,86,.465,28,55,.509,12,31,.387,25,29,.862,117
1158,LAL,2022-03-13,111,@,PHO,L 111-140,240,36,81,.444,20,41,.488,16,40,.400,23,31,.742,111,58,102,.569,46,69,.667,12,33,.364,12,14,.857,140
1159,PHO,2022-03-09,111,@,MIA,W 111-90,240,45,99,.455,34,62,.548,11,37,.297,10,10,1.000,111,35,88,.398,25,55,.455,10,33,.303,10,13,.769,90
1160,NOP,2022-03-08,111,@,MEM,L 111-132,240,41,88,.466,30,54,.556,11,34,.324,18,27,.667,111,48,101,.475,32,57,.561,16,44,.364,20,24,.833,132
1161,DAL,2022-03-07,111,,UTA,W 111-103,240,39,88,.443,22,42,.524,17,46,.370,16,20,.800,111,36,83,.434,24,52,.462,12,31,.387,19,24,.792,103
1162,DET,2022-03-04,111,,IND,W 111-106,240,42,94,.447,27,64,.422,15,30,.500,12,18,.667,111,39,100,.390,29,60,.483,10,40,.250,18,28,.643,106
1163,LAL,2022-03-03,111,@,LAC,L 111-132,240,41,84,.488,29,49,.592,12,35,.343,17,22,.773,111,51,93,.548,34,66,.515,17,27,.630,13,15,.867,132
1164,HOU,2022-02-25,111,@,ORL,L 111-119,240,44,94,.468,30,47,.638,14,47,.298,9,20,.450,111,42,83,.506,29,47,.617,13,36,.361,22,29,.759,119
1165,HOU,2022-02-17,111,@,LAC,L 111-142,240,42,91,.462,29,54,.537,13,37,.351,14,19,.737,111,51,92,.554,33,57,.579,18,35,.514,22,26,.846,142
1166,MIA,2022-02-17,111,@,CHO,W 111-107 (2OT),290,41,102,.402,27,54,.500,14,48,.292,15,23,.652,111,38,95,.400,28,53,.528,10,42,.238,21,30,.700,107
1167,BRK,2022-02-16,111,@,NYK,W 111-106,240,43,98,.439,32,64,.500,11,34,.324,14,23,.609,111,37,85,.435,21,42,.500,16,43,.372,16,18,.889,106
1168,BOS,2022-02-16,111,,DET,L 111-112,240,42,77,.545,29,45,.644,13,32,.406,14,18,.778,111,43,93,.462,27,63,.429,16,30,.533,10,13,.769,112
1169,ORL,2022-02-14,111,@,DEN,L 111-121,240,40,91,.440,29,52,.558,11,39,.282,20,23,.870,111,42,88,.477,26,48,.542,16,40,.400,21,23,.913,121
1170,BRK,2022-02-12,111,@,MIA,L 111-115,240,42,93,.452,30,53,.566,12,40,.300,15,22,.682,111,41,82,.500,31,53,.585,10,29,.345,23,29,.793,115
1171,UTA,2022-02-09,111,,GSW,W 111-85,240,41,89,.461,24,38,.632,17,51,.333,12,17,.706,111,28,78,.359,12,35,.343,16,43,.372,13,17,.765,85
1172,LAC,2022-02-03,111,,LAL,W 111-110,240,46,89,.517,33,59,.559,13,30,.433,6,11,.545,111,41,88,.466,30,59,.508,11,29,.379,17,25,.680,110
1173,NOP,2022-02-01,111,@,DET,W 111-101,240,39,89,.438,31,61,.508,8,28,.286,25,28,.893,111,41,84,.488,33,52,.635,8,32,.250,11,14,.786,101
1174,BRK,2022-02-01,111,@,PHO,L 111-121,240,40,81,.494,24,41,.585,16,40,.400,15,21,.714,111,42,76,.553,31,45,.689,11,31,.355,26,31,.839,121
1175,CHI,2022-01-26,111,,TOR,W 111-105,240,46,84,.548,39,58,.672,7,26,.269,12,16,.750,111,38,79,.481,26,48,.542,12,31,.387,17,28,.607,105
1176,LAC,2022-01-26,111,@,ORL,W 111-102,240,36,81,.444,21,52,.404,15,29,.517,24,27,.889,111,38,84,.452,29,49,.592,9,35,.257,17,22,.773,102
1177,CHI,2022-01-24,111,@,OKC,W 111-110,240,41,89,.461,26,50,.520,15,39,.385,14,19,.737,111,38,92,.413,22,47,.468,16,45,.356,18,24,.750,110
1178,DET,2022-01-23,111,@,DEN,L 111-117,240,42,75,.560,31,46,.674,11,29,.379,16,19,.842,111,44,85,.518,32,50,.640,12,35,.343,17,23,.739,117
1179,UTA,2022-01-21,111,,DET,W 111-101,240,36,79,.456,26,48,.542,10,31,.323,29,34,.853,111,38,87,.437,25,55,.455,13,32,.406,12,16,.750,101
1180,UTA,2022-01-19,111,,HOU,L 111-116,240,42,89,.472,32,51,.627,10,38,.263,17,20,.850,111,41,96,.427,19,51,.373,22,45,.489,12,17,.706,116
1181,IND,2022-01-19,111,@,LAL,W 111-104,240,44,90,.489,33,60,.550,11,30,.367,12,15,.800,111,40,90,.444,29,56,.518,11,34,.324,13,18,.722,104
1182,CHO,2022-01-19,111,@,BOS,W 111-102,240,42,86,.488,26,47,.553,16,39,.410,11,15,.733,111,39,90,.433,25,44,.568,14,46,.304,10,13,.769,102
1183,PHI,2022-01-14,111,,BOS,W 111-99,240,38,85,.447,24,44,.545,14,41,.341,21,25,.840,111,37,78,.474,26,47,.553,11,31,.355,14,18,.778,99
1184,CLE,2022-01-12,111,@,UTA,W 111-91,240,43,81,.531,32,51,.627,11,30,.367,14,17,.824,111,34,85,.400,18,38,.474,16,47,.340,7,11,.636,91
1185,NYK,2022-01-10,111,,SAS,W 111-96,240,40,82,.488,27,50,.540,13,32,.406,18,24,.750,111,39,95,.411,31,66,.470,8,29,.276,10,15,.667,96
1186,PHI,2022-01-10,111,@,HOU,W 111-91,240,43,94,.457,33,59,.559,10,35,.286,15,18,.833,111,30,77,.390,17,35,.486,13,42,.310,18,27,.667,91
1187,SAC,2022-01-07,111,@,DEN,L 111-121,240,40,92,.435,29,63,.460,11,29,.379,20,24,.833,111,47,85,.553,35,51,.686,12,34,.353,15,24,.625,121
1188,MIL,2022-01-05,111,,TOR,L 111-117,240,38,85,.447,21,46,.457,17,39,.436,18,26,.692,111,42,89,.472,26,53,.491,16,36,.444,17,25,.680,117
1189,WAS,2022-01-05,111,,HOU,L 111-114,240,40,91,.440,30,52,.577,10,39,.256,21,26,.808,111,40,85,.471,31,59,.525,9,26,.346,25,32,.781,114
1190,DET,2022-01-05,111,@,CHO,L 111-140,240,43,92,.467,29,50,.580,14,42,.333,11,20,.550,111,48,81,.593,24,39,.615,24,42,.571,20,29,.690,140
1191,ORL,2022-01-02,111,@,BOS,L 111-116 (OT),265,40,95,.421,31,68,.456,9,27,.333,22,27,.815,111,39,86,.453,26,50,.520,13,36,.361,25,28,.893,116
1192,HOU,2022-01-01,111,,DEN,L 111-124,240,37,85,.435,21,43,.488,16,42,.381,21,24,.875,111,46,86,.535,36,54,.667,10,32,.313,22,27,.815,124
1193,OKC,2021-12-28,111,@,SAC,L 111-117,240,35,90,.389,24,57,.421,11,33,.333,30,36,.833,111,40,95,.421,23,56,.411,17,39,.436,20,27,.741,117
1194,BOS,2021-12-22,111,,CLE,W 111-101,240,43,92,.467,32,62,.516,11,30,.367,14,18,.778,111,36,92,.391,27,54,.500,9,38,.237,20,24,.833,101
1195,NOP,2021-12-21,111,,POR,W 111-97,240,42,80,.525,30,47,.638,12,33,.364,15,18,.833,111,35,78,.449,22,44,.500,13,34,.382,14,19,.737,97
1196,MIN,2021-12-19,111,,DAL,W 111-105,240,36,77,.468,21,43,.488,15,34,.441,24,31,.774,111,36,82,.439,24,41,.585,12,41,.293,21,22,.955,105
1197,GSW,2021-12-17,111,@,BOS,W 111-107,240,39,90,.433,23,44,.523,16,46,.348,17,21,.810,111,36,82,.439,21,41,.512,15,41,.366,20,29,.690,107
1198,ATL,2021-12-15,111,@,ORL,W 111-99,240,42,85,.494,31,54,.574,11,31,.355,16,16,1.000,111,35,90,.389,25,55,.455,10,35,.286,19,21,.905,99
1199,PHO,2021-12-14,111,@,POR,W 111-107 (OT),265,44,93,.473,33,62,.532,11,31,.355,12,15,.800,111,40,96,.417,27,55,.491,13,41,.317,14,22,.636,107
1200,LAC,2021-12-13,111,,PHO,W 111-95,240,43,78,.551,34,57,.596,9,21,.429,16,23,.696,111,36,96,.375,29,67,.433,7,29,.241,16,19,.842,95
1201,POR,2021-12-12,111,,MIN,L 111-116,240,37,81,.457,19,33,.576,18,48,.375,19,28,.679,111,38,85,.447,24,49,.490,14,36,.389,26,32,.813,116
1202,PHO,2021-12-10,111,,BOS,W 111-90,240,43,96,.448,29,58,.500,14,38,.368,11,11,1.000,111,35,93,.376,31,67,.463,4,26,.154,16,24,.667,90
1203,DEN,2021-12-09,111,@,SAS,L 111-123,240,42,94,.447,27,55,.491,15,39,.385,12,13,.923,111,46,88,.523,31,53,.585,15,35,.429,16,22,.727,123
1204,BOS,2021-12-08,111,@,LAC,L 111-114,240,41,86,.477,31,54,.574,10,32,.313,19,21,.905,111,40,85,.471,26,53,.491,14,32,.438,20,22,.909,114
1205,CHI,2021-12-04,111,@,BRK,W 111-107,240,41,86,.477,31,55,.564,10,31,.323,19,27,.704,111,46,111,.414,38,86,.442,8,25,.320,7,9,.778,107
1206,CLE,2021-12-01,111,@,MIA,W 111-85,240,37,68,.544,21,37,.568,16,31,.516,21,23,.913,111,32,85,.376,20,48,.417,12,37,.324,9,13,.692,85
1207,IND,2021-12-01,111,,ATL,L 111-114,240,44,90,.489,34,57,.596,10,33,.303,13,16,.813,111,44,86,.512,28,53,.528,16,33,.485,10,12,.833,114
1208,MIA,2021-11-29,111,,DEN,L 111-120,240,43,91,.473,28,47,.596,15,44,.341,10,15,.667,111,43,74,.581,25,39,.641,18,35,.514,16,21,.762,120
1209,SAS,2021-11-22,111,,PHO,L 111-115,240,49,93,.527,44,73,.603,5,20,.250,8,16,.500,111,45,88,.511,33,61,.541,12,27,.444,13,16,.813,115
1210,PHI,2021-11-20,111,@,POR,L 111-118,240,41,81,.506,31,53,.585,10,28,.357,19,21,.905,111,40,80,.500,25,46,.543,15,34,.441,23,23,1.000,118
1211,IND,2021-11-20,111,,NOP,W 111-94,240,42,91,.462,28,53,.528,14,38,.368,13,18,.722,111,35,88,.398,29,70,.414,6,18,.333,18,19,.947,94
1212,BOS,2021-11-20,111,,OKC,W 111-105,240,41,88,.466,24,49,.490,17,39,.436,12,14,.857,111,39,96,.406,21,54,.389,18,42,.429,9,16,.563,105
1213,DAL,2021-11-15,111,,DEN,W 111-101,240,45,90,.500,31,54,.574,14,36,.389,7,10,.700,111,40,84,.476,31,52,.596,9,32,.281,12,17,.706,101
1214,ORL,2021-11-15,111,@,ATL,L 111-129,240,43,95,.453,27,52,.519,16,43,.372,9,14,.643,111,47,85,.553,33,55,.600,14,30,.467,21,32,.656,129
1215,MIA,2021-11-13,111,@,UTA,W 111-105,240,42,85,.494,29,52,.558,13,33,.394,14,16,.875,111,35,85,.412,18,32,.563,17,53,.321,18,25,.720,105
1216,IND,2021-11-11,111,@,UTA,W 111-100,240,43,96,.448,32,65,.492,11,31,.355,14,19,.737,111,39,83,.470,30,51,.588,9,32,.281,13,23,.565,100
1217,HOU,2021-11-04,111,@,PHO,L 111-123,240,38,88,.432,27,56,.482,11,32,.344,24,28,.857,111,44,93,.473,30,62,.484,14,31,.452,21,23,.913,123
1218,IND,2021-11-03,111,,NYK,W 111-98,240,42,91,.462,26,50,.520,16,41,.390,11,14,.786,111,36,87,.414,31,63,.492,5,24,.208,21,27,.778,98
1219,WAS,2021-11-01,111,@,ATL,L 111-118,240,41,86,.477,28,47,.596,13,39,.333,16,16,1.000,111,38,83,.458,25,49,.510,13,34,.382,29,29,1.000,118
1220,POR,2021-10-29,111,,LAC,W 111-92,240,41,98,.418,22,57,.386,19,41,.463,10,16,.625,111,34,87,.391,19,45,.422,15,42,.357,9,16,.563,92
1221,ATL,2021-10-28,111,@,WAS,L 111-122,240,48,88,.545,42,67,.627,6,21,.286,9,14,.643,111,46,99,.465,33,65,.508,13,34,.382,17,21,.810,122
1222,ORL,2021-10-27,111,,CHO,L 111-120,240,43,88,.489,28,48,.583,15,40,.375,10,13,.769,111,43,83,.518,29,53,.547,14,30,.467,20,24,.833,120
1223,CHI,2021-10-25,111,@,TOR,W 111-108,240,39,81,.481,27,54,.500,12,27,.444,21,22,.955,111,40,83,.482,28,53,.528,12,30,.400,16,20,.800,108
1224,CHO,2021-10-24,111,@,BRK,W 111-95,240,43,94,.457,33,64,.516,10,30,.333,15,19,.789,111,38,87,.437,29,52,.558,9,35,.257,10,12,.833,95
1225,SAS,2021-10-23,111,,MIL,L 111-121,240,48,99,.485,38,60,.633,10,39,.256,5,6,.833,111,44,83,.530,29,48,.604,15,35,.429,18,22,.818,121
1226,MEM,2022-04-10,110,,BOS,L 110-139,240,39,102,.382,24,55,.436,15,47,.319,17,27,.630,110,54,99,.545,36,51,.706,18,48,.375,13,13,1.000,139
1227,BRK,2022-04-06,110,@,NYK,W 110-98,240,41,93,.441,27,52,.519,14,41,.341,14,18,.778,110,32,83,.386,19,45,.422,13,38,.342,21,36,.583,98
1228,LAL,2022-04-05,110,@,PHO,L 110-121,240,39,86,.453,30,57,.526,9,29,.310,23,30,.767,110,50,102,.490,36,63,.571,14,39,.359,7,9,.778,121
1229,DET,2022-04-01,110,@,OKC,W 110-101,240,40,94,.426,25,46,.543,15,48,.313,15,18,.833,110,36,84,.429,25,50,.500,11,34,.324,18,29,.621,101
1230,ORL,2022-03-30,110,@,WAS,L 110-127,240,40,96,.417,29,62,.468,11,34,.324,19,22,.864,110,47,92,.511,34,56,.607,13,36,.361,20,26,.769,127
1231,LAL,2022-03-29,110,@,DAL,L 110-128,240,40,89,.449,28,45,.622,12,44,.273,18,22,.818,110,45,87,.517,25,41,.610,20,46,.435,18,23,.783,128
1232,BRK,2022-03-27,110,,CHO,L 110-119,240,43,97,.443,36,63,.571,7,34,.206,17,26,.654,110,42,98,.429,25,66,.379,17,32,.531,18,23,.783,119
1233,BRK,2022-03-26,110,@,MIA,W 110-95,240,39,83,.470,28,50,.560,11,33,.333,21,26,.808,110,33,75,.440,23,41,.561,10,34,.294,19,26,.731,95
1234,ORL,2022-03-26,110,,SAC,L 110-114 (OT),265,45,106,.425,32,70,.457,13,36,.361,7,7,1.000,110,42,98,.429,31,62,.500,11,36,.306,19,24,.792,114
1235,GSW,2022-03-25,110,@,ATL,L 110-121,240,43,90,.478,29,49,.592,14,41,.341,10,13,.769,110,46,89,.517,32,52,.615,14,37,.378,15,19,.789,121
1236,SAC,2022-03-23,110,@,IND,W 110-109,240,43,82,.524,31,45,.689,12,37,.324,12,17,.706,110,42,91,.462,28,55,.509,14,36,.389,11,11,1.000,109
1237,DAL,2022-03-23,110,,HOU,W 110-91,240,42,86,.488,34,53,.642,8,33,.242,18,22,.818,110,33,82,.402,29,54,.537,4,28,.143,21,28,.750,91
1238,DAL,2022-03-21,110,,MIN,W 110-108,240,40,83,.482,26,37,.703,14,46,.304,16,21,.762,110,36,91,.396,23,55,.418,13,36,.361,23,29,.793,108
1239,SAS,2022-03-20,110,@,GSW,W 110-108,240,38,98,.388,23,58,.397,15,40,.375,19,25,.760,110,41,90,.456,30,57,.526,11,33,.333,15,21,.714,108
1240,CHI,2022-03-16,110,@,UTA,L 110-125,240,43,91,.473,31,57,.544,12,34,.353,12,17,.706,110,42,83,.506,23,44,.523,19,39,.487,22,29,.759,125
1241,BOS,2022-03-16,110,@,GSW,W 110-88,240,38,81,.469,23,41,.561,15,40,.375,19,22,.864,110,32,86,.372,21,38,.553,11,48,.229,13,16,.813,88
1242,PHI,2022-03-14,110,,DEN,L 110-114,240,36,84,.429,24,51,.471,12,33,.364,26,32,.813,110,44,82,.537,31,49,.633,13,33,.394,13,20,.650,114
1243,BRK,2022-03-13,110,,NYK,W 110-107,240,44,89,.494,38,60,.633,6,29,.207,16,22,.727,110,39,83,.470,28,54,.519,11,29,.379,18,21,.857,107
1244,MIN,2022-03-11,110,@,ORL,L 110-118,240,41,90,.456,26,45,.578,15,45,.333,13,13,1.000,110,40,86,.465,24,46,.522,16,40,.400,22,25,.880,118
1245,ATL,2022-03-07,110,@,DET,L 110-113 (OT),265,42,93,.452,31,55,.564,11,38,.289,15,22,.682,110,43,93,.462,31,60,.517,12,33,.364,15,23,.652,113
1246,LAL,2022-03-07,110,@,SAS,L 110-117,240,43,91,.473,35,65,.538,8,26,.308,16,23,.696,110,46,84,.548,37,58,.638,9,26,.346,16,30,.533,117
1247,OKC,2022-02-28,110,,SAC,L 110-131,240,40,86,.465,29,51,.569,11,35,.314,19,27,.704,110,49,87,.563,39,56,.696,10,31,.323,23,30,.767,131
1248,SAC,2022-02-26,110,@,DEN,L 110-115,240,38,89,.427,29,59,.492,9,30,.300,25,33,.758,110,38,82,.463,22,39,.564,16,43,.372,23,29,.793,115
1249,CHI,2022-02-26,110,,MEM,L 110-116,240,39,93,.419,30,73,.411,9,20,.450,23,30,.767,110,44,100,.440,37,77,.481,7,23,.304,21,26,.808,116
1250,SAC,2022-02-24,110,,DEN,L 110-128,240,43,86,.500,34,57,.596,9,29,.310,15,18,.833,110,48,86,.558,33,51,.647,15,35,.429,17,20,.850,128
1251,DEN,2022-02-12,110,@,TOR,W 110-109,240,39,84,.464,25,47,.532,14,37,.378,18,21,.857,110,43,88,.489,31,54,.574,12,34,.353,11,17,.647,109
1252,WAS,2022-02-12,110,,SAC,L 110-123,240,41,88,.466,28,50,.560,13,38,.342,15,21,.714,110,43,76,.566,31,48,.646,12,28,.429,25,29,.862,123
1253,NOP,2022-02-08,110,,HOU,W 110-97,240,42,80,.525,34,48,.708,8,32,.250,18,20,.900,110,32,86,.372,19,44,.432,13,42,.310,20,31,.645,97
1254,GSW,2022-02-07,110,@,OKC,W 110-98,240,41,82,.500,26,39,.667,15,43,.349,13,17,.765,110,37,90,.411,26,54,.481,11,36,.306,13,17,.765,98
1255,LAL,2022-02-03,110,@,LAC,L 110-111,240,41,88,.466,30,59,.508,11,29,.379,17,25,.680,110,46,89,.517,33,59,.559,13,30,.433,6,11,.545,111
1256,TOR,2022-02-01,110,,MIA,W 110-106,240,39,81,.481,27,55,.491,12,26,.462,20,29,.690,110,38,78,.487,30,48,.625,8,30,.267,22,25,.880,106
1257,SAS,2022-01-30,110,@,PHO,L 110-115,240,45,100,.450,32,63,.508,13,37,.351,7,8,.875,110,48,97,.495,37,65,.569,11,32,.344,8,12,.667,115
1258,ORL,2022-01-30,110,,DAL,W 110-108,240,43,84,.512,32,50,.640,11,34,.324,13,16,.813,110,39,81,.481,23,43,.535,16,38,.421,14,18,.778,108
1259,GSW,2022-01-29,110,,BRK,W 110-106,240,40,98,.408,26,53,.491,14,45,.311,16,18,.889,110,39,98,.398,28,70,.400,11,28,.393,17,21,.810,106
1260,OKC,2022-01-28,110,,IND,L 110-113 (OT),265,43,95,.453,29,52,.558,14,43,.326,10,17,.588,110,41,95,.432,28,56,.500,13,39,.333,18,29,.621,113
1261,HOU,2022-01-28,110,,POR,L 110-125,240,38,79,.481,28,38,.737,10,41,.244,24,31,.774,110,46,81,.568,29,42,.690,17,39,.436,16,20,.800,125
1262,SAS,2022-01-26,110,,MEM,L 110-118,240,43,94,.457,34,57,.596,9,37,.243,15,19,.789,110,46,90,.511,39,67,.582,7,23,.304,19,26,.731,118
1263,MIA,2022-01-26,110,,NYK,W 110-96,240,37,74,.500,21,37,.568,16,37,.432,20,22,.909,110,35,83,.422,20,39,.513,15,44,.341,11,17,.647,96
1264,DEN,2022-01-25,110,@,DET,W 110-105,240,36,84,.429,25,52,.481,11,32,.344,27,31,.871,110,41,97,.423,29,61,.475,12,36,.333,11,14,.786,105
1265,OKC,2022-01-24,110,,CHI,L 110-111,240,38,92,.413,22,47,.468,16,45,.356,18,24,.750,110,41,89,.461,26,50,.520,15,39,.385,14,19,.737,111
1266,NYK,2022-01-23,110,,LAC,W 110-102,240,39,91,.429,23,55,.418,16,36,.444,16,19,.842,110,34,79,.430,20,38,.526,14,41,.341,20,30,.667,102
1267,ATL,2022-01-21,110,,MIA,W 110-108,240,38,68,.559,24,35,.686,14,33,.424,20,24,.833,110,41,85,.482,26,45,.578,15,40,.375,11,12,.917,108
1268,ORL,2022-01-19,110,@,PHI,L 110-123,240,40,90,.444,22,55,.400,18,35,.514,12,16,.750,110,45,83,.542,35,55,.636,10,28,.357,23,27,.852,123
1269,NYK,2022-01-18,110,,MIN,L 110-112,240,37,80,.463,25,42,.595,12,38,.316,24,33,.727,110,35,81,.432,22,40,.550,13,41,.317,29,38,.763,112
1270,WAS,2022-01-15,110,,POR,L 110-115,240,39,90,.433,27,53,.509,12,37,.324,20,23,.870,110,39,85,.459,26,46,.565,13,39,.333,24,35,.686,115
1271,MEM,2022-01-04,110,@,CLE,W 110-106,240,42,90,.467,33,63,.524,9,27,.333,17,22,.773,110,40,92,.435,30,58,.517,10,34,.294,16,21,.762,106
1272,NOP,2022-01-04,110,,PHO,L 110-123,240,36,89,.404,26,56,.464,10,33,.303,28,32,.875,110,46,85,.541,29,54,.537,17,31,.548,14,20,.700,123
1273,HOU,2021-12-31,110,,MIA,L 110-120,240,41,93,.441,27,51,.529,14,42,.333,14,17,.824,110,40,86,.465,26,53,.491,14,33,.424,26,31,.839,120
1274,WAS,2021-12-30,110,,CLE,W 110-93,240,45,90,.500,36,61,.590,9,29,.310,11,17,.647,110,35,83,.422,27,55,.491,8,28,.286,15,23,.652,93
1275,PHI,2021-12-30,110,@,BRK,W 110-102,240,42,100,.420,29,68,.426,13,32,.406,13,20,.650,110,37,81,.457,30,54,.556,7,27,.259,21,27,.778,102
1276,ORL,2021-12-28,110,,MIL,L 110-127,240,38,83,.458,26,44,.591,12,39,.308,22,26,.846,110,47,85,.553,30,48,.625,17,37,.459,16,22,.727,127
1277,UTA,2021-12-27,110,@,SAS,W 110-104,240,39,86,.453,30,55,.545,9,31,.290,23,30,.767,110,45,100,.450,35,70,.500,10,30,.333,4,9,.444,104
1278,LAL,2021-12-23,110,,SAS,L 110-138,240,44,94,.468,39,67,.582,5,27,.185,17,30,.567,110,46,95,.484,28,56,.500,18,39,.462,28,33,.848,138
1279,NOP,2021-12-23,110,@,ORL,W 110-104,240,37,86,.430,24,56,.429,13,30,.433,23,26,.885,110,38,88,.432,29,56,.518,9,32,.281,19,21,.905,104
1280,LAL,2021-12-19,110,@,CHI,L 110-115,240,42,82,.512,30,48,.625,12,34,.353,14,22,.636,110,40,93,.430,30,63,.476,10,30,.333,25,31,.806,115
1281,MIN,2021-12-17,110,,LAL,W 110-92,240,41,98,.418,29,54,.537,12,44,.273,16,24,.667,110,30,78,.385,18,35,.514,12,43,.279,20,29,.690,92
1282,OKC,2021-12-15,110,,NOP,L 110-113,240,39,93,.419,26,58,.448,13,35,.371,19,19,1.000,110,39,80,.488,28,52,.538,11,28,.393,24,36,.667,113
1283,OKC,2021-12-08,110,@,TOR,W 110-109,240,38,84,.452,21,44,.477,17,40,.425,17,20,.850,110,42,93,.452,27,52,.519,15,41,.366,10,15,.667,109
1284,PHI,2021-12-08,110,@,CHO,W 110-106,240,36,75,.480,23,41,.561,13,34,.382,25,30,.833,110,39,80,.488,29,51,.569,10,29,.345,18,21,.857,106
1285,WAS,2021-12-06,110,@,IND,L 110-116,240,43,81,.531,36,66,.545,7,15,.467,17,21,.810,110,43,82,.524,34,59,.576,9,23,.391,21,22,.955,116
1286,MIN,2021-12-06,110,,ATL,L 110-121,240,39,98,.398,22,58,.379,17,40,.425,15,19,.789,110,40,90,.444,15,41,.366,25,49,.510,16,19,.842,121
1287,BRK,2021-12-03,110,,MIN,W 110-105,240,36,76,.474,30,53,.566,6,23,.261,32,41,.780,110,36,93,.387,23,51,.451,13,42,.310,20,24,.833,105
1288,OKC,2021-12-01,110,,HOU,L 110-114,240,40,85,.471,32,53,.604,8,32,.250,22,29,.759,110,40,79,.506,25,42,.595,15,37,.405,19,22,.864,114
1289,NYK,2021-11-30,110,@,BRK,L 110-112,240,44,91,.484,33,59,.559,11,32,.344,11,12,.917,110,41,85,.482,33,57,.579,8,28,.286,22,25,.880,112
1290,POR,2021-11-30,110,,DET,W 110-92,240,41,96,.427,27,54,.500,14,42,.333,14,18,.778,110,29,76,.382,20,41,.488,9,35,.257,25,30,.833,92
1291,LAL,2021-11-28,110,,DET,W 110-106,240,43,86,.500,34,54,.630,9,32,.281,15,25,.600,110,38,89,.427,25,56,.446,13,33,.394,17,19,.895,106
1292,UTA,2021-11-24,110,@,OKC,W 110-104,240,39,86,.453,24,39,.615,15,47,.319,17,20,.850,110,37,82,.451,22,46,.478,15,36,.417,15,22,.682,104
1293,MIN,2021-11-22,110,@,NOP,W 110-96,240,40,100,.400,30,56,.536,10,44,.227,20,28,.714,110,37,88,.420,31,56,.554,6,32,.188,16,18,.889,96
1294,ATL,2021-11-17,110,,BOS,W 110-99,240,41,81,.506,28,44,.636,13,37,.351,15,18,.833,110,37,84,.440,26,43,.605,11,41,.268,14,17,.824,99
1295,MIN,2021-11-10,110,@,GSW,L 110-123,240,39,95,.411,22,51,.431,17,44,.386,15,20,.750,110,40,85,.471,29,45,.644,11,40,.275,32,40,.800,123
1296,UTA,2021-11-09,110,,ATL,W 110-98,240,41,81,.506,26,43,.605,15,38,.395,13,16,.813,110,37,85,.435,19,50,.380,18,35,.514,6,10,.600,98
1297,POR,2021-11-05,110,,IND,W 110-106,240,40,82,.488,23,43,.535,17,39,.436,13,15,.867,110,43,88,.489,29,46,.630,14,42,.333,6,10,.600,106
1298,CHO,2021-11-05,110,@,SAC,L 110-140,240,43,92,.467,32,57,.561,11,35,.314,13,21,.619,110,48,87,.552,26,43,.605,22,44,.500,22,26,.846,140
1299,DAL,2021-11-02,110,,MIA,L 110-125,240,37,84,.440,23,42,.548,14,42,.333,22,31,.710,110,43,83,.518,30,58,.517,13,25,.520,26,30,.867,125
1300,CHO,2021-11-01,110,,CLE,L 110-113,240,42,101,.416,27,62,.435,15,39,.385,11,15,.733,110,39,90,.433,30,62,.484,9,28,.321,26,38,.684,113
1301,DET,2021-10-30,110,,ORL,W 110-103,240,36,89,.404,22,46,.478,14,43,.326,24,30,.800,110,38,87,.437,22,55,.400,16,32,.500,11,15,.733,103
1302,TOR,2021-10-29,110,,ORL,W 110-109,240,43,86,.500,34,56,.607,9,30,.300,15,22,.682,110,41,87,.471,25,53,.472,16,34,.471,11,16,.688,109
1303,PHI,2021-10-28,110,,DET,W 110-102,240,38,76,.500,26,49,.531,12,27,.444,22,24,.917,110,35,86,.407,22,47,.468,13,39,.333,19,27,.704,102
1304,SAC,2021-10-27,110,@,PHO,W 110-107,240,42,95,.442,27,57,.474,15,38,.395,11,15,.733,110,42,93,.452,36,71,.507,6,22,.273,17,24,.708,107
1305,DEN,2021-10-26,110,@,UTA,L 110-122,240,42,83,.506,32,55,.582,10,28,.357,16,24,.667,110,44,85,.518,32,46,.696,12,39,.308,22,29,.759,122
1306,ORL,2021-10-24,110,@,NYK,W 110-104,240,36,88,.409,24,45,.533,12,43,.279,26,34,.765,110,37,100,.370,24,52,.462,13,48,.271,17,25,.680,104
1307,UTA,2021-10-22,110,@,SAC,W 110-101,240,37,90,.411,21,48,.438,16,42,.381,20,23,.870,110,39,99,.394,31,63,.492,8,36,.222,15,21,.714,101
1308,DEN,2021-10-20,110,@,PHO,W 110-98,240,44,83,.530,27,44,.614,17,39,.436,5,9,.556,110,36,87,.414,22,50,.440,14,37,.378,12,17,.706,98
1309,PHO,2022-04-10,109,,SAC,L 109-116,240,42,103,.408,28,56,.500,14,47,.298,11,15,.733,109,40,76,.526,26,50,.520,14,26,.538,22,30,.733,116
1310,ATL,2022-04-08,109,@,MIA,L 109-113,240,42,88,.477,34,54,.630,8,34,.235,17,19,.895,109,40,72,.556,29,46,.630,11,26,.423,22,28,.786,113
1311,MEM,2022-04-07,109,@,DEN,L 109-122,240,42,89,.472,31,61,.508,11,28,.393,14,19,.737,109,44,80,.550,32,50,.640,12,30,.400,22,25,.880,122
1312,PHO,2022-04-06,109,@,LAC,L 109-113,240,42,108,.389,25,60,.417,17,48,.354,8,12,.667,109,33,75,.440,21,41,.512,12,34,.353,35,44,.795,113
1313,SAC,2022-04-05,109,,NOP,L 109-123,240,39,76,.513,28,46,.609,11,30,.367,20,22,.909,109,45,88,.511,33,63,.524,12,25,.480,21,26,.808,123
1314,TOR,2022-04-03,109,,MIA,L 109-114,240,35,83,.422,23,44,.523,12,39,.308,27,34,.794,109,41,79,.519,23,41,.561,18,38,.474,14,22,.636,114
1315,GSW,2022-04-03,109,@,SAC,W 109-90,240,41,79,.519,25,45,.556,16,34,.471,11,15,.733,109,31,81,.383,24,48,.500,7,33,.212,21,24,.875,90
1316,CHI,2022-04-02,109,,MIA,L 109-127,240,37,86,.430,28,52,.538,9,34,.265,26,29,.897,109,44,82,.537,27,48,.563,17,34,.500,22,27,.815,127
1317,LAL,2022-03-31,109,@,UTA,L 109-122,240,41,83,.494,34,58,.586,7,25,.280,20,28,.714,109,46,90,.511,31,46,.674,15,44,.341,15,24,.625,122
1318,CHO,2022-03-28,109,,DEN,L 109-113,240,44,93,.473,31,51,.608,13,42,.310,8,12,.667,109,40,86,.465,28,53,.528,12,33,.364,21,28,.750,113
1319,NYK,2022-03-28,109,,CHI,W 109-104,240,38,89,.427,26,54,.481,12,35,.343,21,35,.600,109,34,79,.430,28,56,.500,6,23,.261,30,33,.909,104
1320,CHI,2022-03-24,109,@,NOP,L 109-126,240,40,78,.513,26,44,.591,14,34,.412,15,19,.789,109,41,83,.494,29,54,.537,12,29,.414,32,34,.941,126
1321,IND,2022-03-23,109,,SAC,L 109-110,240,42,91,.462,28,55,.509,14,36,.389,11,11,1.000,109,43,82,.524,31,45,.689,12,37,.324,12,17,.706,110
1322,DET,2022-03-19,109,@,CLE,L 109-113,240,41,85,.482,28,55,.509,13,30,.433,14,19,.737,109,45,88,.511,35,62,.565,10,26,.385,13,23,.565,113
1323,WAS,2022-03-16,109,,DEN,L 109-127,240,41,87,.471,36,64,.563,5,23,.217,22,31,.710,109,46,90,.511,31,53,.585,15,37,.405,20,21,.952,127
1324,MIL,2022-03-12,109,@,GSW,L 109-122,240,38,92,.413,21,48,.438,17,44,.386,16,23,.696,109,45,93,.484,27,48,.563,18,45,.400,14,15,.933,122
1325,WAS,2022-03-11,109,@,LAL,L 109-122,240,39,85,.459,30,58,.517,9,27,.333,22,33,.667,109,48,91,.527,34,60,.567,14,31,.452,12,17,.706,122
1326,WAS,2022-03-09,109,@,LAC,L 109-115,240,41,87,.471,31,60,.517,10,27,.370,17,20,.850,109,43,86,.500,27,54,.500,16,32,.500,13,13,1.000,115
1327,DAL,2022-03-01,109,@,LAL,W 109-104,240,41,82,.500,31,47,.660,10,35,.286,17,27,.630,109,37,82,.451,23,48,.479,14,34,.412,16,20,.800,104
1328,TOR,2022-03-01,109,,BRK,W 109-108,240,41,90,.456,34,67,.507,7,23,.304,20,23,.870,109,42,84,.500,32,59,.542,10,25,.400,14,19,.737,108
1329,NYK,2022-02-27,109,,PHI,L 109-125,240,38,85,.447,27,52,.519,11,33,.333,22,35,.629,109,38,78,.487,28,45,.622,10,33,.303,39,44,.886,125
1330,DAL,2022-02-25,109,@,UTA,L 109-114,240,42,88,.477,25,49,.510,17,39,.436,8,8,1.000,109,40,74,.541,24,36,.667,16,38,.421,18,22,.818,114
1331,ORL,2022-02-16,109,,ATL,L 109-130,240,42,98,.429,29,57,.509,13,41,.317,12,13,.923,109,45,90,.500,27,57,.474,18,33,.545,22,28,.786,130
1332,NOP,2022-02-15,109,,MEM,L 109-121,240,44,88,.500,40,62,.645,4,26,.154,17,20,.850,109,47,94,.500,37,60,.617,10,34,.294,17,27,.630,121
1333,SAS,2022-02-14,109,@,CHI,L 109-120,240,44,92,.478,38,72,.528,6,20,.300,15,21,.714,109,46,88,.523,36,64,.563,10,24,.417,18,21,.857,120
1334,BRK,2022-02-14,109,,SAC,W 109-85,240,43,84,.512,34,58,.586,9,26,.346,14,15,.933,109,31,90,.344,22,55,.400,9,35,.257,14,18,.778,85
1335,TOR,2022-02-12,109,,DEN,L 109-110,240,43,88,.489,31,54,.574,12,34,.353,11,17,.647,109,39,84,.464,25,47,.532,14,37,.378,18,21,.857,110
1336,CHO,2022-02-09,109,,CHI,L 109-121,240,40,93,.430,27,50,.540,13,43,.302,16,23,.696,109,46,82,.561,30,49,.612,16,33,.485,13,19,.684,121
1337,LAC,2022-02-08,109,@,MEM,L 109-135,240,40,89,.449,29,58,.500,11,31,.355,18,24,.750,109,53,103,.515,44,77,.571,9,26,.346,20,25,.800,135
1338,PHI,2022-02-08,109,,PHO,L 109-114,240,41,89,.461,31,57,.544,10,32,.313,17,18,.944,109,43,95,.453,37,69,.536,6,26,.231,22,24,.917,114
1339,UTA,2022-01-28,109,@,MEM,L 109-119,240,37,85,.435,20,39,.513,17,46,.370,18,21,.857,109,46,82,.561,37,59,.627,9,23,.391,18,24,.750,119
1340,MIN,2022-01-25,109,@,POR,W 109-107,240,36,82,.439,22,39,.564,14,43,.326,23,31,.742,109,37,94,.394,21,53,.396,16,41,.390,17,20,.850,107
1341,UTA,2022-01-24,109,@,PHO,L 109-115,240,40,81,.494,26,50,.520,14,31,.452,15,22,.682,109,47,99,.475,34,63,.540,13,36,.361,8,15,.533,115
1342,SAS,2022-01-23,109,,PHI,L 109-115,240,42,89,.472,32,59,.542,10,30,.333,15,22,.682,109,44,92,.478,37,76,.487,7,16,.438,20,23,.870,115
1343,POR,2022-01-21,109,@,BOS,W 109-105,240,36,76,.474,20,43,.465,16,33,.485,21,30,.700,109,37,82,.451,26,45,.578,11,37,.297,20,23,.870,105
1344,TOR,2022-01-21,109,@,WAS,W 109-105,240,42,90,.467,31,60,.517,11,30,.367,14,17,.824,109,43,85,.506,32,52,.615,11,33,.333,8,10,.800,105
1345,PHO,2022-01-20,109,@,DAL,W 109-101,240,39,86,.453,31,50,.620,8,36,.222,23,25,.920,109,37,85,.435,26,48,.542,11,37,.297,16,20,.800,101
1346,PHI,2022-01-15,109,@,MIA,W 109-98,240,40,79,.506,27,47,.574,13,32,.406,16,21,.762,109,33,86,.384,24,51,.471,9,35,.257,23,30,.767,98
1347,SAS,2022-01-14,109,,CLE,L 109-114,240,42,92,.457,27,58,.466,15,34,.441,10,13,.769,109,46,95,.484,38,75,.507,8,20,.400,14,24,.583,114
1348,CHO,2022-01-14,109,,ORL,L 109-116,240,40,97,.412,28,55,.509,12,42,.286,17,21,.810,109,45,87,.517,30,42,.714,15,45,.333,11,15,.733,116
1349,BRK,2022-01-13,109,,OKC,L 109-130,240,41,98,.418,34,66,.515,7,32,.219,20,22,.909,109,47,91,.516,27,46,.587,20,45,.444,16,18,.889,130
1350,CHO,2022-01-12,109,@,PHI,W 109-98,240,46,89,.517,36,55,.655,10,34,.294,7,8,.875,109,34,73,.466,22,43,.512,12,30,.400,18,28,.643,98
1351,CLE,2022-01-10,109,@,SAC,W 109-108,240,43,87,.494,33,53,.623,10,34,.294,13,15,.867,109,39,91,.429,25,61,.410,14,30,.467,16,22,.727,108
1352,BRK,2022-01-07,109,,MIL,L 109-121,240,42,92,.457,36,65,.554,6,27,.222,19,20,.950,109,44,96,.458,28,51,.549,16,45,.356,17,21,.810,121
1353,POR,2022-01-05,109,,MIA,L 109-115,240,33,78,.423,18,40,.450,15,38,.395,28,36,.778,109,37,82,.451,18,41,.439,19,41,.463,22,29,.759,115
1354,DEN,2022-01-05,109,,UTA,L 109-115,240,42,88,.477,31,52,.596,11,36,.306,14,15,.933,109,43,92,.467,29,51,.569,14,41,.341,15,18,.833,115
1355,TOR,2021-12-28,109,,PHI,L 109-114,240,38,87,.437,23,46,.500,15,41,.366,18,22,.818,109,34,77,.442,20,47,.426,14,30,.467,32,38,.842,114
1356,DET,2021-12-26,109,@,SAS,L 109-144,240,38,98,.388,30,66,.455,8,32,.250,25,34,.735,109,51,91,.560,38,64,.594,13,27,.481,29,37,.784,144
1357,WAS,2021-12-18,109,@,UTA,W 109-103,240,42,94,.447,33,63,.524,9,31,.290,16,20,.800,109,35,81,.432,21,37,.568,14,44,.318,19,30,.633,103
1358,NOP,2021-12-10,109,,DET,W 109-93,240,41,95,.432,28,58,.483,13,37,.351,14,16,.875,109,35,90,.389,23,53,.434,12,37,.324,11,12,.917,93
1359,TOR,2021-12-08,109,,OKC,L 109-110,240,42,93,.452,27,52,.519,15,41,.366,10,15,.667,109,38,84,.452,21,44,.477,17,40,.425,17,20,.850,110
1360,SAS,2021-12-07,109,,NYK,L 109-121,240,41,92,.446,29,61,.475,12,31,.387,15,20,.750,109,43,91,.473,25,53,.472,18,38,.474,17,19,.895,121
1361,CHI,2021-12-06,109,,DEN,W 109-97,240,41,91,.451,28,56,.500,13,35,.371,14,20,.700,109,38,96,.396,27,64,.422,11,32,.344,10,15,.667,97
1362,UTA,2021-12-05,109,@,CLE,W 109-108,240,40,90,.444,20,42,.476,20,48,.417,9,10,.900,109,42,91,.462,28,53,.528,14,38,.368,10,13,.769,108
1363,BOS,2021-11-28,109,@,TOR,W 109-97,240,34,82,.415,22,48,.458,12,34,.353,29,31,.935,109,35,93,.376,22,51,.431,13,42,.310,14,16,.875,97
1364,DEN,2021-11-26,109,,MIL,L 109-120,240,40,92,.435,23,45,.511,17,47,.362,12,14,.857,109,46,73,.630,30,40,.750,16,33,.485,12,20,.600,120
1365,CHO,2021-11-22,109,@,WAS,W 109-103,240,40,91,.440,25,60,.417,15,31,.484,14,24,.583,109,36,94,.383,27,57,.474,9,37,.243,22,27,.815,103
1366,IND,2021-11-22,109,@,CHI,W 109-77,240,40,90,.444,27,59,.458,13,31,.419,16,18,.889,109,31,85,.365,25,57,.439,6,28,.214,9,15,.600,77
1367,CHI,2021-11-21,109,,NYK,W 109-103,240,37,88,.420,26,59,.441,11,29,.379,24,27,.889,109,35,84,.417,28,57,.491,7,27,.259,26,31,.839,103
1368,BRK,2021-11-17,109,,CLE,W 109-99,240,38,83,.458,26,51,.510,12,32,.375,21,25,.840,109,35,89,.393,24,45,.533,11,44,.250,18,21,.857,99
1369,MIL,2021-11-17,109,,LAL,W 109-102,240,40,87,.460,28,50,.560,12,37,.324,17,24,.708,109,40,96,.417,28,53,.528,12,43,.279,10,12,.833,102
1370,SAS,2021-11-12,109,,DAL,L 109-123,240,41,84,.488,28,54,.519,13,30,.433,14,20,.700,109,46,100,.460,28,55,.509,18,45,.400,13,19,.684,123
1371,MIA,2021-11-11,109,@,LAC,L 109-112,240,43,97,.443,34,56,.607,9,41,.220,14,17,.824,109,43,91,.473,32,54,.593,11,37,.297,15,17,.882,112
1372,PHI,2021-11-11,109,,TOR,L 109-115,240,40,88,.455,29,54,.537,11,34,.324,18,19,.947,109,42,96,.438,28,63,.444,14,33,.424,17,17,1.000,115
1373,POR,2021-11-10,109,@,PHO,L 109-119,240,44,91,.484,37,61,.607,7,30,.233,14,16,.875,109,49,94,.521,38,66,.576,11,28,.393,10,12,.833,119
1374,POR,2021-11-09,109,@,LAC,L 109-117,240,43,91,.473,29,54,.537,14,37,.378,9,12,.750,109,44,85,.518,28,55,.509,16,30,.533,13,19,.684,117
1375,PHI,2021-11-09,109,,MIL,L 109-118,240,42,103,.408,28,60,.467,14,43,.326,11,12,.917,109,44,95,.463,29,56,.518,15,39,.385,15,21,.714,118
1376,PHO,2021-11-08,109,@,SAC,W 109-104,240,44,93,.473,32,63,.508,12,30,.400,9,11,.818,109,37,82,.451,27,58,.466,10,24,.417,20,26,.769,104
1377,NYK,2021-11-07,109,,CLE,L 109-126,240,39,85,.459,30,54,.556,9,31,.290,22,24,.917,109,49,90,.544,30,55,.545,19,35,.543,9,11,.818,126
1378,PHI,2021-11-04,109,@,DET,W 109-98,240,41,83,.494,29,51,.569,12,32,.375,15,22,.682,109,35,87,.402,24,51,.471,11,36,.306,17,19,.895,98
1379,DAL,2021-11-03,109,@,SAS,W 109-108,240,40,93,.430,32,59,.542,8,34,.235,21,29,.724,109,43,88,.489,36,67,.537,7,21,.333,15,20,.750,108
1380,TOR,2021-11-03,109,@,WAS,W 109-100,240,41,88,.466,31,63,.492,10,25,.400,17,20,.850,109,34,78,.436,26,46,.565,8,32,.250,24,30,.800,100
1381,NOP,2021-10-29,109,,SAC,L 109-113,240,42,98,.429,33,64,.516,9,34,.265,16,25,.640,109,40,80,.500,31,53,.585,9,27,.333,24,25,.960,113
1382,ORL,2021-10-29,109,@,TOR,L 109-110,240,41,87,.471,25,53,.472,16,34,.471,11,16,.688,109,43,86,.500,34,56,.607,9,30,.300,15,22,.682,110
1383,IND,2021-10-25,109,,MIL,L 109-119,240,40,90,.444,26,54,.481,14,36,.389,15,17,.882,109,41,85,.482,30,53,.566,11,32,.344,26,31,.839,119
1384,PHI,2021-10-22,109,,BRK,L 109-114,240,43,91,.473,29,55,.527,14,36,.389,9,11,.818,109,41,88,.466,29,50,.580,12,38,.316,20,24,.833,114
1385,WAS,2022-04-10,108,@,CHO,L 108-124,240,42,94,.447,34,71,.479,8,23,.348,16,26,.615,108,48,89,.539,30,56,.536,18,33,.545,10,14,.714,124
1386,ATL,2022-04-05,108,@,TOR,L 108-118,240,43,94,.457,29,57,.509,14,37,.378,8,12,.667,108,44,101,.436,35,66,.530,9,35,.257,21,31,.677,118
1387,CLE,2022-04-03,108,,PHI,L 108-112,240,35,78,.449,20,45,.444,15,33,.455,23,31,.742,108,33,80,.413,22,49,.449,11,31,.355,35,42,.833,112
1388,LAL,2022-03-27,108,@,NOP,L 108-116,240,42,80,.525,28,45,.622,14,35,.400,10,16,.625,108,44,91,.484,35,64,.547,9,27,.333,19,24,.792,116
1389,MIN,2022-03-21,108,@,DAL,L 108-110,240,36,91,.396,23,55,.418,13,36,.361,23,29,.793,108,40,83,.482,26,37,.703,14,46,.304,16,21,.762,110
1390,GSW,2022-03-20,108,,SAS,L 108-110,240,41,90,.456,30,57,.526,11,33,.333,15,21,.714,108,38,98,.388,23,58,.397,15,40,.375,19,25,.760,110
1391,UTA,2022-03-20,108,@,NYK,W 108-93,240,34,74,.459,17,28,.607,17,46,.370,23,29,.793,108,31,83,.373,15,43,.349,16,40,.400,15,21,.714,93
1392,DAL,2022-03-19,108,@,CHO,L 108-129,240,39,89,.438,25,51,.490,14,38,.368,16,20,.800,108,44,88,.500,24,46,.522,20,42,.476,21,27,.778,129
1393,OKC,2022-03-18,108,@,MIA,L 108-120,240,40,84,.476,30,50,.600,10,34,.294,18,23,.783,108,46,95,.484,28,44,.636,18,51,.353,10,12,.833,120
1394,ORL,2022-03-15,108,,BRK,L 108-150,240,36,95,.379,21,54,.389,15,41,.366,21,27,.778,108,53,88,.602,37,61,.607,16,27,.593,28,34,.824,150
1395,SAS,2022-03-12,108,,IND,L 108-119,240,42,102,.412,31,68,.456,11,34,.324,13,16,.813,108,45,92,.489,31,56,.554,14,36,.389,15,15,1.000,119
1396,DET,2022-03-09,108,,CHI,L 108-114,240,42,82,.512,31,51,.608,11,31,.355,13,17,.765,108,40,76,.526,37,61,.607,3,15,.200,31,35,.886,114
1397,ORL,2022-03-09,108,@,NOP,W 108-102,240,36,76,.474,22,39,.564,14,37,.378,22,26,.846,108,41,93,.441,34,62,.548,7,31,.226,13,18,.722,102
1398,DET,2022-03-03,108,@,TOR,W 108-106,240,38,84,.452,27,47,.574,11,37,.297,21,28,.750,108,36,83,.434,29,57,.509,7,26,.269,27,36,.750,106
1399,NYK,2022-03-02,108,@,PHI,L 108-123,240,39,91,.429,31,63,.492,8,28,.286,22,32,.688,108,39,75,.520,22,39,.564,17,36,.472,28,33,.848,123
1400,BRK,2022-03-01,108,@,TOR,L 108-109,240,42,84,.500,32,59,.542,10,25,.400,14,19,.737,108,41,90,.456,34,67,.507,7,23,.304,20,23,.870,109
1401,ATL,2022-02-24,108,@,CHI,L 108-112,240,41,97,.423,33,69,.478,8,28,.286,18,27,.667,108,41,84,.488,33,57,.579,8,27,.296,22,27,.815,112
1402,WAS,2022-02-16,108,@,IND,L 108-113,240,39,91,.429,22,54,.407,17,37,.459,13,16,.813,108,45,83,.542,41,63,.651,4,20,.200,19,29,.655,113
1403,BOS,2022-02-11,108,,DEN,W 108-102,240,38,96,.396,28,59,.475,10,37,.270,22,30,.733,108,39,90,.433,28,46,.609,11,44,.250,13,18,.722,102
1404,CHI,2022-02-06,108,,PHI,L 108-119,240,39,81,.481,32,55,.582,7,26,.269,23,26,.885,108,45,84,.536,33,60,.550,12,24,.500,17,21,.810,119
1405,POR,2022-02-05,108,,MIL,L 108-137,240,41,85,.482,27,40,.675,14,45,.311,12,21,.571,108,49,92,.533,26,42,.619,23,50,.460,16,22,.727,137
1406,UTA,2022-02-02,108,,DEN,W 108-104,240,42,86,.488,35,57,.614,7,29,.241,17,22,.773,108,42,79,.532,31,51,.608,11,28,.393,9,12,.750,104
1407,NYK,2022-02-02,108,,MEM,L 108-120,240,38,88,.432,26,52,.500,12,36,.333,20,26,.769,108,44,102,.431,28,63,.444,16,39,.410,16,23,.696,120
1408,HOU,2022-01-31,108,,GSW,L 108-122,240,36,84,.429,20,41,.488,16,43,.372,20,29,.690,108,43,80,.538,26,40,.650,17,40,.425,19,23,.826,122
1409,DAL,2022-01-30,108,@,ORL,L 108-110,240,39,81,.481,23,43,.535,16,38,.421,14,18,.778,108,43,84,.512,32,50,.640,11,34,.324,13,16,.813,110
1410,NYK,2022-01-28,108,@,MIL,L 108-123,240,39,84,.464,25,44,.568,14,40,.350,16,28,.571,108,41,89,.461,27,46,.587,14,43,.326,27,31,.871,123
1411,ATL,2022-01-28,108,,BOS,W 108-92,240,41,89,.461,29,58,.500,12,31,.387,14,20,.700,108,30,86,.349,23,50,.460,7,36,.194,25,27,.926,92
1412,MIA,2022-01-21,108,@,ATL,L 108-110,240,41,85,.482,26,45,.578,15,40,.375,11,12,.917,108,38,68,.559,24,35,.686,14,33,.424,20,24,.833,110
1413,DET,2022-01-16,108,,PHO,L 108-135,240,38,82,.463,29,57,.509,9,25,.360,23,34,.676,108,51,87,.586,40,60,.667,11,27,.407,22,30,.733,135
1414,DAL,2022-01-15,108,,ORL,W 108-92,240,32,78,.410,20,44,.455,12,34,.353,32,38,.842,108,37,77,.481,30,51,.588,7,26,.269,11,16,.688,92
1415,ATL,2022-01-15,108,,NYK,L 108-117,240,40,80,.500,24,36,.667,16,44,.364,12,17,.706,108,42,83,.506,29,52,.558,13,31,.419,20,26,.769,117
1416,POR,2022-01-13,108,@,DEN,L 108-140,240,39,86,.453,26,46,.565,13,40,.325,17,28,.607,108,52,83,.627,31,41,.756,21,42,.500,15,20,.750,140
1417,MIN,2022-01-13,108,@,MEM,L 108-116,240,41,96,.427,26,48,.542,15,48,.313,11,14,.786,108,42,92,.457,34,60,.567,8,32,.250,24,35,.686,116
1418,NYK,2022-01-12,108,,DAL,W 108-85,240,42,90,.467,30,63,.476,12,27,.444,12,15,.800,108,32,78,.410,24,41,.585,8,37,.216,13,19,.684,85
1419,GSW,2022-01-11,108,@,MEM,L 108-116,240,35,82,.427,22,46,.478,13,36,.361,25,29,.862,108,44,100,.440,30,66,.455,14,34,.412,14,18,.778,116
1420,SAC,2022-01-10,108,,CLE,L 108-109,240,39,91,.429,25,61,.410,14,30,.467,16,22,.727,108,43,87,.494,33,53,.623,10,34,.294,13,15,.867,109
1421,BRK,2022-01-10,108,@,POR,L 108-114,240,42,91,.462,30,59,.508,12,32,.375,12,15,.800,108,40,86,.465,25,48,.521,15,38,.395,19,26,.731,114
1422,LAC,2022-01-08,108,,MEM,L 108-123,240,39,96,.406,29,64,.453,10,32,.313,20,24,.833,108,44,100,.440,32,62,.516,12,38,.316,23,31,.742,123
1423,UTA,2022-01-07,108,@,TOR,L 108-122,240,39,81,.481,22,43,.512,17,38,.447,13,18,.722,108,45,100,.450,33,59,.559,12,41,.293,20,25,.800,122
1424,NYK,2022-01-06,108,,BOS,W 108-105,240,40,90,.444,22,54,.407,18,36,.500,10,15,.667,108,38,80,.475,21,35,.600,17,45,.378,12,13,.923,105
1425,ATL,2022-01-05,108,@,SAC,W 108-102,240,39,86,.453,31,56,.554,8,30,.267,22,30,.733,108,38,90,.422,27,63,.429,11,27,.407,15,20,.750,102
1426,MIA,2022-01-03,108,@,GSW,L 108-115,240,37,90,.411,20,48,.417,17,42,.405,17,19,.895,108,45,92,.489,31,54,.574,14,38,.368,11,13,.846,115
1427,LAL,2022-01-02,108,,MIN,W 108-103,240,36,75,.480,23,34,.676,13,41,.317,23,29,.793,108,41,92,.446,32,54,.593,9,38,.237,12,16,.750,103
1428,CLE,2022-01-02,108,,IND,W 108-104,240,41,88,.466,35,62,.565,6,26,.231,20,28,.714,108,37,83,.446,18,37,.486,19,46,.413,11,14,.786,104
1429,LAC,2021-12-31,108,@,TOR,L 108-116,240,38,78,.487,23,44,.523,15,34,.441,17,19,.895,108,40,96,.417,29,61,.475,11,35,.314,25,33,.758,116
1430,MIN,2021-12-31,108,@,UTA,L 108-120,240,40,93,.430,26,52,.500,14,41,.341,14,22,.636,108,37,78,.474,26,49,.531,11,29,.379,35,41,.854,120
1431,CHI,2021-12-31,108,@,IND,W 108-106,240,35,86,.407,23,59,.390,12,27,.444,26,30,.867,108,38,91,.418,30,60,.500,8,31,.258,22,29,.759,106
1432,PHO,2021-12-31,108,@,BOS,L 108-123,240,41,100,.410,30,65,.462,11,35,.314,15,16,.938,108,45,83,.542,35,56,.625,10,27,.370,23,26,.885,123
1433,IND,2021-12-29,108,,CHO,L 108-116,240,36,86,.419,19,41,.463,17,45,.378,19,29,.655,108,44,85,.518,35,59,.593,9,26,.346,19,32,.594,116
1434,NOP,2021-12-28,108,,CLE,W 108-104,240,36,80,.450,20,44,.455,16,36,.444,20,26,.769,108,37,88,.420,23,47,.489,14,41,.341,16,19,.842,104
1435,LAC,2021-12-27,108,,BRK,L 108-124,240,37,97,.381,23,60,.383,14,37,.378,20,27,.741,108,50,88,.568,37,54,.685,13,34,.382,11,16,.688,124
1436,MIN,2021-12-27,108,,BOS,W 108-103,240,40,90,.444,26,56,.464,14,34,.412,14,19,.737,108,33,89,.371,17,42,.405,16,47,.340,21,28,.750,103
1437,OKC,2021-12-22,108,,DEN,W 108-94,240,42,94,.447,34,60,.567,8,34,.235,16,19,.842,108,33,84,.393,20,40,.500,13,44,.295,15,26,.577,94
1438,PHO,2021-12-21,108,@,LAL,W 108-90,240,41,93,.441,29,52,.558,12,41,.293,14,15,.933,108,34,87,.391,27,52,.519,7,35,.200,15,23,.652,90
1439,PHI,2021-12-20,108,@,BOS,W 108-103,240,36,72,.500,26,47,.553,10,25,.400,26,31,.839,108,38,82,.463,31,55,.564,7,27,.259,20,25,.800,103
1440,MEM,2021-12-09,108,,LAL,W 108-95,240,41,94,.436,27,52,.519,14,42,.333,12,18,.667,108,36,78,.462,24,48,.500,12,30,.400,11,17,.647,95
1441,PHO,2021-12-06,108,,SAS,W 108-104,240,43,94,.457,33,65,.508,10,29,.345,12,18,.667,108,40,93,.430,29,64,.453,11,29,.379,13,19,.684,104
1442,CLE,2021-12-05,108,,UTA,L 108-109,240,42,91,.462,28,53,.528,14,38,.368,10,13,.769,108,40,90,.444,20,42,.476,20,48,.417,9,10,.900,109
1443,NOP,2021-12-05,108,@,HOU,L 108-118,240,40,94,.426,30,56,.536,10,38,.263,18,25,.720,108,39,79,.494,22,39,.564,17,40,.425,23,29,.793,118
1444,ORL,2021-12-01,108,,DEN,W 108-103,240,44,81,.543,38,54,.704,6,27,.222,14,19,.737,108,39,80,.488,29,46,.630,10,34,.294,15,21,.714,103
1445,BOS,2021-11-22,108,,HOU,W 108-90,240,39,92,.424,27,57,.474,12,35,.343,18,19,.947,108,31,83,.373,20,41,.488,11,42,.262,17,24,.708,90
1446,ORL,2021-11-20,108,@,MIL,L 108-117,240,39,98,.398,20,47,.426,19,51,.373,11,14,.786,108,37,82,.451,18,42,.429,19,40,.475,24,37,.649,117
1447,LAL,2021-11-19,108,@,BOS,L 108-130,240,39,84,.464,27,54,.500,12,30,.400,18,24,.750,108,44,88,.500,33,58,.569,11,30,.367,31,38,.816,130
1448,TOR,2021-11-19,108,@,SAC,W 108-89,240,38,84,.452,26,53,.491,12,31,.387,20,24,.833,108,32,84,.381,23,47,.489,9,37,.243,16,25,.640,89
1449,DEN,2021-11-19,108,,CHI,L 108-114,240,39,82,.476,25,45,.556,14,37,.378,16,20,.800,108,41,93,.441,33,62,.532,8,31,.258,24,24,1.000,114
1450,LAC,2021-11-18,108,@,MEM,L 108-120,240,42,90,.467,26,51,.510,16,39,.410,8,8,1.000,108,52,96,.542,41,70,.586,11,26,.423,5,6,.833,120
1451,OKC,2021-11-10,108,@,NOP,W 108-100,240,37,87,.425,27,53,.509,10,34,.294,24,30,.800,108,34,97,.351,25,62,.403,9,35,.257,23,32,.719,100
1452,MEM,2021-11-10,108,,CHO,L 108-118,240,45,107,.421,36,69,.522,9,38,.237,9,15,.600,108,41,90,.456,26,54,.481,15,36,.417,21,24,.875,118
1453,DAL,2021-11-08,108,,NOP,W 108-92,240,43,85,.506,29,50,.580,14,35,.400,8,13,.615,108,37,87,.425,28,53,.528,9,34,.265,9,11,.818,92
1454,MEM,2021-11-03,108,,DEN,W 108-106,240,42,81,.519,26,47,.553,16,34,.471,8,14,.571,108,43,91,.473,35,64,.547,8,27,.296,12,13,.923,106
1455,ATL,2021-11-03,108,@,BRK,L 108-117,240,41,94,.436,28,59,.475,13,35,.371,13,15,.867,108,43,88,.489,21,40,.525,22,48,.458,9,12,.750,117
1456,SAS,2021-11-03,108,,DAL,L 108-109,240,43,88,.489,36,67,.537,7,21,.333,15,20,.750,108,40,93,.430,32,59,.542,8,34,.235,21,29,.724,109
1457,MIL,2021-10-27,108,,MIN,L 108-113,240,39,95,.411,25,44,.568,14,51,.275,16,21,.762,108,43,91,.473,30,46,.652,13,45,.289,14,17,.824,113
1458,TOR,2021-10-25,108,,CHI,L 108-111,240,40,83,.482,28,53,.528,12,30,.400,16,20,.800,108,39,81,.481,27,54,.500,12,27,.444,21,22,.955,111
1459,NOP,2022-04-10,107,,GSW,L 107-128,240,42,99,.424,28,59,.475,14,40,.350,9,12,.750,107,49,81,.605,30,48,.625,19,33,.576,11,13,.846,128
1460,CLE,2022-04-08,107,@,BRK,L 107-118,240,40,82,.488,32,55,.582,8,27,.296,19,24,.792,107,43,92,.467,31,60,.517,12,32,.375,20,21,.952,118
1461,UTA,2022-04-02,107,@,GSW,L 107-111,240,38,89,.427,23,43,.535,15,46,.326,16,22,.727,107,40,84,.476,20,36,.556,20,48,.417,11,12,.917,111
1462,CLE,2022-03-31,107,@,ATL,L 107-131,240,39,90,.433,32,60,.533,7,30,.233,22,28,.786,107,45,91,.495,28,52,.538,17,39,.436,24,28,.857,131
1463,PHO,2022-03-30,107,@,GSW,W 107-103,240,38,92,.413,31,64,.484,7,28,.250,24,30,.800,107,35,83,.422,22,45,.489,13,38,.342,20,25,.800,103
1464,POR,2022-03-30,107,,NOP,L 107-117,240,39,85,.459,25,43,.581,14,42,.333,15,18,.833,107,40,78,.513,34,54,.630,6,24,.250,31,39,.795,117
1465,CHI,2022-03-29,107,@,WAS,W 107-94,240,43,85,.506,37,67,.552,6,18,.333,15,18,.833,107,38,79,.481,32,53,.604,6,26,.231,12,17,.706,94
1466,CLE,2022-03-28,107,,ORL,W 107-101,240,37,83,.446,24,42,.571,13,41,.317,20,23,.870,107,42,87,.483,32,50,.640,10,37,.270,7,13,.538,101
1467,OKC,2022-03-26,107,@,DEN,L 107-113,240,39,84,.464,25,48,.521,14,36,.389,15,16,.938,107,41,85,.482,33,54,.611,8,31,.258,23,24,.958,113
1468,SAS,2022-03-26,107,@,NOP,W 107-103,240,39,92,.424,32,66,.485,7,26,.269,22,25,.880,107,40,90,.444,30,58,.517,10,32,.313,13,19,.684,103
1469,CHO,2022-03-25,107,,UTA,W 107-101,240,41,88,.466,28,54,.519,13,34,.382,12,17,.706,107,38,84,.452,21,37,.568,17,47,.362,8,11,.727,101
1470,NYK,2022-03-13,107,@,BRK,L 107-110,240,39,83,.470,28,54,.519,11,29,.379,18,21,.857,107,44,89,.494,38,60,.633,6,29,.207,16,22,.727,110
1471,NYK,2022-03-09,107,@,DAL,W 107-77,240,36,84,.429,27,50,.540,9,34,.265,26,33,.788,107,27,86,.314,21,42,.500,6,44,.136,17,25,.680,77
1472,BRK,2022-03-03,107,,MIA,L 107-113,240,39,83,.470,27,52,.519,12,31,.387,17,22,.773,107,40,77,.519,30,47,.638,10,30,.333,23,28,.821,113
1473,MEM,2022-03-03,107,@,BOS,L 107-120,240,42,99,.424,29,59,.492,13,40,.325,10,13,.769,107,46,89,.517,30,52,.577,16,37,.432,12,15,.800,120
1474,DEN,2022-03-02,107,,OKC,L 107-119,240,40,90,.444,28,44,.636,12,46,.261,15,17,.882,107,44,87,.506,28,58,.483,16,29,.552,15,21,.714,119
1475,BOS,2022-03-01,107,,ATL,W 107-98,240,39,83,.470,28,48,.583,11,35,.314,18,19,.947,107,36,83,.434,29,52,.558,7,31,.226,19,24,.792,98
1476,BOS,2022-02-27,107,@,IND,L 107-128,240,39,91,.429,27,48,.563,12,43,.279,17,20,.850,107,47,90,.522,30,57,.526,17,33,.515,17,20,.850,128
1477,DAL,2022-02-27,107,@,GSW,W 107-101,240,39,78,.500,26,44,.591,13,34,.382,16,20,.800,107,39,91,.429,28,52,.538,11,39,.282,12,20,.600,101
1478,CHO,2022-02-17,107,,MIA,L 107-111 (2OT),290,38,95,.400,28,53,.528,10,42,.238,21,30,.700,107,41,102,.402,27,54,.500,14,48,.292,15,23,.652,111
1479,DAL,2022-02-15,107,@,MIA,W 107-99,240,34,76,.447,16,35,.457,18,41,.439,21,33,.636,107,35,84,.417,28,57,.491,7,27,.259,22,27,.815,99
1480,MIL,2022-02-14,107,,POR,L 107-122,240,38,89,.427,25,48,.521,13,41,.317,18,24,.750,107,45,99,.455,27,56,.482,18,43,.419,14,19,.737,122
1481,MIL,2022-02-10,107,@,PHO,L 107-131,240,40,88,.455,30,50,.600,10,38,.263,17,25,.680,107,51,90,.567,42,60,.700,9,30,.300,20,29,.690,131
1482,DET,2022-02-10,107,,MEM,L 107-132,240,41,94,.436,34,59,.576,7,35,.200,18,21,.857,107,44,92,.478,29,62,.468,15,30,.500,29,42,.690,132
1483,POR,2022-02-09,107,,LAL,W 107-105,240,42,89,.472,32,57,.561,10,32,.313,13,16,.813,107,41,74,.554,24,37,.649,17,37,.459,6,13,.462,105
1484,HOU,2022-02-06,107,,NOP,L 107-120,240,40,84,.476,24,39,.615,16,45,.356,11,16,.688,107,41,77,.532,29,48,.604,12,29,.414,26,36,.722,120
1485,DAL,2022-02-04,107,,PHI,W 107-98,240,39,85,.459,29,51,.569,10,34,.294,19,23,.826,107,36,70,.514,27,43,.628,9,27,.333,17,23,.739,98
1486,CHO,2022-02-02,107,@,BOS,L 107-113,240,37,87,.425,25,47,.532,12,40,.300,21,27,.778,107,42,82,.512,28,46,.609,14,36,.389,15,17,.882,113
1487,BOS,2022-01-29,107,@,NOP,W 107-97,240,43,81,.531,29,40,.725,14,41,.341,7,11,.636,107,36,82,.439,28,50,.560,8,32,.250,17,23,.739,97
1488,NOP,2022-01-25,107,@,PHI,L 107-117,240,40,83,.482,31,61,.508,9,22,.409,18,26,.692,107,39,84,.464,29,53,.547,10,31,.323,29,31,.935,117
1489,POR,2022-01-25,107,,MIN,L 107-109,240,37,94,.394,21,53,.396,16,41,.390,17,20,.850,107,36,82,.439,22,39,.564,14,43,.326,23,31,.742,109
1490,LAL,2022-01-23,107,@,MIA,L 107-113,240,36,79,.456,25,39,.641,11,40,.275,24,30,.800,107,40,81,.494,25,48,.521,15,33,.455,18,20,.900,113
1491,SAS,2022-01-17,107,,PHO,L 107-121,240,41,92,.446,32,62,.516,9,30,.300,16,22,.727,107,49,95,.516,40,63,.635,9,32,.281,14,20,.700,121
1492,BRK,2022-01-17,107,@,CLE,L 107-114,240,41,83,.494,29,53,.547,12,30,.400,13,18,.722,107,42,81,.519,31,49,.633,11,32,.344,19,21,.905,114
1493,CLE,2022-01-15,107,@,OKC,W 107-102,240,40,87,.460,31,52,.596,9,35,.257,18,25,.720,107,36,83,.434,26,56,.464,10,27,.370,20,22,.909,102
1494,PHO,2021-12-25,107,,GSW,L 107-116,240,40,83,.482,29,53,.547,11,30,.367,16,16,1.000,107,42,85,.494,28,48,.583,14,37,.378,18,21,.857,116
1495,DEN,2021-12-23,107,,CHO,L 107-115,240,40,96,.417,26,56,.464,14,40,.350,13,17,.765,107,39,94,.415,23,47,.489,16,47,.340,21,24,.875,115
1496,NYK,2021-12-18,107,@,BOS,L 107-114,240,35,80,.438,22,44,.500,13,36,.361,24,30,.800,107,42,89,.472,25,44,.568,17,45,.378,13,17,.765,114
1497,DET,2021-12-18,107,,HOU,L 107-116,240,43,93,.462,33,57,.579,10,36,.278,11,16,.688,107,46,93,.495,32,55,.582,14,38,.368,10,17,.588,116
1498,BOS,2021-12-17,107,,GSW,L 107-111,240,36,82,.439,21,41,.512,15,41,.366,20,29,.690,107,39,90,.433,23,44,.523,16,46,.348,17,21,.810,111
1499,DEN,2021-12-15,107,,MIN,L 107-124,240,38,84,.452,24,45,.533,14,39,.359,17,23,.739,107,45,88,.511,22,40,.550,23,48,.479,11,16,.688,124
1500,LAL,2021-12-15,107,@,DAL,W 107-104 (OT),265,39,90,.433,24,51,.471,15,39,.385,14,18,.778,107,39,98,.398,27,54,.500,12,44,.273,14,17,.824,104
1501,POR,2021-12-14,107,,PHO,L 107-111 (OT),265,40,96,.417,27,55,.491,13,41,.317,14,22,.636,107,44,93,.473,33,62,.532,11,31,.355,12,15,.800,111
1502,WAS,2021-12-13,107,@,DEN,L 107-113,240,41,90,.456,29,56,.518,12,34,.353,13,21,.619,107,37,79,.468,27,47,.574,10,32,.313,29,33,.879,113
1503,GSW,2021-12-04,107,,SAS,L 107-112,240,40,90,.444,27,51,.529,13,39,.333,14,21,.667,107,42,88,.477,30,53,.566,12,35,.343,16,19,.842,112
1504,BRK,2021-12-04,107,,CHI,L 107-111,240,46,111,.414,38,86,.442,8,25,.320,7,9,.778,107,41,86,.477,31,55,.564,10,31,.323,19,27,.704,111
1505,NOP,2021-12-03,107,@,DAL,W 107-91,240,37,90,.411,25,60,.417,12,30,.400,21,28,.750,107,32,79,.405,22,45,.489,10,34,.294,17,26,.654,91
1506,NOP,2021-12-01,107,,DAL,L 107-139,240,40,89,.449,27,52,.519,13,37,.351,14,16,.875,107,57,83,.687,39,49,.796,18,34,.529,7,9,.778,139
1507,MIN,2021-12-01,107,@,WAS,L 107-115,240,37,88,.420,26,51,.510,11,37,.297,22,26,.846,107,45,91,.495,35,59,.593,10,32,.313,15,21,.714,115
1508,POR,2021-11-29,107,@,UTA,L 107-129,240,42,91,.462,31,60,.517,11,31,.355,12,17,.706,107,47,89,.528,28,43,.651,19,46,.413,16,23,.696,129
1509,MIA,2021-11-27,107,@,CHI,W 107-104,240,37,86,.430,23,46,.500,14,40,.350,19,22,.864,107,38,81,.469,27,42,.643,11,39,.282,17,21,.810,104
1510,BRK,2021-11-27,107,,PHO,L 107-113,240,42,84,.500,35,61,.574,7,23,.304,16,21,.762,107,41,92,.446,28,54,.519,13,38,.342,18,21,.857,113
1511,LAC,2021-11-26,107,,DET,W 107-96,240,39,91,.429,28,53,.528,11,38,.289,18,19,.947,107,33,90,.367,25,57,.439,8,33,.242,22,26,.846,96
1512,MIN,2021-11-17,107,,SAC,W 107-97,240,41,82,.500,31,46,.674,10,36,.278,15,18,.833,107,34,93,.366,24,55,.436,10,38,.263,19,25,.760,97
1513,CHI,2021-11-17,107,@,POR,L 107-112,240,39,83,.470,26,54,.481,13,29,.448,16,20,.800,107,37,84,.440,26,53,.491,11,31,.355,27,28,.964,112
1514,DET,2021-11-15,107,,SAC,L 107-129,240,39,96,.406,26,49,.531,13,47,.277,16,17,.941,107,52,98,.531,36,65,.554,16,33,.485,9,11,.818,129
1515,MIN,2021-11-12,107,@,LAL,W 107-83,240,43,94,.457,31,57,.544,12,37,.324,9,12,.750,107,29,82,.354,20,41,.488,9,41,.220,16,20,.800,83
1516,DAL,2021-11-10,107,@,CHI,L 107-117,240,38,83,.458,26,50,.520,12,33,.364,19,24,.792,107,45,89,.506,30,58,.517,15,31,.484,12,14,.857,117
1517,ORL,2021-11-07,107,,UTA,W 107-100,240,43,87,.494,31,55,.564,12,32,.375,9,11,.818,107,34,89,.382,26,47,.553,8,42,.190,24,29,.828,100
1518,HOU,2021-11-07,107,@,GSW,L 107-120,240,36,79,.456,26,46,.565,10,33,.303,25,37,.676,107,44,85,.518,29,39,.744,15,46,.326,17,20,.850,120
1519,DAL,2021-11-06,107,,BOS,W 107-104,240,41,78,.526,28,39,.718,13,39,.333,12,14,.857,107,42,86,.488,33,55,.600,9,31,.290,11,16,.688,104
1520,OKC,2021-11-04,107,@,LAL,W 107-104,240,37,87,.425,22,46,.478,15,41,.366,18,26,.692,107,39,94,.415,27,61,.443,12,33,.364,14,17,.824,104
1521,CLE,2021-11-03,107,,POR,W 107-104,240,39,74,.527,24,44,.545,15,30,.500,14,18,.778,107,40,90,.444,27,53,.509,13,37,.351,11,17,.647,104
1522,UTA,2021-10-31,107,@,MIL,W 107-95,240,35,75,.467,23,38,.605,12,37,.324,25,27,.926,107,39,96,.406,27,55,.491,12,41,.293,5,6,.833,95
1523,CHI,2021-10-30,107,,UTA,W 107-99,240,39,91,.429,34,70,.486,5,21,.238,24,30,.800,107,35,92,.380,24,54,.444,11,38,.289,18,19,.947,99
1524,PHO,2021-10-27,107,,SAC,L 107-110,240,42,93,.452,36,71,.507,6,22,.273,17,24,.708,107,42,95,.442,27,57,.474,15,38,.395,11,15,.733,110
1525,BOS,2021-10-27,107,,WAS,L 107-116,240,37,85,.435,27,56,.482,10,29,.345,23,28,.821,107,43,84,.512,34,59,.576,9,25,.360,21,29,.724,116
1526,NOP,2021-10-25,107,@,MIN,W 107-98,240,39,87,.448,29,57,.509,10,30,.333,19,23,.826,107,31,90,.344,16,40,.400,15,50,.300,21,27,.778,98
1527,MIA,2021-10-25,107,,ORL,W 107-90,240,41,87,.471,35,60,.583,6,27,.222,19,19,1.000,107,33,81,.407,21,37,.568,12,44,.273,12,19,.632,90
1528,BOS,2021-10-24,107,@,HOU,W 107-97,240,38,86,.442,23,39,.590,15,47,.319,16,20,.800,107,32,75,.427,18,43,.419,14,32,.438,19,24,.792,97
1529,SAC,2021-10-24,107,,GSW,L 107-119,240,42,86,.488,27,40,.675,15,46,.326,8,13,.615,107,43,97,.443,30,60,.500,13,37,.351,20,24,.833,119
1530,UTA,2021-10-20,107,,OKC,W 107-86,240,40,91,.440,26,44,.591,14,47,.298,13,15,.867,107,34,91,.374,27,56,.482,7,35,.200,11,18,.611,86
1531,DET,2022-04-10,106,@,PHI,L 106-118,240,38,83,.458,27,49,.551,11,34,.324,19,29,.655,106,46,88,.523,41,63,.651,5,25,.200,21,23,.913,118
1532,CHI,2022-04-05,106,,MIL,L 106-127,240,42,98,.429,33,65,.508,9,33,.273,13,13,1.000,106,46,87,.529,34,52,.654,12,35,.343,23,25,.920,127
1533,MIA,2022-03-30,106,@,BOS,W 106-98,240,38,79,.481,25,45,.556,13,34,.382,17,25,.680,106,35,85,.412,24,48,.500,11,37,.297,17,23,.739,98
1534,POR,2022-03-25,106,,HOU,L 106-125,240,43,85,.506,40,65,.615,3,20,.150,17,23,.739,106,43,83,.518,24,38,.632,19,45,.422,20,23,.870,125
1535,CHO,2022-03-23,106,,NYK,L 106-121,240,42,89,.472,29,43,.674,13,46,.283,9,17,.529,106,43,83,.518,23,38,.605,20,45,.444,15,17,.882,121
1536,CHO,2022-03-21,106,,NOP,W 106-103,240,40,79,.506,27,42,.643,13,37,.351,13,15,.867,106,40,90,.444,31,66,.470,9,24,.375,14,16,.875,103
1537,UTA,2022-03-21,106,@,BRK,L 106-114,240,37,83,.446,23,44,.523,14,39,.359,18,22,.818,106,45,83,.542,34,53,.642,11,30,.367,13,15,.867,114
1538,MIA,2022-03-21,106,@,PHI,L 106-113,240,38,80,.475,28,47,.596,10,33,.303,20,20,1.000,106,43,86,.500,28,49,.571,15,37,.405,12,16,.750,113
1539,ATL,2022-03-16,106,@,CHO,L 106-116,240,40,93,.430,27,56,.482,13,37,.351,13,14,.929,106,43,87,.494,32,52,.615,11,35,.314,19,23,.826,116
1540,LAC,2022-03-13,106,@,DET,W 106-102,240,40,89,.449,30,59,.508,10,30,.333,16,20,.800,106,36,80,.450,24,51,.471,12,29,.414,18,20,.900,102
1541,LAC,2022-03-11,106,@,ATL,L 106-112,240,40,82,.488,28,50,.560,12,32,.375,14,17,.824,106,43,90,.478,34,59,.576,9,31,.290,17,19,.895,112
1542,DEN,2022-03-09,106,@,SAC,W 106-100,240,40,82,.488,31,47,.660,9,35,.257,17,19,.895,106,38,85,.447,26,51,.510,12,34,.353,12,18,.667,100
1543,HOU,2022-03-07,106,@,MIA,L 106-123,240,39,88,.443,26,45,.578,13,43,.302,15,22,.682,106,49,91,.538,35,60,.583,14,31,.452,11,14,.786,123
1544,CHI,2022-03-07,106,@,PHI,L 106-121,240,39,87,.448,31,63,.492,8,24,.333,20,26,.769,106,41,84,.488,29,54,.537,12,30,.400,27,34,.794,121
1545,IND,2022-03-04,106,@,DET,L 106-111,240,39,100,.390,29,60,.483,10,40,.250,18,28,.643,106,42,94,.447,27,64,.422,15,30,.500,12,18,.667,111
1546,TOR,2022-03-03,106,,DET,L 106-108,240,36,83,.434,29,57,.509,7,26,.269,27,36,.750,106,38,84,.452,27,47,.574,11,37,.297,21,28,.750,108
1547,CHO,2022-02-28,106,@,MIL,L 106-130,240,36,93,.387,22,54,.407,14,39,.359,20,32,.625,106,40,91,.440,22,46,.478,18,45,.400,32,37,.865,130
1548,BRK,2022-02-24,106,,BOS,L 106-129,240,39,94,.415,32,65,.492,7,29,.241,21,28,.750,106,46,85,.541,29,43,.674,17,42,.405,20,27,.741,129
1549,DET,2022-02-24,106,,CLE,W 106-103,240,35,86,.407,24,52,.462,11,34,.324,25,28,.893,106,34,77,.442,22,42,.524,12,35,.343,23,34,.676,103
1550,LAL,2022-02-16,106,,UTA,W 106-101,240,41,86,.477,31,50,.620,10,36,.278,14,22,.636,106,37,79,.468,26,46,.565,11,33,.333,16,19,.842,101
1551,NYK,2022-02-16,106,,BRK,L 106-111,240,37,85,.435,21,42,.500,16,43,.372,16,18,.889,106,43,98,.439,32,64,.500,11,34,.324,14,23,.609,111
1552,OKC,2022-02-16,106,,SAS,L 106-114,240,41,105,.390,30,73,.411,11,32,.344,13,19,.684,106,43,98,.439,33,64,.516,10,34,.294,18,22,.818,114
1553,CHI,2022-02-12,106,,OKC,W 106-101,240,40,89,.449,33,64,.516,7,25,.280,19,23,.826,106,34,88,.386,23,52,.442,11,36,.306,22,30,.733,101
1554,HOU,2022-02-04,106,@,SAS,L 106-131,240,36,83,.434,25,50,.500,11,33,.333,23,29,.793,106,51,89,.573,38,61,.623,13,28,.464,16,20,.800,131
1555,WAS,2022-02-02,106,@,PHI,W 106-103,240,41,90,.456,32,68,.471,9,22,.409,15,19,.789,106,41,91,.451,30,64,.469,11,27,.407,10,13,.769,103
1556,MIA,2022-02-01,106,@,TOR,L 106-110,240,38,78,.487,30,48,.625,8,30,.267,22,25,.880,106,39,81,.481,27,55,.491,12,26,.462,20,29,.690,110
1557,TOR,2022-01-31,106,@,ATL,W 106-100,240,38,89,.427,20,53,.377,18,36,.500,12,17,.706,106,37,81,.457,25,49,.510,12,32,.375,14,16,.875,100
1558,UTA,2022-01-30,106,@,MIN,L 106-126,240,38,81,.469,23,41,.561,15,40,.375,15,21,.714,106,49,89,.551,36,58,.621,13,31,.419,15,18,.833,126
1559,BRK,2022-01-29,106,@,GSW,L 106-110,240,39,98,.398,28,70,.400,11,28,.393,17,21,.810,106,40,98,.408,26,53,.491,14,45,.311,16,18,.889,110
1560,LAL,2022-01-25,106,@,BRK,W 106-96,240,42,89,.472,30,51,.588,12,38,.316,10,10,1.000,106,37,88,.420,30,61,.492,7,27,.259,15,22,.682,96
1561,CHI,2022-01-17,106,@,MEM,L 106-119,240,40,92,.435,27,61,.443,13,31,.419,13,15,.867,106,47,92,.511,37,67,.552,10,25,.400,15,20,.750,119
1562,ORL,2022-01-12,106,@,WAS,L 106-112,240,41,99,.414,30,64,.469,11,35,.314,13,16,.813,106,43,82,.524,33,51,.647,10,31,.323,16,21,.762,112
1563,LAC,2022-01-09,106,,ATL,W 106-93,240,44,92,.478,32,59,.542,12,33,.364,6,7,.857,106,35,78,.449,28,52,.538,7,26,.269,16,19,.842,93
1564,MIL,2022-01-08,106,@,CHO,L 106-114,240,35,90,.389,23,53,.434,12,37,.324,24,26,.923,106,44,99,.444,28,51,.549,16,48,.333,10,17,.588,114
1565,HOU,2022-01-07,106,,DAL,L 106-130,240,37,87,.425,25,44,.568,12,43,.279,20,29,.690,106,49,90,.544,32,52,.615,17,38,.447,15,28,.536,130
1566,PHO,2022-01-06,106,,LAC,W 106-89,240,44,107,.411,34,76,.447,10,31,.323,8,10,.800,106,31,86,.360,25,58,.431,6,28,.214,21,25,.840,89
1567,ORL,2022-01-05,106,,PHI,L 106-116,240,40,90,.444,28,51,.549,12,39,.308,14,20,.700,106,43,85,.506,31,57,.544,12,28,.429,18,24,.750,116
1568,CLE,2022-01-04,106,,MEM,L 106-110,240,40,92,.435,30,58,.517,10,34,.294,16,21,.762,106,42,90,.467,33,63,.524,9,27,.333,17,22,.773,110
1569,MIL,2022-01-03,106,,DET,L 106-115,240,39,92,.424,28,46,.609,11,46,.239,17,22,.773,106,44,91,.484,26,48,.542,18,43,.419,9,14,.643,115
1570,POR,2021-12-31,106,@,LAL,L 106-139,240,36,102,.353,24,60,.400,12,42,.286,22,27,.815,106,47,85,.553,28,44,.636,19,41,.463,26,30,.867,139
1571,IND,2021-12-31,106,,CHI,L 106-108,240,38,91,.418,30,60,.500,8,31,.258,22,29,.759,106,35,86,.407,23,59,.390,12,27,.444,26,30,.867,108
1572,HOU,2021-12-23,106,@,IND,L 106-118,240,35,80,.438,20,43,.465,15,37,.405,21,26,.808,106,46,88,.523,33,50,.660,13,38,.342,13,19,.684,118
1573,HOU,2021-12-22,106,@,MIL,L 106-126,240,36,86,.419,23,41,.561,13,45,.289,21,31,.677,106,45,103,.437,28,57,.491,17,46,.370,19,21,.905,126
1574,CHO,2021-12-19,106,@,PHO,L 106-137,240,36,100,.360,26,55,.473,10,45,.222,24,28,.857,106,54,95,.568,34,54,.630,20,41,.488,9,13,.692,137
1575,LAL,2021-12-12,106,,ORL,W 106-94,240,41,84,.488,28,56,.500,13,28,.464,11,17,.647,106,33,88,.375,20,50,.400,13,38,.342,15,19,.789,94
1576,HOU,2021-12-11,106,@,MEM,L 106-113,240,38,77,.494,27,44,.614,11,33,.333,19,29,.655,106,40,80,.500,29,51,.569,11,29,.379,22,36,.611,113
1577,LAC,2021-12-11,106,,ORL,W 106-104,240,42,92,.457,24,56,.429,18,36,.500,4,6,.667,106,35,80,.438,23,47,.489,12,33,.364,22,24,.917,104
1578,IND,2021-12-10,106,,DAL,W 106-93,240,41,87,.471,28,51,.549,13,36,.361,11,12,.917,106,39,84,.464,35,55,.636,4,29,.138,11,12,.917,93
1579,MIN,2021-12-10,106,,CLE,L 106-123,240,36,92,.391,25,53,.472,11,39,.282,23,28,.821,106,46,85,.541,33,52,.635,13,33,.394,18,22,.818,123
1580,CHO,2021-12-08,106,,PHI,L 106-110,240,39,80,.488,29,51,.569,10,29,.345,18,21,.857,106,36,75,.480,23,41,.561,13,34,.382,25,30,.833,110
1581,DET,2021-11-28,106,@,LAL,L 106-110,240,38,89,.427,25,56,.446,13,33,.394,17,19,.895,106,43,86,.500,34,54,.630,9,32,.281,15,25,.600,110
1582,SAS,2021-11-24,106,,ATL,L 106-124,240,43,100,.430,31,67,.463,12,33,.364,8,10,.800,106,45,88,.511,33,62,.532,12,26,.462,22,24,.917,124
1583,CHO,2021-11-24,106,@,ORL,W 106-99,240,39,93,.419,27,53,.509,12,40,.300,16,21,.762,106,38,93,.409,23,51,.451,15,42,.357,8,10,.800,99
1584,NYK,2021-11-23,106,,LAL,W 106-100,240,37,82,.451,22,48,.458,15,34,.441,17,21,.810,106,34,91,.374,23,55,.418,11,36,.306,21,30,.700,100
1585,NYK,2021-11-20,106,,HOU,W 106-99,240,33,78,.423,15,37,.405,18,41,.439,22,26,.846,106,38,84,.452,28,45,.622,10,39,.256,13,22,.591,99
1586,LAC,2021-11-16,106,,SAS,W 106-92,240,37,85,.435,25,47,.532,12,38,.316,20,22,.909,106,41,95,.432,36,73,.493,5,22,.227,5,7,.714,92
1587,SAS,2021-11-14,106,@,LAL,L 106-114,240,40,90,.444,24,54,.444,16,36,.444,10,15,.667,106,43,83,.518,28,52,.538,15,31,.484,13,17,.765,114
1588,CHO,2021-11-14,106,,GSW,W 106-102,240,42,88,.477,28,52,.538,14,36,.389,8,12,.667,106,38,90,.422,29,51,.569,9,39,.231,17,25,.680,102
1589,CHO,2021-11-07,106,@,LAC,L 106-120,240,41,101,.406,31,68,.456,10,33,.303,14,18,.778,106,41,86,.477,23,38,.605,18,48,.375,20,21,.952,120
1590,IND,2021-11-05,106,@,POR,L 106-110,240,43,88,.489,29,46,.630,14,42,.333,6,10,.600,106,40,82,.488,23,43,.535,17,39,.436,13,15,.867,110
1591,DEN,2021-11-03,106,@,MEM,L 106-108,240,43,91,.473,35,64,.547,8,27,.296,12,13,.923,106,42,81,.519,26,47,.553,16,34,.471,8,14,.571,108
1592,MEM,2021-11-01,106,,DEN,W 106-97,240,44,97,.454,31,63,.492,13,34,.382,5,7,.714,106,39,88,.443,30,50,.600,9,38,.237,10,15,.667,97
1593,DEN,2021-10-29,106,,DAL,W 106-75,240,43,83,.518,32,47,.681,11,36,.306,9,13,.692,106,23,78,.295,15,41,.366,8,37,.216,21,27,.778,75
1594,MIA,2021-10-27,106,@,BRK,W 106-93,240,38,96,.396,30,67,.448,8,29,.276,22,26,.846,106,33,85,.388,19,42,.452,14,43,.326,13,14,.929,93
1595,GSW,2021-10-26,106,@,OKC,W 106-98,240,39,83,.470,25,43,.581,14,40,.350,14,18,.778,106,36,86,.419,24,52,.462,12,34,.353,14,17,.824,98
1596,HOU,2021-10-26,106,@,DAL,L 106-116,240,36,86,.419,20,47,.426,16,39,.410,18,26,.692,106,43,93,.462,31,50,.620,12,43,.279,18,25,.720,116
1597,HOU,2021-10-20,106,@,MIN,L 106-124,240,40,88,.455,29,55,.527,11,33,.333,15,22,.682,106,42,87,.483,26,49,.531,16,38,.421,24,31,.774,124
1598,NYK,2022-04-10,105,,TOR,W 105-94,240,40,87,.460,25,44,.568,15,43,.349,10,12,.833,105,36,92,.391,24,50,.480,12,42,.286,10,11,.909,94
1599,UTA,2022-04-08,105,,PHO,L 105-111,240,35,88,.398,24,50,.480,11,38,.289,24,33,.727,105,46,92,.500,40,73,.548,6,19,.316,13,15,.867,111
1600,HOU,2022-04-05,105,@,BRK,L 105-118,240,40,99,.404,29,56,.518,11,43,.256,14,25,.560,105,39,86,.453,24,49,.490,15,37,.405,25,27,.926,118
1601,MEM,2022-03-18,105,@,ATL,L 105-120,240,40,86,.465,32,64,.500,8,22,.364,17,23,.739,105,45,91,.495,32,63,.508,13,28,.464,17,21,.810,120
1602,MIA,2022-03-15,105,,DET,W 105-98,240,29,72,.403,17,39,.436,12,33,.364,35,39,.897,105,37,80,.463,27,46,.587,10,34,.294,14,22,.636,98
1603,HOU,2022-03-13,105,@,NOP,L 105-130,240,39,77,.506,27,46,.587,12,31,.387,15,25,.600,105,48,93,.516,38,61,.623,10,32,.313,24,34,.706,130
1604,CLE,2022-03-11,105,@,MIA,L 105-117,240,35,79,.443,27,54,.500,8,25,.320,27,29,.931,105,41,86,.477,30,51,.588,11,35,.314,24,27,.889,117
1605,SAS,2022-02-28,105,@,MEM,L 105-118,240,41,99,.414,32,67,.478,9,32,.281,14,19,.737,105,48,89,.539,37,63,.587,11,26,.423,11,19,.579,118
1606,LAC,2022-02-25,105,@,LAL,W 105-102,240,41,83,.494,31,57,.544,10,26,.385,13,19,.684,105,39,93,.419,31,62,.500,8,31,.258,16,21,.762,102
1607,BOS,2022-02-13,105,,ATL,W 105-95,240,36,85,.424,25,47,.532,11,38,.289,22,27,.815,105,34,93,.366,22,55,.400,12,38,.316,15,15,1.000,95
1608,ORL,2022-02-12,105,@,PHO,L 105-132,240,37,87,.425,22,46,.478,15,41,.366,16,24,.667,105,55,105,.524,40,71,.563,15,34,.441,7,10,.700,132
1609,LAC,2022-02-10,105,@,DAL,L 105-112,240,39,81,.481,30,58,.517,9,23,.391,18,25,.720,105,38,78,.487,25,39,.641,13,39,.333,23,27,.852,112
1610,LAL,2022-02-09,105,@,POR,L 105-107,240,41,74,.554,24,37,.649,17,37,.459,6,13,.462,105,42,89,.472,32,57,.561,10,32,.313,13,16,.813,107
1611,CLE,2022-02-09,105,,SAS,W 105-92,240,39,82,.476,30,61,.492,9,21,.429,18,24,.750,105,38,99,.384,30,66,.455,8,33,.242,8,11,.727,92
1612,DET,2022-02-06,105,@,MIN,L 105-118,240,40,95,.421,28,63,.444,12,32,.375,13,19,.684,105,42,91,.462,25,55,.455,17,36,.472,17,21,.810,118
1613,DEN,2022-02-04,105,,NOP,L 105-113,240,35,78,.449,16,37,.432,19,41,.463,16,17,.941,105,42,75,.560,34,50,.680,8,25,.320,21,23,.913,113
1614,CLE,2022-01-30,105,@,DET,L 105-115,240,38,82,.463,25,48,.521,13,34,.382,16,25,.640,105,42,91,.462,32,65,.492,10,26,.385,21,25,.840,115
1615,IND,2022-01-29,105,@,DAL,L 105-132,240,40,91,.440,31,58,.534,9,33,.273,16,23,.696,105,51,96,.531,35,62,.565,16,34,.471,14,22,.636,132
1616,NOP,2022-01-28,105,,DEN,L 105-116,240,35,90,.389,30,56,.536,5,34,.147,30,33,.909,105,41,82,.500,29,49,.592,12,33,.364,22,25,.880,116
1617,PHI,2022-01-27,105,,LAL,W 105-87,240,41,82,.500,28,47,.596,13,35,.371,10,17,.588,105,36,88,.409,30,59,.508,6,29,.207,9,9,1.000,87
1618,PHO,2022-01-26,105,@,UTA,W 105-97,240,40,82,.488,33,64,.516,7,18,.389,18,27,.667,105,34,79,.430,22,49,.449,12,30,.400,17,23,.739,97
1619,TOR,2022-01-26,105,@,CHI,L 105-111,240,38,79,.481,26,48,.542,12,31,.387,17,28,.607,105,46,84,.548,39,58,.672,7,26,.269,12,16,.750,111
1620,DET,2022-01-25,105,,DEN,L 105-110,240,41,97,.423,29,61,.475,12,36,.333,11,14,.786,105,36,84,.429,25,52,.481,11,32,.344,27,31,.871,110
1621,TOR,2022-01-23,105,,POR,L 105-114,240,39,98,.398,21,44,.477,18,54,.333,9,14,.643,105,45,85,.529,27,53,.509,18,32,.563,6,13,.462,114
1622,WAS,2022-01-21,105,,TOR,L 105-109,240,43,85,.506,32,52,.615,11,33,.333,8,10,.800,105,42,90,.467,31,60,.517,11,30,.367,14,17,.824,109
1623,ORL,2022-01-21,105,,LAL,L 105-116,240,36,81,.444,25,41,.610,11,40,.275,22,29,.759,105,42,85,.494,29,55,.527,13,30,.433,19,23,.826,116
1624,BOS,2022-01-21,105,,POR,L 105-109,240,37,82,.451,26,45,.578,11,37,.297,20,23,.870,105,36,76,.474,20,43,.465,16,33,.485,21,30,.700,109
1625,GSW,2022-01-21,105,,HOU,W 105-103,240,39,81,.481,29,51,.569,10,30,.333,17,22,.773,105,38,89,.427,28,54,.519,10,35,.286,17,20,.850,103
1626,NOP,2022-01-15,105,@,BRK,L 105-120,240,40,87,.460,31,56,.554,9,31,.290,16,24,.667,105,46,84,.548,34,57,.596,12,27,.444,16,17,.941,120
1627,TOR,2022-01-09,105,,NOP,W 105-101,240,36,85,.424,22,51,.431,14,34,.412,19,20,.950,105,34,75,.453,22,42,.524,12,33,.364,21,25,.840,101
1628,OKC,2022-01-07,105,,MIN,L 105-135,240,36,89,.404,21,45,.467,15,44,.341,18,23,.783,105,50,90,.556,33,49,.673,17,41,.415,18,25,.720,135
1629,BOS,2022-01-06,105,@,NYK,L 105-108,240,38,80,.475,21,35,.600,17,45,.378,12,13,.923,105,40,90,.444,22,54,.407,18,36,.500,10,15,.667,108
1630,NYK,2022-01-02,105,@,TOR,L 105-120,240,35,78,.449,23,42,.548,12,36,.333,23,28,.821,105,41,86,.477,28,52,.538,13,34,.382,25,30,.833,120
1631,SAS,2021-12-31,105,@,MEM,L 105-118,240,39,90,.433,27,55,.491,12,35,.343,15,24,.625,105,49,102,.480,39,76,.513,10,26,.385,10,16,.625,118
1632,POR,2021-12-29,105,,UTA,L 105-120,240,37,88,.420,23,48,.479,14,40,.350,17,24,.708,105,46,87,.529,38,58,.655,8,29,.276,20,32,.625,120
1633,IND,2021-12-26,105,@,CHI,L 105-113,240,41,94,.436,33,64,.516,8,30,.267,15,21,.714,105,43,76,.566,32,53,.604,11,23,.478,16,22,.727,113
1634,LAC,2021-12-22,105,@,SAC,W 105-89,240,42,82,.512,35,58,.603,7,24,.292,14,16,.875,105,34,85,.400,22,47,.468,12,38,.316,9,12,.750,89
1635,NYK,2021-12-21,105,,DET,W 105-91,240,40,90,.444,29,57,.509,11,33,.333,14,19,.737,105,34,94,.362,26,61,.426,8,33,.242,15,19,.789,91
1636,DAL,2021-12-19,105,@,MIN,L 105-111,240,36,82,.439,24,41,.585,12,41,.293,21,22,.955,105,36,77,.468,21,43,.488,15,34,.441,24,31,.774,111
1637,POR,2021-12-19,105,@,MEM,W 105-100,240,35,74,.473,24,42,.571,11,32,.344,24,28,.857,105,35,91,.385,26,57,.456,9,34,.265,21,25,.840,100
1638,SAC,2021-12-17,105,,MEM,L 105-124,240,36,88,.409,23,53,.434,13,35,.371,20,26,.769,105,45,97,.464,32,73,.438,13,24,.542,21,27,.778,124
1639,ORL,2021-12-17,105,,MIA,L 105-115,240,43,89,.483,32,57,.561,11,32,.344,8,10,.800,105,41,82,.500,22,47,.468,19,35,.543,14,19,.737,115
1640,PHI,2021-12-16,105,@,BRK,L 105-114,240,39,89,.438,29,55,.527,10,34,.294,17,20,.850,105,44,89,.494,33,66,.500,11,23,.478,15,16,.938,114
1641,WAS,2021-12-15,105,@,SAC,L 105-119,240,42,89,.472,37,65,.569,5,24,.208,16,21,.762,105,45,82,.549,37,56,.661,8,26,.308,21,29,.724,119
1642,GSW,2021-12-14,105,@,NYK,W 105-96,240,35,77,.455,20,37,.541,15,40,.375,20,27,.741,105,30,83,.361,14,41,.341,16,42,.381,20,22,.909,96
1643,CLE,2021-12-13,105,,MIA,W 105-94,240,36,81,.444,20,45,.444,16,36,.444,17,18,.944,105,38,85,.447,25,45,.556,13,40,.325,5,9,.556,94
1644,ATL,2021-12-10,105,,BRK,L 105-113,240,37,94,.394,26,60,.433,11,34,.324,20,24,.833,105,46,93,.495,40,70,.571,6,23,.261,15,16,.938,113
1645,MEM,2021-12-06,105,@,MIA,W 105-90,240,38,89,.427,25,56,.446,13,33,.394,16,21,.762,105,35,76,.461,29,54,.537,6,22,.273,14,17,.824,90
1646,MIN,2021-12-03,105,@,BRK,L 105-110,240,36,93,.387,23,51,.451,13,42,.310,20,24,.833,105,36,76,.474,30,53,.566,6,23,.261,32,41,.780,110
1647,GSW,2021-11-28,105,@,LAC,W 105-90,240,38,86,.442,21,46,.457,17,40,.425,12,22,.545,105,32,80,.400,23,52,.442,9,28,.321,17,25,.680,90
1648,CLE,2021-11-27,105,,ORL,W 105-92,240,41,90,.456,27,51,.529,14,39,.359,9,12,.750,105,35,88,.398,27,56,.482,8,32,.250,14,23,.609,92
1649,NOP,2021-11-27,105,@,UTA,L 105-127,240,40,93,.430,32,58,.552,8,35,.229,17,21,.810,105,45,80,.563,25,45,.556,20,35,.571,17,22,.773,127
1650,OKC,2021-11-20,105,@,BOS,L 105-111,240,39,96,.406,21,54,.389,18,42,.429,9,16,.563,105,41,88,.466,24,49,.490,17,39,.436,12,14,.857,111
1651,CHO,2021-11-20,105,@,ATL,L 105-115,240,43,102,.422,33,62,.532,10,40,.250,9,15,.600,105,43,82,.524,31,48,.646,12,34,.353,17,21,.810,115
1652,SAC,2021-11-20,105,,UTA,L 105-123,240,41,91,.451,31,60,.517,10,31,.323,13,21,.619,105,46,91,.505,29,52,.558,17,39,.436,14,17,.824,123
1653,GSW,2021-11-19,105,@,DET,W 105-102,240,38,80,.475,26,50,.520,12,30,.400,17,21,.810,105,32,80,.400,18,38,.474,14,42,.333,24,30,.800,102
1654,PHO,2021-11-17,105,,DAL,W 105-98,240,41,93,.441,28,54,.519,13,39,.333,10,14,.714,105,38,91,.418,22,59,.373,16,32,.500,6,6,1.000,98
1655,WAS,2021-11-15,105,,NOP,W 105-100,240,39,84,.464,29,56,.518,10,28,.357,17,25,.680,105,30,74,.405,19,53,.358,11,21,.524,29,34,.853,100
1656,UTA,2021-11-13,105,,MIA,L 105-111,240,35,85,.412,18,32,.563,17,53,.321,18,25,.720,105,42,85,.494,29,52,.558,13,33,.394,14,16,.875,111
1657,DEN,2021-11-12,105,,ATL,W 105-96,240,40,90,.444,30,55,.545,10,35,.286,15,20,.750,105,38,93,.409,33,65,.508,5,28,.179,15,21,.714,96
1658,OKC,2021-11-12,105,,SAC,W 105-103,240,42,99,.424,32,69,.464,10,30,.333,11,15,.733,105,38,95,.400,24,54,.444,14,41,.341,13,17,.765,103
1659,POR,2021-11-06,105,,LAL,W 105-90,240,36,95,.379,21,40,.525,15,55,.273,18,24,.750,105,31,90,.344,22,58,.379,9,32,.281,19,24,.792,90
1660,CHI,2021-11-06,105,,PHI,L 105-114,240,37,92,.402,30,63,.476,7,29,.241,24,30,.800,105,43,81,.531,30,55,.545,13,26,.500,15,19,.789,114
1661,DAL,2021-10-31,105,,SAC,W 105-99,240,40,90,.444,28,53,.528,12,37,.324,13,20,.650,105,38,96,.396,31,60,.517,7,36,.194,16,20,.800,99
1662,BRK,2021-10-29,105,,IND,W 105-98,240,34,76,.447,28,50,.560,6,26,.231,31,41,.756,105,37,93,.398,29,64,.453,8,29,.276,16,23,.696,98
1663,PHO,2021-10-23,105,@,POR,L 105-134,240,43,89,.483,34,61,.557,9,28,.321,10,15,.667,105,51,94,.543,30,44,.682,21,50,.420,11,17,.647,134
1664,LAL,2021-10-22,105,,PHO,L 105-115,240,34,86,.395,19,52,.365,15,34,.441,22,29,.759,105,42,86,.488,32,54,.593,10,32,.313,21,28,.750,115
1665,CHI,2022-03-28,104,@,NYK,L 104-109,240,34,79,.430,28,56,.500,6,23,.261,30,33,.909,104,38,89,.427,26,54,.481,12,35,.343,21,35,.600,109
1666,NYK,2022-03-27,104,@,DET,W 104-102,240,34,85,.400,21,44,.477,13,41,.317,23,29,.793,104,39,85,.459,31,56,.554,8,29,.276,16,18,.889,102
1667,PHI,2022-03-27,104,@,PHO,L 104-114,240,37,89,.416,27,53,.509,10,36,.278,20,26,.769,104,45,87,.517,32,60,.533,13,27,.481,11,17,.647,114
1668,CLE,2022-03-24,104,@,TOR,L 104-117,240,37,79,.468,25,49,.510,12,30,.400,18,22,.818,104,42,89,.472,26,52,.500,16,37,.432,17,19,.895,117
1669,MIA,2022-03-23,104,,GSW,L 104-118,240,37,85,.435,23,49,.469,14,36,.389,16,21,.762,104,40,77,.519,25,41,.610,15,36,.417,23,27,.852,118
1670,DEN,2022-03-20,104,,BOS,L 104-124,240,35,87,.402,21,48,.438,14,39,.359,20,25,.800,104,47,82,.573,28,42,.667,19,40,.475,11,11,1.000,124
1671,LAL,2022-03-16,104,@,MIN,L 104-124,240,39,93,.419,29,49,.592,10,44,.227,16,23,.696,104,40,90,.444,23,48,.479,17,42,.405,27,31,.871,124
1672,MIA,2022-03-12,104,,MIN,L 104-113,240,35,88,.398,20,43,.465,15,45,.333,19,25,.760,104,35,83,.422,20,41,.488,15,42,.357,28,32,.875,113
1673,SAS,2022-03-11,104,,UTA,W 104-102,240,34,85,.400,28,56,.500,6,29,.207,30,43,.698,104,37,92,.402,24,52,.462,13,40,.325,15,23,.652,102
1674,SAS,2022-03-09,104,,TOR,L 104-119,240,38,84,.452,29,52,.558,9,32,.281,19,20,.950,104,41,85,.482,30,55,.545,11,30,.367,26,28,.929,119
1675,CLE,2022-03-06,104,,TOR,W 104-96,240,39,85,.459,28,49,.571,11,36,.306,15,23,.652,104,37,94,.394,31,70,.443,6,24,.250,16,26,.615,96
1676,LAL,2022-03-01,104,,DAL,L 104-109,240,37,82,.451,23,48,.479,14,34,.412,16,20,.800,104,41,82,.500,31,47,.660,10,35,.286,17,27,.630,109
1677,DET,2022-02-26,104,,BOS,L 104-113,240,39,87,.448,32,60,.533,7,27,.259,19,22,.864,104,42,88,.477,32,62,.516,10,26,.385,19,21,.905,113
1678,OKC,2022-02-24,104,,PHO,L 104-124,240,44,93,.473,38,62,.613,6,31,.194,10,11,.909,104,46,86,.535,33,52,.635,13,34,.382,19,21,.905,124
1679,GSW,2022-02-14,104,@,LAC,L 104-119,240,39,86,.453,23,45,.511,16,41,.390,10,13,.769,104,48,85,.565,33,51,.647,15,34,.441,8,15,.533,119
1680,NYK,2022-02-07,104,@,UTA,L 104-113,240,36,95,.379,28,62,.452,8,33,.242,24,35,.686,104,39,93,.419,27,45,.600,12,48,.250,23,27,.852,113
1681,BRK,2022-02-06,104,@,DEN,L 104-124,240,36,87,.414,20,46,.435,16,41,.390,16,22,.727,104,49,94,.521,39,62,.629,10,32,.313,16,21,.762,124
1682,MIA,2022-02-05,104,@,CHO,W 104-86,240,38,91,.418,27,59,.458,11,32,.344,17,18,.944,104,33,86,.384,23,50,.460,10,36,.278,10,16,.625,86
1683,CLE,2022-02-02,104,@,HOU,L 104-115,240,41,80,.513,34,59,.576,7,21,.333,15,27,.556,104,39,82,.476,25,42,.595,14,40,.350,23,33,.697,115
1684,DEN,2022-02-02,104,@,UTA,L 104-108,240,42,79,.532,31,51,.608,11,28,.393,9,12,.750,104,42,86,.488,35,57,.614,7,29,.241,17,22,.773,108
1685,SAC,2022-01-26,104,@,ATL,L 104-121,240,39,93,.419,27,53,.509,12,40,.300,14,19,.737,104,48,90,.533,36,54,.667,12,36,.333,13,17,.765,121
1686,HOU,2022-01-25,104,,SAS,L 104-134,240,39,95,.411,30,61,.492,9,34,.265,17,25,.680,104,58,101,.574,46,69,.667,12,32,.375,6,6,1.000,134
1687,DAL,2022-01-23,104,,MEM,W 104-91,240,36,74,.486,27,44,.614,9,30,.300,23,31,.742,104,37,99,.374,33,75,.440,4,24,.167,13,19,.684,91
1688,CLE,2022-01-19,104,@,CHI,L 104-117,240,40,77,.519,31,50,.620,9,27,.333,15,22,.682,104,47,86,.547,37,64,.578,10,22,.455,13,18,.722,117
1689,LAL,2022-01-19,104,,IND,L 104-111,240,40,90,.444,29,56,.518,11,34,.324,13,18,.722,104,44,90,.489,33,60,.550,11,30,.367,12,15,.800,111
1690,MIA,2022-01-19,104,,POR,W 104-92,240,37,80,.463,25,45,.556,12,35,.343,18,25,.720,104,33,81,.407,19,35,.543,14,46,.304,12,16,.750,92
1691,MIA,2022-01-17,104,,TOR,W 104-99,240,38,83,.458,29,59,.492,9,24,.375,19,22,.864,104,37,90,.411,24,54,.444,13,36,.361,12,17,.706,99
1692,BOS,2022-01-17,104,,NOP,W 104-92,240,38,80,.475,28,48,.583,10,32,.313,18,20,.900,104,36,87,.414,27,57,.474,9,30,.300,11,18,.611,92
1693,DAL,2022-01-17,104,,OKC,W 104-102,240,35,88,.398,23,51,.451,12,37,.324,22,28,.786,104,36,83,.434,25,48,.521,11,35,.314,19,24,.792,102
1694,SAS,2022-01-04,104,@,TOR,L 104-129,240,41,95,.432,32,60,.533,9,35,.257,13,19,.684,104,45,96,.469,27,52,.519,18,44,.409,21,29,.724,129
1695,NYK,2022-01-04,104,,IND,W 104-94,240,39,80,.488,33,52,.635,6,28,.214,20,28,.714,104,32,76,.421,23,38,.605,9,38,.237,21,32,.656,94
1696,BRK,2022-01-03,104,,MEM,L 104-118,240,37,82,.451,28,51,.549,9,31,.290,21,26,.808,104,48,102,.471,38,67,.567,10,35,.286,12,21,.571,118
1697,NOP,2022-01-03,104,,UTA,L 104-115,240,39,97,.402,27,51,.529,12,46,.261,14,22,.636,104,41,85,.482,22,46,.478,19,39,.487,14,17,.824,115
1698,LAC,2022-01-03,104,,MIN,L 104-122,240,39,78,.500,28,46,.609,11,32,.344,15,17,.882,104,49,93,.527,33,48,.688,16,45,.356,8,9,.889,122
1699,IND,2022-01-02,104,@,CLE,L 104-108,240,37,83,.446,18,37,.486,19,46,.413,11,14,.786,104,41,88,.466,35,62,.565,6,26,.231,20,28,.714,108
1700,MEM,2021-12-29,104,,LAL,W 104-99,240,35,85,.412,25,55,.455,10,30,.333,24,29,.828,104,39,86,.453,24,45,.533,15,41,.366,6,8,.750,99
1701,CLE,2021-12-28,104,@,NOP,L 104-108,240,37,88,.420,23,47,.489,14,41,.341,16,19,.842,104,36,80,.450,20,44,.455,16,36,.444,20,26,.769,108
1702,SAS,2021-12-27,104,,UTA,L 104-110,240,45,100,.450,35,70,.500,10,30,.333,4,9,.444,104,39,86,.453,30,55,.545,9,31,.290,23,30,.767,110
1703,MEM,2021-12-23,104,@,GSW,L 104-113,240,38,90,.422,30,64,.469,8,26,.308,20,24,.833,104,40,82,.488,21,42,.500,19,40,.475,14,18,.778,113
1704,ORL,2021-12-23,104,,NOP,L 104-110,240,38,88,.432,29,56,.518,9,32,.281,19,21,.905,104,37,86,.430,24,56,.429,13,30,.433,23,26,.885,110
1705,ORL,2021-12-22,104,@,ATL,W 104-98,240,38,85,.447,27,48,.563,11,37,.297,17,23,.739,104,32,80,.400,20,49,.408,12,31,.387,22,29,.759,98
1706,OKC,2021-12-18,104,,LAC,W 104-103,240,43,92,.467,31,61,.508,12,31,.387,6,10,.600,104,37,83,.446,21,44,.477,16,39,.410,13,19,.684,103
1707,DAL,2021-12-15,104,,LAL,L 104-107 (OT),265,39,98,.398,27,54,.500,12,44,.273,14,17,.824,104,39,90,.433,24,51,.471,15,39,.385,14,18,.778,107
1708,DET,2021-12-12,104,,BRK,L 104-116,240,39,92,.424,25,55,.455,14,37,.378,12,18,.667,104,41,87,.471,30,59,.508,11,28,.393,23,25,.920,116
1709,ORL,2021-12-11,104,@,LAC,L 104-106,240,35,80,.438,23,47,.489,12,33,.364,22,24,.917,104,42,92,.457,24,56,.429,18,36,.500,4,6,.667,106
1710,MIL,2021-12-08,104,@,MIA,L 104-113,240,36,85,.424,24,46,.522,12,39,.308,20,27,.741,104,40,77,.519,18,30,.600,22,47,.468,11,12,.917,113
1711,MIN,2021-12-08,104,,UTA,L 104-136,240,38,95,.400,21,48,.438,17,47,.362,11,17,.647,104,50,88,.568,25,34,.735,25,54,.463,11,15,.733,136
1712,BRK,2021-12-08,104,@,HOU,L 104-114,240,35,89,.393,27,56,.482,8,33,.242,26,31,.839,104,40,81,.494,26,40,.650,14,41,.341,20,29,.690,114
1713,DAL,2021-12-08,104,@,MEM,W 104-96,240,37,77,.481,25,44,.568,12,33,.364,18,23,.783,104,36,90,.400,27,59,.458,9,31,.290,15,25,.600,96
1714,GSW,2021-12-08,104,,POR,W 104-94,240,33,83,.398,19,37,.514,14,46,.304,24,31,.774,104,33,80,.413,25,50,.500,8,30,.267,20,28,.714,94
1715,CLE,2021-12-06,104,@,MIL,L 104-112,240,35,90,.389,20,44,.455,15,46,.326,19,20,.950,104,40,86,.465,27,54,.500,13,32,.406,19,24,.792,112
1716,SAS,2021-12-06,104,@,PHO,L 104-108,240,40,93,.430,29,64,.453,11,29,.379,13,19,.684,104,43,94,.457,33,65,.508,10,29,.345,12,18,.667,108
1717,SAC,2021-12-04,104,,LAC,W 104-99,240,36,86,.419,24,52,.462,12,34,.353,20,25,.800,104,34,89,.382,21,55,.382,13,34,.382,18,27,.667,99
1718,IND,2021-12-03,104,,MIA,L 104-113,240,35,80,.438,26,44,.591,9,36,.250,25,33,.758,104,43,81,.531,27,47,.574,16,34,.471,11,13,.846,113
1719,PHO,2021-11-30,104,,GSW,W 104-96,240,43,87,.494,31,57,.544,12,30,.400,6,11,.545,104,36,86,.419,22,46,.478,14,40,.350,10,14,.714,96
1720,LAC,2021-11-29,104,,NOP,L 104-123,240,37,72,.514,23,36,.639,14,36,.389,16,21,.762,104,48,94,.511,34,59,.576,14,35,.400,13,16,.813,123
1721,CHI,2021-11-27,104,,MIA,L 104-107,240,38,81,.469,27,42,.643,11,39,.282,17,21,.810,104,37,86,.430,23,46,.500,14,40,.350,19,22,.864,107
1722,BOS,2021-11-24,104,,BRK,L 104-123,240,34,91,.374,23,43,.535,11,48,.229,25,28,.893,104,43,85,.506,29,50,.580,14,35,.400,23,30,.767,123
1723,OKC,2021-11-24,104,,UTA,L 104-110,240,37,82,.451,22,46,.478,15,36,.417,15,22,.682,104,39,86,.453,24,39,.615,15,47,.319,17,20,.850,110
1724,LAC,2021-11-23,104,,DAL,L 104-112 (OT),265,35,85,.412,25,53,.472,10,32,.313,24,29,.828,104,39,89,.438,27,50,.540,12,39,.308,22,27,.815,112
1725,TOR,2021-11-21,104,@,GSW,L 104-119,240,39,99,.394,24,62,.387,15,37,.405,11,20,.550,104,39,79,.494,17,34,.500,22,45,.489,19,24,.792,119
1726,DAL,2021-11-19,104,@,PHO,L 104-112,240,37,90,.411,25,50,.500,12,40,.300,18,23,.783,104,44,85,.518,30,56,.536,14,29,.483,10,14,.714,112
1727,GSW,2021-11-18,104,@,CLE,W 104-89,240,41,83,.494,26,40,.650,15,43,.349,7,8,.875,104,34,80,.425,22,41,.537,12,39,.308,9,16,.563,89
1728,ORL,2021-11-17,104,@,NYK,W 104-98,240,39,96,.406,28,58,.483,11,38,.289,15,18,.833,104,37,88,.420,21,39,.538,16,49,.327,8,12,.667,98
1729,WAS,2021-11-13,104,@,ORL,W 104-92,240,42,84,.500,30,49,.612,12,35,.343,8,10,.800,104,31,92,.337,18,52,.346,13,40,.325,17,20,.850,92
1730,POR,2021-11-12,104,@,HOU,W 104-92,240,34,87,.391,23,51,.451,11,36,.306,25,31,.806,104,34,85,.400,27,53,.509,7,32,.219,17,27,.630,92
1731,CHO,2021-11-12,104,,NYK,W 104-96,240,39,90,.433,29,54,.537,10,36,.278,16,24,.667,104,36,93,.387,23,58,.397,13,35,.371,11,18,.611,96
1732,BOS,2021-11-10,104,,TOR,W 104-88,240,42,94,.447,32,65,.492,10,29,.345,10,15,.667,104,33,77,.429,27,52,.519,6,25,.240,16,19,.842,88
1733,HOU,2021-11-10,104,,DET,L 104-112,240,35,82,.427,23,48,.479,12,34,.353,22,34,.647,104,42,97,.433,26,49,.531,16,48,.333,12,18,.667,112
1734,SAC,2021-11-08,104,,PHO,L 104-109,240,37,82,.451,27,58,.466,10,24,.417,20,26,.769,104,44,93,.473,32,63,.508,12,30,.400,9,11,.818,109
1735,BOS,2021-11-06,104,@,DAL,L 104-107,240,42,86,.488,33,55,.600,9,31,.290,11,16,.688,104,41,78,.526,28,39,.718,13,39,.333,12,14,.857,107
1736,LAC,2021-11-05,104,@,MIN,W 104-84,240,36,88,.409,30,60,.500,6,28,.214,26,32,.813,104,31,89,.348,14,37,.378,17,52,.327,5,7,.714,84
1737,LAL,2021-11-04,104,,OKC,L 104-107,240,39,94,.415,27,61,.443,12,33,.364,14,17,.824,104,37,87,.425,22,46,.478,15,41,.366,18,26,.692,107
1738,POR,2021-11-03,104,@,CLE,L 104-107,240,40,90,.444,27,53,.509,13,37,.351,11,17,.647,104,39,74,.527,24,44,.545,15,30,.500,14,18,.778,107
1739,NYK,2021-11-01,104,,TOR,L 104-113,240,35,76,.461,19,38,.500,16,38,.421,18,24,.750,104,43,99,.434,29,57,.509,14,42,.333,13,14,.929,113
1740,MEM,2021-10-28,104,@,GSW,W 104-101 (OT),265,39,97,.402,27,49,.551,12,48,.250,14,14,1.000,104,39,90,.433,25,50,.500,14,40,.350,9,12,.750,101
1741,NYK,2021-10-28,104,@,CHI,W 104-103,240,39,85,.459,28,56,.500,11,29,.379,15,20,.750,104,36,84,.429,25,52,.481,11,32,.344,20,22,.909,103
1742,DAL,2021-10-28,104,,SAS,W 104-99,240,41,89,.461,23,44,.523,18,45,.400,4,13,.308,104,39,88,.443,27,58,.466,12,30,.400,9,15,.600,99
1743,DET,2021-10-25,104,@,ATL,L 104-122,240,40,91,.440,31,58,.534,9,33,.273,15,18,.833,104,46,90,.511,34,58,.586,12,32,.375,18,21,.857,122
1744,BRK,2021-10-25,104,,WAS,W 104-90,240,40,94,.426,30,59,.508,10,35,.286,14,17,.824,104,33,95,.347,24,56,.429,9,39,.231,15,20,.750,90
1745,NYK,2021-10-24,104,,ORL,L 104-110,240,37,100,.370,24,52,.462,13,48,.271,17,25,.680,104,36,88,.409,24,45,.533,12,43,.279,26,34,.765,110
1746,BRK,2021-10-19,104,@,MIL,L 104-127,240,37,84,.440,20,52,.385,17,32,.531,13,23,.565,104,48,105,.457,31,60,.517,17,45,.378,14,18,.778,127
1747,WAS,2022-04-06,103,@,ATL,L 103-118,240,42,86,.488,32,51,.627,10,35,.286,9,11,.818,103,43,92,.467,27,53,.509,16,39,.410,16,19,.842,118
1748,DAL,2022-04-01,103,@,WAS,L 103-135,240,34,78,.436,23,40,.575,11,38,.289,24,26,.923,103,49,90,.544,32,57,.561,17,33,.515,20,22,.909,135
1749,GSW,2022-03-30,103,,PHO,L 103-107,240,35,83,.422,22,45,.489,13,38,.342,20,25,.800,103,38,92,.413,31,64,.484,7,28,.250,24,30,.800,107
1750,NOP,2022-03-26,103,,SAS,L 103-107,240,40,90,.444,30,58,.517,10,32,.313,13,19,.684,103,39,92,.424,32,66,.485,7,26,.269,22,25,.880,107
1751,MIA,2022-03-25,103,,NYK,L 103-111,240,35,70,.500,23,37,.622,12,33,.364,21,25,.840,103,36,82,.439,19,32,.594,17,50,.340,22,28,.786,111
1752,IND,2022-03-24,103,@,MEM,L 103-133,240,39,92,.424,30,59,.508,9,33,.273,16,23,.696,103,50,93,.538,29,51,.569,21,42,.500,12,17,.706,133
1753,NOP,2022-03-21,103,@,CHO,L 103-106,240,40,90,.444,31,66,.470,9,24,.375,14,16,.875,103,40,79,.506,27,42,.643,13,37,.351,13,15,.867,106
1754,TOR,2022-03-16,103,@,LAC,W 103-100,240,38,83,.458,27,51,.529,11,32,.344,16,21,.762,103,38,78,.487,27,48,.563,11,30,.367,13,15,.867,100
1755,LAL,2022-03-14,103,,TOR,L 103-114,240,34,87,.391,21,45,.467,13,42,.310,22,29,.759,103,39,96,.406,29,59,.492,10,37,.270,26,36,.722,114
1756,CHI,2022-03-14,103,@,SAC,L 103-112,240,36,88,.409,26,54,.481,10,34,.294,21,22,.955,103,39,82,.476,29,57,.509,10,25,.400,24,26,.923,112
1757,DET,2022-03-11,103,@,BOS,L 103-114,240,35,83,.422,25,49,.510,10,34,.294,23,24,.958,103,42,90,.467,36,58,.621,6,32,.188,24,30,.800,114
1758,UTA,2022-03-07,103,@,DAL,L 103-111,240,36,83,.434,24,52,.462,12,31,.387,19,24,.792,103,39,88,.443,22,42,.524,17,46,.370,16,20,.800,111
1759,OKC,2022-03-06,103,,UTA,L 103-116,240,39,92,.424,31,52,.596,8,40,.200,17,19,.895,103,40,89,.449,17,37,.459,23,52,.442,13,17,.765,116
1760,ORL,2022-03-04,103,@,TOR,W 103-97,240,36,95,.379,25,58,.431,11,37,.297,20,21,.952,103,37,93,.398,25,56,.446,12,37,.324,11,17,.647,97
1761,IND,2022-02-28,103,@,ORL,L 103-119,240,35,72,.486,20,36,.556,15,36,.417,18,25,.720,103,45,96,.469,33,59,.559,12,37,.324,17,22,.773,119
1762,CLE,2022-02-24,103,@,DET,L 103-106,240,34,77,.442,22,42,.524,12,35,.343,23,34,.676,103,35,86,.407,24,52,.462,11,34,.324,25,28,.893,106
1763,BRK,2022-02-17,103,,WAS,L 103-117,240,36,89,.404,22,51,.431,14,38,.368,17,24,.708,103,46,83,.554,34,59,.576,12,24,.500,13,16,.813,117
1764,TOR,2022-02-16,103,@,MIN,W 103-91,240,40,88,.455,32,63,.508,8,25,.320,15,19,.789,103,30,77,.390,20,35,.571,10,42,.238,21,29,.724,91
1765,PHO,2022-02-15,103,,LAC,W 103-96,240,44,90,.489,36,65,.554,8,25,.320,7,10,.700,103,40,97,.412,30,62,.484,10,35,.286,6,9,.667,96
1766,WAS,2022-02-14,103,,DET,W 103-94,240,40,85,.471,31,56,.554,9,29,.310,14,18,.778,103,32,85,.376,24,62,.387,8,23,.348,22,27,.815,94
1767,NYK,2022-02-12,103,@,POR,L 103-112,240,31,81,.383,19,42,.452,12,39,.308,29,34,.853,103,40,84,.476,25,44,.568,15,40,.375,17,20,.850,112
1768,PHI,2022-02-12,103,,CLE,W 103-93,240,38,79,.481,28,57,.491,10,22,.455,17,21,.810,103,36,77,.468,28,53,.528,8,24,.333,13,15,.867,93
1769,DAL,2022-02-06,103,,ATL,W 103-94,240,38,88,.432,22,52,.423,16,36,.444,11,13,.846,103,37,95,.389,32,70,.457,5,25,.200,15,16,.938,94
1770,OKC,2022-02-05,103,@,SAC,L 103-113,240,42,87,.483,33,57,.579,9,30,.300,10,16,.625,103,43,83,.518,31,51,.608,12,32,.375,15,22,.682,113
1771,PHI,2022-02-02,103,,WAS,L 103-106,240,41,91,.451,30,64,.469,11,27,.407,10,13,.769,103,41,90,.456,32,68,.471,9,22,.409,15,19,.789,106
1772,PHI,2022-01-29,103,,SAC,W 103-101,240,36,70,.514,24,40,.600,12,30,.400,19,26,.731,103,36,82,.439,24,47,.511,12,35,.343,17,20,.850,101
1773,DET,2022-01-28,103,@,ORL,L 103-119,240,32,87,.368,22,58,.379,10,29,.345,29,37,.784,103,41,83,.494,29,58,.500,12,25,.480,25,26,.962,119
1774,IND,2022-01-22,103,@,PHO,L 103-113,240,37,84,.440,27,55,.491,10,29,.345,19,27,.704,103,47,96,.490,40,71,.563,7,25,.280,12,14,.857,113
1775,HOU,2022-01-21,103,@,GSW,L 103-105,240,38,89,.427,28,54,.519,10,35,.286,17,20,.850,103,39,81,.481,29,51,.569,10,30,.333,17,22,.773,105
1776,TOR,2022-01-15,103,@,MIL,W 103-96,240,40,91,.440,28,56,.500,12,35,.343,11,20,.550,103,26,77,.338,14,38,.368,12,39,.308,32,35,.914,96
1777,DET,2022-01-14,103,,TOR,W 103-87,240,38,81,.469,30,54,.556,8,27,.296,19,23,.826,103,28,87,.322,17,49,.347,11,38,.289,20,26,.769,87
1778,CHO,2022-01-10,103,,MIL,W 103-99,240,38,96,.396,25,52,.481,13,44,.295,14,16,.875,103,37,84,.440,24,41,.585,13,43,.302,12,16,.750,99
1779,POR,2022-01-09,103,,SAC,W 103-88,240,37,88,.420,20,48,.417,17,40,.425,12,15,.800,103,33,85,.388,26,54,.481,7,31,.226,15,21,.714,88
1780,DAL,2022-01-03,103,,DEN,W 103-89,240,35,78,.449,21,41,.512,14,37,.378,19,21,.905,103,31,67,.463,25,42,.595,6,25,.240,21,29,.724,89
1781,MIN,2022-01-02,103,@,LAL,L 103-108,240,41,92,.446,32,54,.593,9,38,.237,12,16,.750,103,36,75,.480,23,34,.676,13,41,.317,23,29,.793,108
1782,BOS,2021-12-27,103,@,MIN,L 103-108,240,33,89,.371,17,42,.405,16,47,.340,21,28,.750,103,40,90,.444,26,56,.464,14,34,.412,14,19,.737,108
1783,DEN,2021-12-26,103,@,LAC,W 103-100,240,39,95,.411,24,54,.444,15,41,.366,10,11,.909,103,40,86,.465,32,60,.533,8,26,.308,12,18,.667,100
1784,BOS,2021-12-20,103,,PHI,L 103-108,240,38,82,.463,31,55,.564,7,27,.259,20,25,.800,103,36,72,.500,26,47,.553,10,25,.400,26,31,.839,108
1785,LAC,2021-12-18,103,@,OKC,L 103-104,240,37,83,.446,21,44,.477,16,39,.410,13,19,.684,103,43,92,.467,31,61,.508,12,31,.387,6,10,.600,104
1786,UTA,2021-12-18,103,,WAS,L 103-109,240,35,81,.432,21,37,.568,14,44,.318,19,30,.633,103,42,94,.447,33,63,.524,9,31,.290,16,20,.800,109
1787,HOU,2021-12-16,103,,NYK,L 103-116,240,34,68,.500,23,36,.639,11,32,.344,24,30,.800,103,39,83,.470,22,47,.468,17,36,.472,21,25,.840,116
1788,LAC,2021-12-15,103,@,UTA,L 103-124,240,40,85,.471,30,55,.545,10,30,.333,13,20,.650,103,47,89,.528,32,52,.615,15,37,.405,15,20,.750,124
1789,POR,2021-12-15,103,,MEM,L 103-113,240,31,82,.378,16,44,.364,15,38,.395,26,28,.929,103,39,82,.476,28,50,.560,11,32,.344,24,30,.800,113
1790,MIL,2021-12-13,103,@,BOS,L 103-117,240,40,90,.444,29,54,.537,11,36,.306,12,15,.800,103,43,86,.500,23,39,.590,20,47,.426,11,13,.846,117
1791,DAL,2021-12-12,103,@,OKC,W 103-84,240,38,90,.422,29,57,.509,9,33,.273,18,23,.783,103,30,80,.375,17,43,.395,13,37,.351,11,16,.688,84
1792,SAC,2021-12-11,103,@,CLE,L 103-117,240,41,93,.441,34,65,.523,7,28,.250,14,22,.636,103,41,88,.466,29,57,.509,12,31,.387,23,28,.821,117
1793,DET,2021-12-06,103,,OKC,L 103-114,240,41,99,.414,25,58,.431,16,41,.390,5,6,.833,103,41,82,.500,32,57,.561,9,25,.360,23,30,.767,114
1794,DET,2021-12-02,103,@,PHO,L 103-114,240,36,80,.450,25,53,.472,11,27,.407,20,26,.769,103,43,79,.544,31,58,.534,12,21,.571,16,23,.696,114
1795,DEN,2021-12-01,103,@,ORL,L 103-108,240,39,80,.488,29,46,.630,10,34,.294,15,21,.714,103,44,81,.543,38,54,.704,6,27,.222,14,19,.737,108
1796,POR,2021-11-26,103,@,GSW,L 103-118,240,36,86,.419,23,48,.479,13,38,.342,18,23,.783,103,47,87,.540,35,50,.700,12,37,.324,12,16,.750,118
1797,WAS,2021-11-22,103,,CHO,L 103-109,240,36,94,.383,27,57,.474,9,37,.243,22,27,.815,103,40,91,.440,25,60,.417,15,31,.484,14,24,.583,109
1798,NYK,2021-11-21,103,@,CHI,L 103-109,240,35,84,.417,28,57,.491,7,27,.259,26,31,.839,103,37,88,.420,26,59,.441,11,29,.379,24,27,.889,109
1799,WAS,2021-11-20,103,,MIA,W 103-100,240,36,74,.486,25,44,.568,11,30,.367,20,23,.870,103,38,81,.469,31,54,.574,7,27,.259,17,20,.850,100
1800,TOR,2021-11-18,103,@,UTA,L 103-119,240,39,94,.415,29,56,.518,10,38,.263,15,17,.882,103,44,80,.550,25,34,.735,19,46,.413,12,13,.923,119
1801,TOR,2021-11-18,103,@,UTA,L 103-119,240,39,94,.415,29,56,.518,10,38,.263,15,17,.882,103,44,80,.550,25,34,.735,19,46,.413,12,13,.923,119
1802,MIA,2021-11-15,103,@,OKC,W 103-90,240,37,82,.451,19,42,.452,18,40,.450,11,13,.846,103,34,83,.410,19,42,.452,15,41,.366,7,10,.700,90
1803,LAL,2021-11-15,103,,CHI,L 103-121,240,36,79,.456,30,47,.638,6,32,.188,25,31,.806,103,49,89,.551,34,55,.618,15,34,.441,8,11,.727,121
1804,SAC,2021-11-12,103,@,OKC,L 103-105,240,38,95,.400,24,54,.444,14,41,.341,13,17,.765,103,42,99,.424,32,69,.464,10,30,.333,11,15,.733,105
1805,NYK,2021-11-08,103,@,PHI,W 103-96,240,40,91,.440,27,51,.529,13,40,.325,10,13,.769,103,35,91,.385,22,51,.431,13,40,.325,13,16,.813,96
1806,TOR,2021-11-07,103,,BRK,L 103-116,240,41,87,.471,34,57,.596,7,30,.233,14,18,.778,103,41,80,.513,24,42,.571,17,38,.447,17,20,.850,116
1807,PHI,2021-11-03,103,,CHI,W 103-98,240,38,77,.494,26,49,.531,12,28,.429,15,21,.714,103,38,82,.463,32,61,.525,6,21,.286,16,18,.889,98
1808,POR,2021-11-01,103,@,PHI,L 103-113,240,40,84,.476,28,50,.560,12,34,.353,11,18,.611,103,43,83,.518,30,47,.638,13,36,.361,14,16,.875,113
1809,MEM,2021-10-30,103,,MIA,L 103-129,240,34,88,.386,18,38,.474,16,50,.320,19,21,.905,103,46,88,.523,25,51,.490,21,37,.568,16,19,.842,129
1810,ORL,2021-10-30,103,@,DET,L 103-110,240,38,87,.437,22,55,.400,16,32,.500,11,15,.733,103,36,89,.404,22,46,.478,14,43,.326,24,30,.800,110
1811,GSW,2021-10-30,103,,OKC,W 103-82,240,39,92,.424,18,38,.474,21,54,.389,4,8,.500,103,29,83,.349,21,44,.477,8,39,.205,16,21,.762,82
1812,CHI,2021-10-28,103,,NYK,L 103-104,240,36,84,.429,25,52,.481,11,32,.344,20,22,.909,103,39,85,.459,28,56,.500,11,29,.379,15,20,.750,104
1813,OKC,2021-10-24,103,,PHI,L 103-115,240,40,84,.476,32,53,.604,8,31,.258,15,19,.789,103,41,88,.466,24,47,.511,17,41,.415,16,20,.800,115
1814,DAL,2021-10-23,103,@,TOR,W 103-95,240,38,91,.418,24,49,.490,14,42,.333,13,18,.722,103,34,85,.400,23,48,.479,11,37,.297,16,23,.696,95
1815,WAS,2022-04-03,102,@,BOS,L 102-144,240,38,82,.463,30,61,.492,8,21,.381,18,20,.900,102,56,91,.615,33,47,.702,23,44,.523,9,13,.692,144
1816,TOR,2022-04-01,102,@,ORL,W 102-89,240,36,86,.419,23,44,.523,13,42,.310,17,20,.850,102,34,79,.430,23,44,.523,11,35,.314,10,11,.909,89
1817,DET,2022-03-31,102,,PHI,W 102-94,240,41,82,.500,31,47,.660,10,35,.286,10,15,.667,102,31,69,.449,24,43,.558,7,26,.269,25,28,.893,94
1818,MIN,2022-03-30,102,@,TOR,L 102-125,240,37,92,.402,26,55,.473,11,37,.297,17,23,.739,102,48,96,.500,30,60,.500,18,36,.500,11,15,.733,125
1819,DET,2022-03-27,102,,NYK,L 102-104,240,39,85,.459,31,56,.554,8,29,.276,16,18,.889,102,34,85,.400,21,44,.477,13,41,.317,23,29,.793,104
1820,MIL,2022-03-26,102,@,MEM,L 102-127,240,37,93,.398,30,61,.492,7,32,.219,21,26,.808,102,49,102,.480,36,65,.554,13,37,.351,16,23,.696,127
1821,WAS,2022-03-24,102,@,MIL,L 102-114,240,43,92,.467,32,54,.593,11,38,.289,5,9,.556,102,42,81,.519,26,46,.565,16,35,.457,14,16,.875,114
1822,ORL,2022-03-23,102,@,OKC,L 102-118,240,36,93,.387,19,42,.452,17,51,.333,13,16,.813,102,38,79,.481,21,38,.553,17,41,.415,25,30,.833,118
1823,CHI,2022-03-18,102,@,PHO,L 102-129,240,35,85,.412,28,58,.483,7,27,.259,25,31,.806,102,47,84,.560,36,59,.610,11,25,.440,24,26,.923,129
1824,IND,2022-03-15,102,,MEM,L 102-135,240,41,98,.418,35,68,.515,6,30,.200,14,19,.737,102,54,105,.514,39,65,.600,15,40,.375,12,20,.600,135
1825,DET,2022-03-13,102,,LAC,L 102-106,240,36,80,.450,24,51,.471,12,29,.414,18,20,.900,102,40,89,.449,30,59,.508,10,30,.333,16,20,.800,106
1826,UTA,2022-03-11,102,@,SAS,L 102-104,240,37,92,.402,24,52,.462,13,40,.325,15,23,.652,102,34,85,.400,28,56,.500,6,29,.207,30,43,.698,104
1827,DEN,2022-03-10,102,,GSW,L 102-113,240,35,84,.417,28,53,.528,7,31,.226,25,32,.781,102,42,88,.477,28,46,.609,14,42,.333,15,20,.750,113
1828,NOP,2022-03-09,102,,ORL,L 102-108,240,41,93,.441,34,62,.548,7,31,.226,13,18,.722,102,36,76,.474,22,39,.564,14,37,.378,22,26,.846,108
1829,OKC,2022-03-09,102,@,MIN,L 102-132,240,36,87,.414,22,44,.500,14,43,.326,16,24,.667,102,45,86,.523,23,34,.676,22,52,.423,20,26,.769,132
1830,PHO,2022-03-08,102,@,ORL,W 102-99,240,35,92,.380,22,55,.400,13,37,.351,19,23,.826,102,35,92,.380,28,53,.528,7,39,.179,22,25,.880,99
1831,PHO,2022-02-25,102,,NOP,L 102-117,240,36,82,.439,24,42,.571,12,40,.300,18,24,.750,102,38,87,.437,30,58,.517,8,29,.276,33,41,.805,117
1832,LAL,2022-02-25,102,,LAC,L 102-105,240,39,93,.419,31,62,.500,8,31,.258,16,21,.762,102,41,83,.494,31,57,.544,10,26,.385,13,19,.684,105
1833,MIN,2022-02-25,102,,PHI,L 102-133,240,36,86,.419,27,47,.574,9,39,.231,21,25,.840,102,42,82,.512,23,43,.535,19,39,.487,30,36,.833,133
1834,DEN,2022-02-11,102,@,BOS,L 102-108,240,39,90,.433,28,46,.609,11,44,.250,13,18,.722,102,38,96,.396,28,59,.475,10,37,.270,22,30,.733,108
1835,CLE,2022-02-04,102,@,CHO,W 102-101,240,36,90,.400,22,55,.400,14,35,.400,16,20,.800,102,38,92,.413,24,49,.490,14,43,.326,11,12,.917,101
1836,BOS,2022-02-04,102,@,DET,W 102-93,240,37,82,.451,28,54,.519,9,28,.321,19,25,.760,102,34,104,.327,24,78,.308,10,26,.385,15,20,.750,93
1837,BRK,2022-02-04,102,@,UTA,L 102-125,240,41,99,.414,29,65,.446,12,34,.353,8,11,.727,102,48,85,.565,31,47,.660,17,38,.447,12,14,.857,125
1838,ORL,2022-01-26,102,,LAC,L 102-111,240,38,84,.452,29,49,.592,9,35,.257,17,22,.773,102,36,81,.444,21,52,.404,15,29,.517,24,27,.889,111
1839,LAC,2022-01-23,102,@,NYK,L 102-110,240,34,79,.430,20,38,.526,14,41,.341,20,30,.667,102,39,91,.429,23,55,.418,16,36,.444,16,19,.842,110
1840,LAC,2022-01-21,102,@,PHI,W 102-101,240,40,87,.460,29,55,.527,11,32,.344,11,15,.733,102,38,91,.418,28,63,.444,10,28,.357,15,21,.714,101
1841,SAS,2022-01-21,102,,BRK,L 102-117,240,37,95,.389,29,66,.439,8,29,.276,20,24,.833,102,48,100,.480,39,75,.520,9,25,.360,12,12,1.000,117
1842,NOP,2022-01-20,102,@,NYK,W 102-91,240,38,76,.500,27,48,.563,11,28,.393,15,22,.682,102,29,77,.377,20,39,.513,9,38,.237,24,36,.667,91
1843,BOS,2022-01-19,102,,CHO,L 102-111,240,39,90,.433,25,44,.568,14,46,.304,10,13,.769,102,42,86,.488,26,47,.553,16,39,.410,11,15,.733,111
1844,DAL,2022-01-19,102,,TOR,W 102-98,240,37,76,.487,28,43,.651,9,33,.273,19,20,.950,102,35,91,.385,27,59,.458,8,32,.250,20,25,.800,98
1845,GSW,2022-01-18,102,,DET,W 102-86,240,34,83,.410,20,41,.488,14,42,.333,20,27,.741,102,30,85,.353,21,51,.412,9,34,.265,17,24,.708,86
1846,OKC,2022-01-17,102,@,DAL,L 102-104,240,36,83,.434,25,48,.521,11,35,.314,19,24,.792,102,35,88,.398,23,51,.451,12,37,.324,22,28,.786,104
1847,DEN,2022-01-16,102,,UTA,L 102-125,240,42,95,.442,31,52,.596,11,43,.256,7,8,.875,102,44,84,.524,29,45,.644,15,39,.385,22,29,.759,125
1848,OKC,2022-01-15,102,,CLE,L 102-107,240,36,83,.434,26,56,.464,10,27,.370,20,22,.909,102,40,87,.460,31,52,.596,9,35,.257,18,25,.720,107
1849,WAS,2022-01-09,102,@,ORL,W 102-100,240,36,88,.409,25,59,.424,11,29,.379,19,24,.792,102,38,95,.400,29,67,.433,9,28,.321,15,16,.938,100
1850,SAC,2022-01-05,102,,ATL,L 102-108,240,38,90,.422,27,63,.429,11,27,.407,15,20,.750,102,39,86,.453,31,56,.554,8,30,.267,22,30,.733,108
1851,CHI,2022-01-03,102,,ORL,W 102-98,240,37,86,.430,26,55,.473,11,31,.355,17,23,.739,102,36,85,.424,26,58,.448,10,27,.370,16,18,.889,98
1852,BRK,2021-12-30,102,,PHI,L 102-110,240,37,81,.457,30,54,.556,7,27,.259,21,27,.778,102,42,100,.420,29,68,.426,13,32,.406,13,20,.650,110
1853,SAC,2021-12-26,102,,MEM,L 102-127,240,34,81,.420,24,52,.462,10,29,.345,24,27,.889,102,47,100,.470,38,70,.543,9,30,.300,24,30,.800,127
1854,MIL,2021-12-23,102,@,DAL,W 102-95,240,37,82,.451,27,46,.587,10,36,.278,18,22,.818,102,35,86,.407,23,41,.561,12,45,.267,13,17,.765,95
1855,MIN,2021-12-21,102,@,DAL,L 102-114,240,36,79,.456,23,39,.590,13,40,.325,17,20,.850,102,42,86,.488,31,52,.596,11,34,.324,19,23,.826,114
1856,CHO,2021-12-20,102,@,UTA,L 102-112,240,39,101,.386,24,58,.414,15,43,.349,9,9,1.000,102,34,96,.354,18,43,.419,16,53,.302,28,37,.757,112
1857,OKC,2021-12-20,102,@,MEM,W 102-99,240,36,84,.429,25,46,.543,11,38,.289,19,28,.679,102,39,101,.386,28,69,.406,11,32,.344,10,13,.769,99
1858,GSW,2021-12-13,102,@,IND,W 102-100,240,42,84,.500,34,54,.630,8,30,.267,10,14,.714,102,35,87,.402,28,57,.491,7,30,.233,23,31,.742,100
1859,PHI,2021-12-11,102,,GSW,W 102-93,240,35,76,.461,26,49,.531,9,27,.333,23,26,.885,102,34,85,.400,22,37,.595,12,48,.250,13,18,.722,93
1860,NYK,2021-12-08,102,@,IND,L 102-122,240,36,86,.419,27,56,.482,9,30,.300,21,23,.913,102,46,86,.535,36,59,.610,10,27,.370,20,25,.800,122
1861,BOS,2021-12-07,102,@,LAL,L 102-117,240,36,82,.439,26,49,.531,10,33,.303,20,29,.690,102,48,93,.516,40,66,.606,8,27,.296,13,17,.765,117
1862,BRK,2021-12-07,102,@,DAL,W 102-99,240,42,83,.506,34,57,.596,8,26,.308,10,13,.769,102,36,90,.400,27,44,.614,9,46,.196,18,22,.818,99
1863,LAC,2021-12-06,102,@,POR,W 102-90,240,41,92,.446,30,56,.536,11,36,.306,9,14,.643,102,35,79,.443,30,57,.526,5,22,.227,15,20,.750,90
1864,TOR,2021-12-05,102,,WAS,W 102-90,240,38,85,.447,30,62,.484,8,23,.348,18,24,.750,102,30,73,.411,22,48,.458,8,25,.320,22,29,.759,90
1865,MIA,2021-12-04,102,@,MIL,L 102-124,240,34,84,.405,17,41,.415,17,43,.395,17,24,.708,102,44,98,.449,26,48,.542,18,50,.360,18,20,.900,124
1866,HOU,2021-11-29,102,,OKC,W 102-89,240,40,96,.417,25,50,.500,15,46,.326,7,11,.636,102,31,87,.356,24,44,.545,7,43,.163,20,26,.769,89
1867,WAS,2021-11-24,102,@,NOP,L 102-127,240,36,84,.429,29,53,.547,7,31,.226,23,36,.639,102,44,96,.458,32,67,.478,12,29,.414,27,32,.844,127
1868,PHI,2021-11-22,102,@,SAC,W 102-94,240,36,85,.424,27,53,.509,9,32,.281,21,27,.778,102,33,80,.413,26,49,.531,7,31,.226,21,29,.724,94
1869,DET,2021-11-19,102,,GSW,L 102-105,240,32,80,.400,18,38,.474,14,42,.333,24,30,.800,102,38,80,.475,26,50,.520,12,30,.400,17,21,.810,105
1870,LAL,2021-11-17,102,@,MIL,L 102-109,240,40,96,.417,28,53,.528,12,43,.279,10,12,.833,102,40,87,.460,28,50,.560,12,37,.324,17,24,.708,109
1871,HOU,2021-11-15,102,@,MEM,L 102-136,240,36,95,.379,25,57,.439,11,38,.289,19,26,.731,102,52,96,.542,36,55,.655,16,41,.390,16,20,.800,136
1872,GSW,2021-11-14,102,@,CHO,L 102-106,240,38,90,.422,29,51,.569,9,39,.231,17,25,.680,102,42,88,.477,28,52,.538,14,36,.389,8,12,.667,106
1873,MIN,2021-11-13,102,@,LAC,L 102-129,240,40,102,.392,29,66,.439,11,36,.306,11,16,.688,102,53,99,.535,37,59,.627,16,40,.400,7,9,.778,129
1874,SAS,2021-11-05,102,@,ORL,W 102-89,240,40,90,.444,34,71,.479,6,19,.316,16,18,.889,102,35,89,.393,23,48,.479,12,41,.293,7,10,.700,89
1875,CLE,2021-11-05,102,@,TOR,W 102-101,240,38,83,.458,28,53,.528,10,30,.333,16,19,.842,102,42,99,.424,30,72,.417,12,27,.444,5,9,.556,101
1876,SAS,2021-10-30,102,@,MIL,W 102-93,240,39,95,.411,32,64,.500,7,31,.226,17,24,.708,102,36,89,.404,26,50,.520,10,39,.256,11,16,.688,93
1877,DET,2021-10-28,102,@,PHI,L 102-110,240,35,86,.407,22,47,.468,13,39,.333,19,27,.704,102,38,76,.500,26,49,.531,12,27,.444,22,24,.917,110
1878,ATL,2021-10-27,102,@,NOP,W 102-99,240,40,96,.417,32,66,.485,8,30,.267,14,17,.824,102,40,93,.430,29,57,.509,11,36,.306,8,9,.889,99
1879,IND,2021-10-23,102,,MIA,W 102-91 (OT),265,38,97,.392,28,58,.483,10,39,.256,16,21,.762,102,35,91,.385,26,58,.448,9,33,.273,12,14,.857,91
1880,DEN,2021-10-22,102,,SAS,W 102-96,240,44,86,.512,35,56,.625,9,30,.300,5,8,.625,102,40,84,.476,34,60,.567,6,24,.250,10,14,.714,96
1881,OKC,2022-04-08,101,@,LAL,L 101-120,240,40,88,.455,34,59,.576,6,29,.207,15,19,.789,101,41,82,.500,32,51,.627,9,31,.290,29,39,.744,120
1882,DET,2022-04-08,101,,MIL,L 101-131,240,35,90,.389,25,42,.595,10,48,.208,21,23,.913,101,50,101,.495,39,64,.609,11,37,.297,20,23,.870,131
1883,ORL,2022-04-07,101,@,CHO,L 101-128,240,38,95,.400,23,47,.489,15,48,.313,10,13,.769,101,48,92,.522,36,58,.621,12,34,.353,20,27,.741,128
1884,OKC,2022-04-06,101,@,UTA,L 101-137,240,37,90,.411,21,53,.396,16,37,.432,11,17,.647,101,49,84,.583,34,48,.708,15,36,.417,24,32,.750,137
1885,NYK,2022-04-02,101,,CLE,L 101-119,240,31,77,.403,18,47,.383,13,30,.433,26,34,.765,101,44,81,.543,29,47,.617,15,34,.441,16,21,.762,119
1886,OKC,2022-04-01,101,,DET,L 101-110,240,36,84,.429,25,50,.500,11,34,.324,18,29,.621,101,40,94,.426,25,46,.543,15,48,.313,15,18,.833,110
1887,ORL,2022-03-28,101,@,CLE,L 101-107,240,42,87,.483,32,50,.640,10,37,.270,7,13,.538,101,37,83,.446,24,42,.571,13,41,.317,20,23,.870,107
1888,UTA,2022-03-25,101,@,CHO,L 101-107,240,38,84,.452,21,37,.568,17,47,.362,8,11,.727,101,41,88,.466,28,54,.519,13,34,.382,12,17,.706,107
1889,ATL,2022-03-23,101,@,DET,L 101-122,240,37,92,.402,23,48,.479,14,44,.318,13,15,.867,101,44,88,.500,32,55,.582,12,33,.364,22,25,.880,122
1890,DAL,2022-03-18,101,@,PHI,L 101-111,240,37,80,.463,25,48,.521,12,32,.375,15,21,.714,101,37,75,.493,21,37,.568,16,38,.421,21,23,.913,111
1891,CHI,2022-03-12,101,,CLE,W 101-91,240,39,88,.443,30,67,.448,9,21,.429,14,15,.933,101,36,86,.419,31,62,.500,5,24,.208,14,17,.824,91
1892,CHO,2022-03-09,101,,BOS,L 101-115,240,36,85,.424,28,52,.538,8,33,.242,21,28,.750,101,46,93,.495,34,56,.607,12,37,.324,11,14,.786,115
1893,HOU,2022-03-04,101,@,DEN,L 101-116,240,38,83,.458,28,47,.596,10,36,.278,15,22,.682,101,39,86,.453,26,53,.491,13,33,.394,25,31,.806,116
1894,OKC,2022-03-04,101,,MIN,L 101-138,240,37,86,.430,28,51,.549,9,35,.257,18,21,.857,101,49,91,.538,27,44,.614,22,47,.468,18,23,.783,138
1895,GSW,2022-02-27,101,,DAL,L 101-107,240,39,91,.429,28,52,.538,11,39,.282,12,20,.600,101,39,78,.500,26,44,.591,13,34,.382,16,20,.800,107
1896,UTA,2022-02-16,101,@,LAL,L 101-106,240,37,79,.468,26,46,.565,11,33,.333,16,19,.842,101,41,86,.477,31,50,.620,10,36,.278,14,22,.636,106
1897,HOU,2022-02-14,101,@,UTA,L 101-135,240,35,83,.422,23,46,.500,12,37,.324,19,28,.679,101,49,89,.551,31,49,.633,18,40,.450,19,22,.864,135
1898,OKC,2022-02-12,101,@,CHI,L 101-106,240,34,88,.386,23,52,.442,11,36,.306,22,30,.733,101,40,89,.449,33,64,.516,7,25,.280,19,23,.826,106
1899,CHO,2022-02-07,101,,TOR,L 101-116,240,39,95,.411,30,55,.545,9,40,.225,14,16,.875,101,41,84,.488,26,49,.531,15,35,.429,19,29,.655,116
1900,CHO,2022-02-04,101,,CLE,L 101-102,240,38,92,.413,24,49,.490,14,43,.326,11,12,.917,101,36,90,.400,22,55,.400,14,35,.400,16,20,.800,102
1901,BRK,2022-02-02,101,@,SAC,L 101-112,240,41,84,.488,33,59,.559,8,25,.320,11,14,.786,101,41,93,.441,27,51,.529,14,42,.333,16,18,.889,112
1902,DET,2022-02-01,101,,NOP,L 101-111,240,41,84,.488,33,52,.635,8,32,.250,11,14,.786,101,39,89,.438,31,61,.508,8,28,.286,25,28,.893,111
1903,SAC,2022-01-29,101,@,PHI,L 101-103,240,36,82,.439,24,47,.511,12,35,.343,17,20,.850,101,36,70,.514,24,40,.600,12,30,.400,19,26,.731,103
1904,PHI,2022-01-21,101,,LAC,L 101-102,240,38,91,.418,28,63,.444,10,28,.357,15,21,.714,101,40,87,.460,29,55,.527,11,32,.344,11,15,.733,102
1905,DET,2022-01-21,101,@,UTA,L 101-111,240,38,87,.437,25,55,.455,13,32,.406,12,16,.750,101,36,79,.456,26,48,.542,10,31,.323,29,34,.853,111
1906,DAL,2022-01-20,101,,PHO,L 101-109,240,37,85,.435,26,48,.542,11,37,.297,16,20,.800,101,39,86,.453,31,50,.620,8,36,.222,23,25,.920,109
1907,LAL,2022-01-17,101,,UTA,W 101-95,240,38,86,.442,27,49,.551,11,37,.297,14,23,.609,101,31,83,.373,19,37,.514,12,46,.261,21,24,.875,95
1908,SAS,2022-01-15,101,,LAC,W 101-94,240,34,83,.410,23,46,.500,11,37,.297,22,27,.815,101,38,100,.380,26,62,.419,12,38,.316,6,8,.750,94
1909,BOS,2022-01-10,101,,IND,W 101-98 (OT),265,35,88,.398,27,60,.450,8,28,.286,23,28,.821,101,36,94,.383,25,57,.439,11,37,.297,15,17,.882,98
1910,NOP,2022-01-09,101,@,TOR,L 101-105,240,34,75,.453,22,42,.524,12,33,.364,21,25,.840,101,36,85,.424,22,51,.431,14,34,.412,19,20,.950,105
1911,POR,2022-01-07,101,,CLE,L 101-114,240,37,92,.402,21,57,.368,16,35,.457,11,19,.579,101,39,80,.488,22,41,.537,17,39,.436,19,29,.655,114
1912,NOP,2022-01-06,101,,GSW,W 101-96,240,35,83,.422,27,49,.551,8,34,.235,23,29,.793,101,37,87,.425,30,54,.556,7,33,.212,15,18,.833,96
1913,NYK,2021-12-25,101,,ATL,W 101-87,240,38,85,.447,18,35,.514,20,50,.400,5,12,.417,101,33,87,.379,20,49,.408,13,38,.342,8,14,.571,87
1914,OKC,2021-12-23,101,@,PHO,L 101-113,240,37,96,.385,26,55,.473,11,41,.268,16,21,.762,101,45,93,.484,30,54,.556,15,39,.385,8,13,.615,113
1915,CLE,2021-12-22,101,@,BOS,L 101-111,240,36,92,.391,27,54,.500,9,38,.237,20,24,.833,101,43,92,.467,32,62,.516,11,30,.367,14,18,.778,111
1916,MIA,2021-12-15,101,@,PHI,W 101-96,240,35,78,.449,17,34,.500,18,44,.409,13,17,.765,101,35,79,.443,23,42,.548,12,37,.324,14,17,.824,96
1917,SAC,2021-12-13,101,@,TOR,L 101-124,240,38,94,.404,27,60,.450,11,34,.324,14,21,.667,101,53,98,.541,42,67,.627,11,31,.355,7,10,.700,124
1918,WAS,2021-12-03,101,,CLE,L 101-116,240,38,82,.463,28,51,.549,10,31,.323,15,19,.789,101,42,89,.472,29,59,.492,13,30,.433,19,25,.760,116
1919,PHI,2021-11-29,101,,ORL,W 101-96,240,39,97,.402,29,64,.453,10,33,.303,13,18,.722,101,37,90,.411,29,57,.509,8,33,.242,14,18,.778,96
1920,SAC,2021-11-28,101,@,MEM,L 101-128,240,33,97,.340,24,55,.436,9,42,.214,26,37,.703,101,50,104,.481,37,65,.569,13,39,.333,15,20,.750,128
1921,WAS,2021-11-26,101,@,OKC,W 101-99,240,38,79,.481,28,50,.560,10,29,.345,15,15,1.000,101,38,94,.404,27,61,.443,11,33,.333,12,14,.857,99
1922,MIA,2021-11-24,101,@,MIN,L 101-113,240,33,74,.446,18,32,.563,15,42,.357,20,29,.690,101,38,93,.409,20,38,.526,18,55,.327,19,21,.905,113
1923,OKC,2021-11-22,101,@,ATL,L 101-113,240,39,97,.402,29,59,.492,10,38,.263,13,14,.929,101,42,87,.483,28,53,.528,14,34,.412,15,16,.938,113
1924,OKC,2021-11-17,101,,HOU,W 101-89,240,41,92,.446,31,53,.585,10,39,.256,9,16,.563,101,32,90,.356,20,48,.417,12,42,.286,13,19,.684,89
1925,DEN,2021-11-15,101,@,DAL,L 101-111,240,40,84,.476,31,52,.596,9,32,.281,12,17,.706,101,45,90,.500,31,54,.574,14,36,.389,7,10,.700,111
1926,MEM,2021-11-13,101,@,NOP,L 101-112,240,38,88,.432,30,64,.469,8,24,.333,17,21,.810,101,38,79,.481,24,50,.480,14,29,.483,22,25,.880,112
1927,DEN,2021-11-10,101,,IND,W 101-98,240,36,84,.429,24,54,.444,12,30,.400,17,20,.850,101,40,84,.476,29,53,.547,11,31,.355,7,11,.636,98
1928,WAS,2021-11-07,101,,MIL,W 101-94,240,41,81,.506,30,54,.556,11,27,.407,8,13,.615,101,37,94,.394,27,58,.466,10,36,.278,10,18,.556,94
1929,TOR,2021-11-05,101,,CLE,L 101-102,240,42,99,.424,30,72,.417,12,27,.444,5,9,.556,101,38,83,.458,28,53,.528,10,30,.333,16,19,.842,102
1930,PHO,2021-10-30,101,,CLE,W 101-92,240,39,84,.464,33,58,.569,6,26,.231,17,27,.630,101,36,91,.396,22,47,.468,14,44,.318,6,7,.857,92
1931,CLE,2021-10-29,101,@,LAL,L 101-113,240,37,87,.425,25,53,.472,12,34,.353,15,22,.682,101,46,84,.548,34,57,.596,12,27,.444,9,10,.900,113
1932,GSW,2021-10-28,101,,MEM,L 101-104 (OT),265,39,90,.433,25,50,.500,14,40,.350,9,12,.750,101,39,97,.402,27,49,.551,12,48,.250,14,14,1.000,104
1933,CLE,2021-10-23,101,,ATL,W 101-95,240,37,89,.416,30,61,.492,7,28,.250,20,27,.741,101,38,99,.384,28,65,.431,10,34,.294,9,15,.600,95
1934,SAC,2021-10-22,101,,UTA,L 101-110,240,39,99,.394,31,63,.492,8,36,.222,15,21,.714,101,37,90,.411,21,48,.438,16,42,.381,20,23,.870,110
1935,GSW,2022-04-09,100,@,SAS,W 100-94,240,33,81,.407,25,49,.510,8,32,.250,26,33,.788,100,32,80,.400,22,49,.449,10,31,.323,20,27,.741,94
1936,NOP,2022-04-03,100,@,LAC,L 100-119,240,35,87,.402,26,63,.413,9,24,.375,21,27,.778,100,45,95,.474,24,51,.471,21,44,.477,8,10,.800,119
1937,SAC,2022-03-28,100,@,MIA,L 100-123,240,37,81,.457,25,46,.543,12,35,.343,14,18,.778,100,49,90,.544,30,50,.600,19,40,.475,6,6,1.000,123
1938,UTA,2022-03-27,100,@,DAL,L 100-114,240,41,89,.461,29,55,.527,12,34,.353,6,10,.600,100,40,77,.519,23,43,.535,17,34,.500,17,24,.708,114
1939,WAS,2022-03-25,100,@,DET,W 100-97,240,36,83,.434,27,53,.509,9,30,.300,19,21,.905,100,39,95,.411,33,63,.524,6,32,.188,13,14,.929,97
1940,NYK,2022-03-18,100,,WAS,W 100-97,240,31,90,.344,21,57,.368,10,33,.303,28,36,.778,100,34,79,.430,21,45,.467,13,34,.382,16,21,.762,97
1941,LAC,2022-03-16,100,,TOR,L 100-103,240,38,78,.487,27,48,.563,11,30,.367,13,15,.867,100,38,83,.458,27,51,.529,11,32,.344,16,21,.762,103
1942,HOU,2022-03-11,100,,DAL,L 100-113,240,41,86,.477,35,56,.625,6,30,.200,12,19,.632,100,40,88,.455,29,52,.558,11,36,.306,22,28,.786,113
1943,PHI,2022-03-10,100,,BRK,L 100-129,240,30,93,.323,16,57,.281,14,36,.389,26,30,.867,100,51,91,.560,33,51,.647,18,40,.450,9,17,.529,129
1944,SAC,2022-03-09,100,,DEN,L 100-106,240,38,85,.447,26,51,.510,12,34,.353,12,18,.667,100,40,82,.488,31,47,.660,9,35,.257,17,19,.895,106
1945,HOU,2022-03-01,100,,LAC,L 100-113,240,38,96,.396,25,57,.439,13,39,.333,11,17,.647,100,42,96,.438,29,65,.446,13,31,.419,16,17,.941,113
1946,TOR,2022-02-26,100,@,ATL,L 100-127,240,38,95,.400,28,63,.444,10,32,.313,14,19,.737,100,48,83,.578,35,52,.673,13,31,.419,18,22,.818,127
1947,NYK,2022-02-25,100,,MIA,L 100-115,240,30,75,.400,16,35,.457,14,40,.350,26,36,.722,100,39,83,.470,28,51,.549,11,32,.344,26,35,.743,115
1948,PHI,2022-02-11,100,,OKC,W 100-87,240,36,93,.387,29,67,.433,7,26,.269,21,26,.808,100,35,90,.389,29,55,.527,6,35,.171,11,12,.917,87
1949,WAS,2022-02-07,100,,MIA,L 100-121,240,36,80,.450,29,49,.592,7,31,.226,21,23,.913,100,43,76,.566,25,44,.568,18,32,.563,17,21,.810,121
1950,ATL,2022-01-31,100,,TOR,L 100-106,240,37,81,.457,25,49,.510,12,32,.375,14,16,.875,100,38,89,.427,20,53,.377,18,36,.500,12,17,.706,106
1951,MIL,2022-01-30,100,,DEN,L 100-136,240,37,78,.474,27,48,.563,10,30,.333,16,22,.727,100,53,88,.602,30,45,.667,23,43,.535,7,10,.700,136
1952,IND,2022-01-12,100,,BOS,L 100-119,240,40,86,.465,33,50,.660,7,36,.194,13,20,.650,100,40,78,.513,22,40,.550,18,38,.474,21,25,.840,119
1953,ORL,2022-01-09,100,,WAS,L 100-102,240,38,95,.400,29,67,.433,9,28,.321,15,16,.938,100,36,88,.409,25,59,.424,11,29,.379,19,24,.792,102
1954,PHO,2022-01-08,100,,MIA,L 100-123,240,30,79,.380,16,45,.356,14,34,.412,26,29,.897,100,44,88,.500,22,44,.500,22,44,.500,13,15,.867,123
1955,SAS,2022-01-07,100,@,PHI,L 100-119,240,38,92,.413,29,62,.468,9,30,.300,15,20,.750,100,45,87,.517,37,64,.578,8,23,.348,21,27,.778,119
1956,LAC,2021-12-26,100,,DEN,L 100-103,240,40,86,.465,32,60,.533,8,26,.308,12,18,.667,100,39,95,.411,24,54,.444,15,41,.366,10,11,.909,103
1957,MEM,2021-12-19,100,,POR,L 100-105,240,35,91,.385,26,57,.456,9,34,.265,21,25,.840,100,35,74,.473,24,42,.571,11,32,.344,24,28,.857,105
1958,DET,2021-12-19,100,,MIA,W 100-90,240,35,75,.467,27,43,.628,8,32,.250,22,30,.733,100,28,74,.378,15,31,.484,13,43,.302,21,33,.636,90
1959,GSW,2021-12-18,100,@,TOR,L 100-119,240,37,79,.468,26,43,.605,11,36,.306,15,21,.714,100,45,90,.500,31,52,.596,14,38,.368,15,23,.652,119
1960,ORL,2021-12-18,100,@,BRK,W 100-93,240,39,94,.415,29,63,.460,10,31,.323,12,13,.923,100,39,102,.382,30,56,.536,9,46,.196,6,8,.750,93
1961,IND,2021-12-13,100,,GSW,L 100-102,240,35,87,.402,28,57,.491,7,30,.233,23,31,.742,100,42,84,.500,34,54,.630,8,30,.267,10,14,.714,102
1962,MIN,2021-11-29,100,,IND,W 100-98,240,36,82,.439,27,47,.574,9,35,.257,19,26,.731,100,36,91,.396,27,54,.500,9,37,.243,17,21,.810,98
1963,IND,2021-11-28,100,,MIL,L 100-118,240,38,92,.413,26,47,.553,12,45,.267,12,16,.750,100,46,90,.511,38,55,.691,8,35,.229,18,22,.818,118
1964,MEM,2021-11-26,100,,ATL,L 100-132,240,37,91,.407,25,53,.472,12,38,.316,14,19,.737,100,52,89,.584,39,62,.629,13,27,.481,15,21,.714,132
1965,MIA,2021-11-23,100,@,DET,W 100-92,240,35,76,.461,26,47,.553,9,29,.310,21,29,.724,100,35,84,.417,25,46,.543,10,38,.263,12,14,.857,92
1966,LAL,2021-11-23,100,@,NYK,L 100-106,240,34,91,.374,23,55,.418,11,36,.306,21,30,.700,100,37,82,.451,22,48,.458,15,34,.441,17,21,.810,106
1967,DEN,2021-11-23,100,@,POR,L 100-119,240,38,78,.487,23,45,.511,15,33,.455,9,11,.818,100,45,88,.511,30,49,.612,15,39,.385,14,20,.700,119
1968,MIA,2021-11-20,100,@,WAS,L 100-103,240,38,81,.469,31,54,.574,7,27,.259,17,20,.850,100,36,74,.486,25,44,.568,11,30,.367,20,23,.870,103
1969,NOP,2021-11-15,100,@,WAS,L 100-105,240,30,74,.405,19,53,.358,11,21,.524,29,34,.853,100,39,84,.464,29,56,.518,10,28,.357,17,25,.680,105
1970,CHI,2021-11-14,100,@,LAC,W 100-90,240,38,86,.442,27,57,.474,11,29,.379,13,14,.929,100,29,81,.358,18,47,.383,11,34,.324,21,21,1.000,90
1971,MIL,2021-11-14,100,@,ATL,L 100-120,240,38,84,.452,24,43,.558,14,41,.341,10,16,.625,100,47,97,.485,32,62,.516,15,35,.429,11,13,.846,120
1972,UTA,2021-11-11,100,,IND,L 100-111,240,39,83,.470,30,51,.588,9,32,.281,13,23,.565,100,43,96,.448,32,65,.492,11,31,.355,14,19,.737,111
1973,NYK,2021-11-10,100,,MIL,L 100-112,240,36,83,.434,20,46,.435,16,37,.432,12,17,.706,100,40,90,.444,14,40,.350,26,50,.520,6,9,.667,112
1974,NOP,2021-11-10,100,,OKC,L 100-108,240,34,97,.351,25,62,.403,9,35,.257,23,32,.719,100,37,87,.425,27,53,.509,10,34,.294,24,30,.800,108
1975,UTA,2021-11-07,100,@,ORL,L 100-107,240,34,89,.382,26,47,.553,8,42,.190,24,29,.828,100,43,87,.494,31,55,.564,12,32,.375,9,11,.818,107
1976,WAS,2021-11-03,100,,TOR,L 100-109,240,34,78,.436,26,46,.565,8,32,.250,24,30,.800,100,41,88,.466,31,63,.492,10,25,.400,17,20,.850,109
1977,NOP,2021-11-02,100,@,PHO,L 100-112,240,36,91,.396,23,52,.442,13,39,.333,15,16,.938,100,43,82,.524,34,56,.607,9,26,.346,17,18,.944,112
1978,IND,2021-10-27,100,@,TOR,L 100-118,240,38,79,.481,28,50,.560,10,29,.345,14,17,.824,100,46,100,.460,32,70,.457,14,30,.467,12,19,.632,118
1979,TOR,2022-03-21,99,@,CHI,L 99-113,240,40,91,.440,34,59,.576,6,32,.188,13,15,.867,99,44,90,.489,33,62,.532,11,28,.393,14,24,.583,113
1980,ORL,2022-03-08,99,,PHO,L 99-102,240,35,92,.380,28,53,.528,7,39,.179,22,25,.880,99,35,92,.380,22,55,.400,13,37,.351,19,23,.826,102
1981,MIA,2022-03-05,99,,PHI,W 99-82,240,35,72,.486,22,44,.500,13,28,.464,16,19,.842,99,28,82,.341,21,41,.512,7,41,.171,19,23,.826,82
1982,CHI,2022-02-28,99,@,MIA,L 99-112,240,41,84,.488,34,55,.618,7,29,.241,10,15,.667,99,40,81,.494,28,50,.560,12,31,.387,20,26,.769,112
1983,LAC,2022-02-27,99,@,HOU,W 99-98,240,34,77,.442,23,43,.535,11,34,.324,20,28,.714,99,35,92,.380,18,50,.360,17,42,.405,11,18,.611,98
1984,MIA,2022-02-15,99,,DAL,L 99-107,240,35,84,.417,28,57,.491,7,27,.259,22,27,.815,99,34,76,.447,16,35,.457,18,41,.439,21,33,.636,107
1985,LAC,2022-02-12,99,@,DAL,W 99-97,240,43,82,.524,36,60,.600,7,22,.318,6,11,.545,99,35,85,.412,20,46,.435,15,39,.385,12,19,.632,97
1986,ORL,2022-02-11,99,@,UTA,L 99-114,240,37,84,.440,24,49,.490,13,35,.371,12,16,.750,99,40,89,.449,27,48,.563,13,41,.317,21,24,.875,114
1987,LAL,2022-02-02,99,,POR,W 99-94,240,33,78,.423,22,48,.458,11,30,.367,22,33,.667,99,35,98,.357,21,56,.375,14,42,.333,10,19,.526,94
1988,MIL,2022-01-26,99,@,CLE,L 99-115,240,37,80,.463,28,48,.583,9,32,.281,16,18,.889,99,41,87,.471,22,45,.489,19,42,.452,14,17,.824,115
1989,TOR,2022-01-17,99,@,MIA,L 99-104,240,37,90,.411,24,54,.444,13,36,.361,12,17,.706,99,38,83,.458,29,59,.492,9,24,.375,19,22,.864,104
1990,GSW,2022-01-16,99,@,MIN,L 99-119,240,32,82,.390,19,40,.475,13,42,.310,22,29,.759,99,45,91,.495,29,48,.604,16,43,.372,13,20,.650,119
1991,BOS,2022-01-14,99,@,PHI,L 99-111,240,37,78,.474,26,47,.553,11,31,.355,14,18,.778,99,38,85,.447,24,44,.545,14,41,.341,21,25,.840,111
1992,GSW,2022-01-13,99,@,MIL,L 99-118,240,33,95,.347,17,47,.362,16,48,.333,17,24,.708,99,44,86,.512,26,45,.578,18,41,.439,12,18,.667,118
1993,PHO,2022-01-11,99,@,TOR,W 99-95,240,35,74,.473,24,42,.571,11,32,.344,18,22,.818,99,36,89,.404,28,52,.538,8,37,.216,15,25,.600,95
1994,MIL,2022-01-10,99,@,CHO,L 99-103,240,37,84,.440,24,41,.585,13,43,.302,12,16,.750,99,38,96,.396,25,52,.481,13,44,.295,14,16,.875,103
1995,CHI,2022-01-09,99,@,DAL,L 99-113,240,39,90,.433,28,57,.491,11,33,.333,10,13,.769,99,44,88,.500,28,52,.538,16,36,.444,9,9,1.000,113
1996,DEN,2022-01-09,99,@,OKC,W 99-95,240,37,89,.416,24,53,.453,13,36,.361,12,16,.750,99,38,88,.432,29,50,.580,9,38,.237,10,12,.833,95
1997,BOS,2022-01-08,99,,NYK,W 99-75,240,36,76,.474,24,47,.511,12,29,.414,15,17,.882,99,29,79,.367,18,48,.375,11,31,.355,6,15,.400,75
1998,DAL,2022-01-05,99,,GSW,W 99-82,240,33,87,.379,21,47,.447,12,40,.300,21,26,.808,99,33,81,.407,28,53,.528,5,28,.179,11,16,.688,82
1999,SAS,2022-01-05,99,@,BOS,W 99-97,240,42,88,.477,32,62,.516,10,26,.385,5,5,1.000,99,40,90,.444,31,62,.500,9,28,.321,8,9,.889,97
2000,CHO,2022-01-02,99,,PHO,L 99-133,240,39,85,.459,30,50,.600,9,35,.257,12,21,.571,99,52,103,.505,35,62,.565,17,41,.415,12,12,1.000,133
2001,LAL,2021-12-29,99,@,MEM,L 99-104,240,39,86,.453,24,45,.533,15,41,.366,6,8,.750,99,35,85,.412,25,55,.455,10,30,.333,24,29,.828,104
2002,HOU,2021-12-27,99,@,CHO,L 99-123,240,36,87,.414,21,41,.512,15,46,.326,12,18,.667,99,47,88,.534,29,47,.617,18,41,.439,11,14,.786,123
2003,TOR,2021-12-26,99,@,CLE,L 99-144,240,37,89,.416,28,53,.528,9,36,.250,16,23,.696,99,56,106,.528,34,54,.630,22,52,.423,10,12,.833,144
2004,MEM,2021-12-20,99,,OKC,L 99-102,240,39,101,.386,28,69,.406,11,32,.344,10,13,.769,99,36,84,.429,25,46,.543,11,38,.289,19,28,.679,102
2005,ORL,2021-12-15,99,,ATL,L 99-111,240,35,90,.389,25,55,.455,10,35,.286,19,21,.905,99,42,85,.494,31,54,.574,11,31,.355,16,16,1.000,111
2006,IND,2021-12-15,99,@,MIL,L 99-114,240,39,83,.470,28,45,.622,11,38,.289,10,11,.909,99,44,90,.489,30,61,.492,14,29,.483,12,15,.800,114
2007,DAL,2021-12-07,99,,BRK,L 99-102,240,36,90,.400,27,44,.614,9,46,.196,18,22,.818,99,42,83,.506,34,57,.596,8,26,.308,10,13,.769,102
2008,LAC,2021-12-04,99,@,SAC,L 99-104,240,34,89,.382,21,55,.382,13,34,.382,18,27,.667,99,36,86,.419,24,52,.462,12,34,.353,20,25,.800,104
2009,NYK,2021-12-04,99,,DEN,L 99-113,240,35,88,.398,23,48,.479,12,40,.300,17,21,.810,99,44,84,.524,24,41,.585,20,43,.465,5,5,1.000,113
2010,WAS,2021-11-29,99,@,SAS,L 99-116,240,41,92,.446,32,61,.525,9,31,.290,8,13,.615,99,49,92,.533,41,74,.554,8,18,.444,10,16,.625,116
2011,NYK,2021-11-27,99,@,ATL,W 99-90,240,36,82,.439,25,53,.472,11,29,.379,16,22,.727,99,33,93,.355,24,56,.429,9,37,.243,15,20,.750,90
2012,OKC,2021-11-26,99,,WAS,L 99-101,240,38,94,.404,27,61,.443,11,33,.333,12,14,.857,99,38,79,.481,28,50,.560,10,29,.345,15,15,1.000,101
2013,ORL,2021-11-24,99,,CHO,L 99-106,240,38,93,.409,23,51,.451,15,42,.357,8,10,.800,99,39,93,.419,27,53,.509,12,40,.300,16,21,.762,106
2014,HOU,2021-11-20,99,@,NYK,L 99-106,240,38,84,.452,28,45,.622,10,39,.256,13,22,.591,99,33,78,.423,15,37,.405,18,41,.439,22,26,.846,106
2015,BOS,2021-11-17,99,@,ATL,L 99-110,240,37,84,.440,26,43,.605,11,41,.268,14,17,.824,99,41,81,.506,28,44,.636,13,37,.351,15,18,.833,110
2016,CLE,2021-11-17,99,@,BRK,L 99-109,240,35,89,.393,24,45,.533,11,44,.250,18,21,.857,99,38,83,.458,26,51,.510,12,32,.375,21,25,.840,109
2017,BRK,2021-11-16,99,,GSW,L 99-117,240,34,88,.386,24,52,.462,10,36,.278,21,27,.778,99,41,79,.519,28,39,.718,13,40,.325,22,28,.786,117
2018,PHO,2021-11-15,99,@,MIN,W 99-96,240,32,85,.376,25,54,.463,7,31,.226,28,36,.778,99,31,85,.365,18,41,.439,13,44,.295,21,27,.778,96
2019,OKC,2021-11-07,99,,SAS,W 99-94,240,35,94,.372,23,52,.442,12,42,.286,17,20,.850,99,41,100,.410,35,70,.500,6,30,.200,6,9,.667,94
2020,NOP,2021-11-03,99,@,SAC,L 99-112,240,37,86,.430,25,52,.481,12,34,.353,13,15,.867,99,42,80,.525,32,50,.640,10,30,.333,18,22,.818,112
2021,LAC,2021-11-01,99,,OKC,W 99-94,240,35,92,.380,20,50,.400,15,42,.357,14,19,.737,99,35,90,.389,24,53,.453,11,37,.297,13,16,.813,94
2022,SAC,2021-10-31,99,@,DAL,L 99-105,240,38,96,.396,31,60,.517,7,36,.194,16,20,.800,99,40,90,.444,28,53,.528,12,37,.324,13,20,.650,105
2023,UTA,2021-10-30,99,@,CHI,L 99-107,240,35,92,.380,24,54,.444,11,38,.289,18,19,.947,99,39,91,.429,34,70,.486,5,21,.238,24,30,.800,107
2024,CHO,2021-10-29,99,@,MIA,L 99-114,240,35,90,.389,22,53,.415,13,37,.351,16,22,.727,99,43,91,.473,34,56,.607,9,35,.257,19,19,1.000,114
2025,SAS,2021-10-28,99,@,DAL,L 99-104,240,39,88,.443,27,58,.466,12,30,.400,9,15,.600,99,41,89,.461,23,44,.523,18,45,.400,4,13,.308,104
2026,NOP,2021-10-27,99,,ATL,L 99-102,240,40,93,.430,29,57,.509,11,36,.306,8,9,.889,99,40,96,.417,32,66,.485,8,30,.267,14,17,.824,102
2027,PHI,2021-10-26,99,@,NYK,L 99-112,240,36,82,.439,24,41,.585,12,41,.293,15,17,.882,99,41,87,.471,25,50,.500,16,37,.432,14,15,.933,112
2028,CLE,2021-10-25,99,@,DEN,W 99-87,240,38,82,.463,31,57,.544,7,25,.280,16,20,.800,99,35,86,.407,26,48,.542,9,38,.237,8,12,.667,87
2029,SAC,2022-04-09,98,@,LAC,L 98-117,240,38,86,.442,31,58,.534,7,28,.250,15,24,.625,98,42,86,.488,21,43,.488,21,43,.488,12,15,.800,117
2030,NYK,2022-04-06,98,,BRK,L 98-110,240,32,83,.386,19,45,.422,13,38,.342,21,36,.583,98,41,93,.441,27,52,.519,14,41,.341,14,18,.778,110
2031,OKC,2022-04-05,98,,POR,W 98-94,240,39,81,.481,30,52,.577,9,29,.310,11,22,.500,98,35,83,.422,24,51,.471,11,32,.344,13,16,.813,94
2032,BOS,2022-03-30,98,,MIA,L 98-106,240,35,85,.412,24,48,.500,11,37,.297,17,23,.739,98,38,79,.481,25,45,.556,13,34,.382,17,25,.680,106
2033,CHI,2022-03-26,98,@,CLE,W 98-94,240,36,75,.480,31,54,.574,5,21,.238,21,25,.840,98,34,82,.415,27,51,.529,7,31,.226,19,27,.704,94
2034,POR,2022-03-26,98,,HOU,L 98-115,240,37,93,.398,25,53,.472,12,40,.300,12,17,.706,98,44,84,.524,29,49,.592,15,35,.429,12,18,.667,115
2035,CHI,2022-03-22,98,@,MIL,L 98-126,240,39,92,.424,26,59,.441,13,33,.394,7,13,.538,98,50,82,.610,38,54,.704,12,28,.429,14,20,.700,126
2036,HOU,2022-03-20,98,,MEM,L 98-122,240,37,86,.430,27,55,.491,10,31,.323,14,24,.583,98,46,96,.479,30,62,.484,16,34,.471,14,17,.824,122
2037,POR,2022-03-20,98,@,IND,L 98-129,240,38,81,.469,29,48,.604,9,33,.273,13,18,.722,98,48,84,.571,33,49,.673,15,35,.429,18,21,.857,129
2038,POR,2022-03-16,98,@,NYK,L 98-128,240,40,91,.440,29,57,.509,11,34,.324,7,14,.500,98,40,80,.500,24,42,.571,16,38,.421,32,39,.821,128
2039,DET,2022-03-15,98,@,MIA,L 98-105,240,37,80,.463,27,46,.587,10,34,.294,14,22,.636,98,29,72,.403,17,39,.436,12,33,.364,35,39,.897,105
2040,CLE,2022-03-02,98,,CHO,L 98-119,240,37,79,.468,27,48,.563,10,31,.323,14,21,.667,98,43,85,.506,26,47,.553,17,38,.447,16,22,.727,119
2041,ATL,2022-03-01,98,@,BOS,L 98-107,240,36,83,.434,29,52,.558,7,31,.226,19,24,.792,98,39,83,.470,28,48,.583,11,35,.314,18,19,.947,107
2042,HOU,2022-02-27,98,,LAC,L 98-99,240,35,92,.380,18,50,.360,17,42,.405,11,18,.611,98,34,77,.442,23,43,.535,11,34,.324,20,28,.714,99
2043,OKC,2022-02-09,98,,TOR,L 98-117,240,36,87,.414,22,40,.550,14,47,.298,12,14,.857,98,45,88,.511,32,53,.604,13,35,.371,14,14,1.000,117
2044,OKC,2022-02-07,98,,GSW,L 98-110,240,37,90,.411,26,54,.481,11,36,.306,13,17,.765,98,41,82,.500,26,39,.667,15,43,.349,13,17,.765,110
2045,CLE,2022-02-06,98,,IND,W 98-85,240,34,84,.405,23,52,.442,11,32,.344,19,28,.679,98,31,83,.373,23,52,.442,8,31,.258,15,17,.882,85
2046,PHI,2022-02-04,98,@,DAL,L 98-107,240,36,70,.514,27,43,.628,9,27,.333,17,23,.739,98,39,85,.459,29,51,.569,10,34,.294,19,23,.826,107
2047,WAS,2022-02-01,98,@,MIL,L 98-112,240,36,82,.439,24,47,.511,12,35,.343,14,20,.700,98,46,92,.500,34,54,.630,12,38,.316,8,9,.889,112
2048,OKC,2022-01-31,98,,POR,W 98-81,240,35,86,.407,23,45,.511,12,41,.293,16,17,.941,98,34,81,.420,27,43,.628,7,38,.184,6,8,.750,81
2049,OKC,2022-01-21,98,@,CHO,L 98-121,240,37,98,.378,25,54,.463,12,44,.273,12,15,.800,98,45,99,.455,28,50,.560,17,49,.347,14,20,.700,121
2050,TOR,2022-01-19,98,@,DAL,L 98-102,240,35,91,.385,27,59,.458,8,32,.250,20,25,.800,98,37,76,.487,28,43,.651,9,33,.273,19,20,.950,102
2051,POR,2022-01-17,98,@,ORL,W 98-88,240,37,90,.411,30,56,.536,7,34,.206,17,18,.944,98,34,90,.378,26,58,.448,8,32,.250,12,20,.600,88
2052,PHI,2022-01-17,98,@,WAS,L 98-117,240,35,86,.407,28,60,.467,7,26,.269,21,25,.840,98,42,87,.483,33,57,.579,9,30,.300,24,32,.750,117
2053,MIA,2022-01-15,98,,PHI,L 98-109,240,33,86,.384,24,51,.471,9,35,.257,23,30,.767,98,40,79,.506,27,47,.574,13,32,.406,16,21,.762,109
2054,PHI,2022-01-12,98,,CHO,L 98-109,240,34,73,.466,22,43,.512,12,30,.400,18,28,.643,98,46,89,.517,36,55,.655,10,34,.294,7,8,.875,109
2055,IND,2022-01-10,98,@,BOS,L 98-101 (OT),265,36,94,.383,25,57,.439,11,37,.297,15,17,.882,98,35,88,.398,27,60,.450,8,28,.286,23,28,.821,101
2056,MIN,2022-01-05,98,,OKC,W 98-90,240,36,90,.400,24,46,.522,12,44,.273,14,20,.700,98,33,90,.367,24,55,.436,9,35,.257,15,18,.833,90
2057,ORL,2022-01-03,98,@,CHI,L 98-102,240,36,85,.424,26,58,.448,10,27,.370,16,18,.889,98,37,86,.430,26,55,.473,11,31,.355,17,23,.739,102
2058,ATL,2021-12-23,98,@,PHI,W 98-96,240,37,82,.451,30,58,.517,7,24,.292,17,19,.895,98,33,80,.413,27,53,.509,6,27,.222,24,26,.923,96
2059,ATL,2021-12-22,98,,ORL,L 98-104,240,32,80,.400,20,49,.408,12,31,.387,22,29,.759,98,38,85,.447,27,48,.563,11,37,.297,17,23,.739,104
2060,SAC,2021-12-20,98,@,GSW,L 98-113,240,37,83,.446,24,51,.471,13,32,.406,11,16,.688,98,46,88,.523,31,51,.608,15,37,.405,6,9,.667,113
2061,WAS,2021-12-16,98,@,PHO,L 98-118,240,40,82,.488,34,61,.557,6,21,.286,12,19,.632,98,42,79,.532,33,50,.660,9,29,.310,25,26,.962,118
2062,WAS,2021-12-11,98,,UTA,L 98-123,240,41,89,.461,33,64,.516,8,25,.320,8,14,.571,98,48,93,.516,35,54,.648,13,39,.333,14,17,.824,123
2063,PHI,2021-12-03,98,@,ATL,W 98-96,240,38,81,.469,29,59,.492,9,22,.409,13,17,.765,98,31,76,.408,21,48,.438,10,28,.357,24,30,.800,96
2064,MEM,2021-11-30,98,@,TOR,W 98-91,240,36,93,.387,26,59,.441,10,34,.294,16,19,.842,98,36,91,.396,26,52,.500,10,39,.256,9,12,.750,91
2065,IND,2021-11-29,98,@,MIN,L 98-100,240,36,91,.396,27,54,.500,9,37,.243,17,21,.810,98,36,82,.439,27,47,.574,9,35,.257,19,26,.731,100
2066,NOP,2021-11-26,98,@,UTA,W 98-97,240,38,89,.427,27,62,.435,11,27,.407,11,13,.846,98,36,80,.450,23,47,.489,13,33,.394,12,18,.667,97
2067,NOP,2021-11-17,98,@,MIA,L 98-113,240,33,75,.440,23,40,.575,10,35,.286,22,28,.786,98,42,87,.483,27,47,.574,15,40,.375,14,17,.824,113
2068,NYK,2021-11-17,98,,ORL,L 98-104,240,37,88,.420,21,39,.538,16,49,.327,8,12,.667,98,39,96,.406,28,58,.483,11,38,.289,15,18,.833,104
2069,DAL,2021-11-17,98,@,PHO,L 98-105,240,38,91,.418,22,59,.373,16,32,.500,6,6,1.000,98,41,93,.441,28,54,.519,13,39,.333,10,14,.714,105
2070,BOS,2021-11-15,98,@,CLE,W 98-92,240,36,78,.462,26,49,.531,10,29,.345,16,20,.800,98,32,83,.386,16,43,.372,16,40,.400,12,16,.750,92
2071,CLE,2021-11-12,98,,DET,W 98-78,240,39,82,.476,25,41,.610,14,41,.341,6,9,.667,98,29,79,.367,20,49,.408,9,30,.300,11,13,.846,78
2072,IND,2021-11-10,98,@,DEN,L 98-101,240,40,84,.476,29,53,.547,11,31,.355,7,11,.636,98,36,84,.429,24,54,.444,12,30,.400,17,20,.850,101
2073,ATL,2021-11-09,98,@,UTA,L 98-110,240,37,85,.435,19,50,.380,18,35,.514,6,10,.600,98,41,81,.506,26,43,.605,15,38,.395,13,16,.813,110
2074,MIL,2021-11-05,98,,NYK,L 98-113,240,33,82,.402,17,39,.436,16,43,.372,16,21,.762,98,41,96,.427,31,56,.554,10,40,.250,21,26,.808,113
2075,ATL,2021-11-04,98,,UTA,L 98-116,240,35,82,.427,28,54,.519,7,28,.250,21,26,.808,98,41,81,.506,24,40,.600,17,41,.415,17,23,.739,116
2076,DET,2021-11-04,98,,PHI,L 98-109,240,35,87,.402,24,51,.471,11,36,.306,17,19,.895,98,41,83,.494,29,51,.569,12,32,.375,15,22,.682,109
2077,CHI,2021-11-03,98,@,PHI,L 98-103,240,38,82,.463,32,61,.525,6,21,.286,16,18,.889,98,38,77,.494,26,49,.531,12,28,.429,15,21,.714,103
2078,NYK,2021-11-03,98,@,IND,L 98-111,240,36,87,.414,31,63,.492,5,24,.208,21,27,.778,98,42,91,.462,26,50,.520,16,41,.390,11,14,.786,111
2079,IND,2021-10-29,98,@,BRK,L 98-105,240,37,93,.398,29,64,.453,8,29,.276,16,23,.696,98,34,76,.447,28,50,.560,6,26,.231,31,41,.756,105
2080,OKC,2021-10-26,98,,GSW,L 98-106,240,36,86,.419,24,52,.462,12,34,.353,14,17,.824,98,39,83,.470,25,43,.581,14,40,.350,14,18,.778,106
2081,MIN,2021-10-25,98,,NOP,L 98-107,240,31,90,.344,16,40,.400,15,50,.300,21,27,.778,98,39,87,.448,29,57,.509,10,30,.333,19,23,.826,107
2082,PHO,2021-10-20,98,,DEN,L 98-110,240,36,87,.414,22,50,.440,14,37,.378,12,17,.706,98,44,83,.530,27,44,.614,17,39,.436,5,9,.556,110
2083,WAS,2021-10-20,98,@,TOR,W 98-83,240,36,81,.444,31,54,.574,5,27,.185,21,26,.808,98,30,97,.309,23,63,.365,7,34,.206,16,22,.727,83
2084,DEN,2022-04-05,97,,SAS,L 97-116,240,41,98,.418,34,65,.523,7,33,.212,8,12,.667,97,44,89,.494,32,63,.508,12,26,.462,16,24,.667,116
2085,DET,2022-03-25,97,,WAS,L 97-100,240,39,95,.411,33,63,.524,6,32,.188,13,14,.929,97,36,83,.434,27,53,.509,9,30,.300,19,21,.905,100
2086,LAC,2022-03-25,97,,PHI,L 97-122,240,34,85,.400,26,60,.433,8,25,.320,21,25,.840,97,43,92,.467,28,57,.491,15,35,.429,21,24,.875,122
2087,UTA,2022-03-23,97,@,BOS,L 97-125,240,35,88,.398,27,52,.519,8,36,.222,19,21,.905,97,50,84,.595,31,48,.646,19,36,.528,6,7,.857,125
2088,WAS,2022-03-21,97,@,HOU,L 97-115,240,35,85,.412,29,56,.518,6,29,.207,21,24,.875,97,42,85,.494,22,46,.478,20,39,.513,11,13,.846,115
2089,SAC,2022-03-18,97,,BOS,L 97-126,240,33,79,.418,20,43,.465,13,36,.361,18,24,.750,97,46,82,.561,24,42,.571,22,40,.550,12,17,.706,126
2090,WAS,2022-03-18,97,@,NYK,L 97-100,240,34,79,.430,21,45,.467,13,34,.382,16,21,.762,97,31,90,.344,21,57,.368,10,33,.303,28,36,.778,100
2091,LAC,2022-03-08,97,@,GSW,L 97-112,240,33,93,.355,21,54,.389,12,39,.308,19,23,.826,97,44,92,.478,31,58,.534,13,34,.382,11,13,.846,112
2092,TOR,2022-03-04,97,,ORL,L 97-103,240,37,93,.398,25,56,.446,12,37,.324,11,17,.647,97,36,95,.379,25,58,.431,11,37,.297,20,21,.952,103
2093,BRK,2022-02-28,97,,TOR,L 97-133,240,33,86,.384,21,51,.412,12,35,.343,19,24,.792,97,51,99,.515,33,61,.541,18,38,.474,13,22,.591,133
2094,DAL,2022-02-12,97,,LAC,L 97-99,240,35,85,.412,20,46,.435,15,39,.385,12,19,.632,97,43,82,.524,36,60,.600,7,22,.318,6,11,.545,99
2095,NOP,2022-02-10,97,,MIA,L 97-112,240,36,85,.424,25,44,.568,11,41,.268,14,16,.875,97,39,81,.481,29,49,.592,10,32,.313,24,28,.857,112
2096,HOU,2022-02-08,97,@,NOP,L 97-110,240,32,86,.372,19,44,.432,13,42,.310,20,31,.645,97,42,80,.525,34,48,.708,8,32,.250,18,20,.900,110
2097,NOP,2022-01-29,97,,BOS,L 97-107,240,36,82,.439,28,50,.560,8,32,.250,17,23,.739,97,43,81,.531,29,40,.725,14,41,.341,7,11,.636,107
2098,UTA,2022-01-26,97,,PHO,L 97-105,240,34,79,.430,22,49,.449,12,30,.400,17,23,.739,97,40,82,.488,33,64,.516,7,18,.389,18,27,.667,105
2099,CHO,2022-01-17,97,@,NYK,W 97-87,240,36,86,.419,22,47,.468,14,39,.359,11,17,.647,97,32,80,.400,20,46,.435,12,34,.353,11,21,.524,87
2100,DET,2022-01-08,97,,ORL,W 97-92,240,38,87,.437,28,54,.519,10,33,.303,11,16,.688,97,29,86,.337,15,40,.375,14,46,.304,20,23,.870,92
2101,BOS,2022-01-05,97,,SAS,L 97-99,240,40,90,.444,31,62,.500,9,28,.321,8,9,.889,97,42,88,.477,32,62,.516,10,26,.385,5,5,1.000,99
2102,OKC,2021-12-29,97,@,PHO,L 97-115,240,38,96,.396,31,61,.508,7,35,.200,14,16,.875,97,41,89,.461,29,55,.527,12,34,.353,21,28,.750,115
2103,POR,2021-12-21,97,@,NOP,L 97-111,240,35,78,.449,22,44,.500,13,34,.382,14,19,.737,97,42,80,.525,30,47,.638,12,33,.364,15,18,.833,111
2104,NOP,2021-12-12,97,@,SAS,L 97-112,240,40,94,.426,32,65,.492,8,29,.276,9,15,.600,97,45,91,.495,38,66,.576,7,25,.280,15,20,.750,112
2105,NYK,2021-12-12,97,,MIL,L 97-112,240,35,82,.427,18,33,.545,17,49,.347,10,13,.769,97,42,88,.477,28,47,.596,14,41,.341,14,17,.824,112
2106,DEN,2021-12-06,97,@,CHI,L 97-109,240,38,96,.396,27,64,.422,11,32,.344,10,15,.667,97,41,91,.451,28,56,.500,13,35,.371,14,20,.700,109
2107,MEM,2021-12-04,97,@,DAL,W 97-90,240,37,76,.487,28,50,.560,9,26,.346,14,24,.583,97,31,92,.337,16,49,.327,15,43,.349,13,19,.684,90
2108,TOR,2021-12-02,97,,MIL,W 97-93,240,37,88,.420,23,48,.479,14,40,.350,9,14,.643,97,32,85,.376,21,54,.389,11,31,.355,18,25,.720,93
2109,TOR,2021-11-28,97,,BOS,L 97-109,240,35,93,.376,22,51,.431,13,42,.310,14,16,.875,97,34,82,.415,22,48,.458,12,34,.353,29,31,.935,109
2110,TOR,2021-11-26,97,@,IND,L 97-114,240,37,89,.416,30,59,.508,7,30,.233,16,22,.727,97,47,97,.485,36,58,.621,11,39,.282,9,11,.818,114
2111,UTA,2021-11-26,97,,NOP,L 97-98,240,36,80,.450,23,47,.489,13,33,.394,12,18,.667,97,38,89,.427,27,62,.435,11,27,.407,11,13,.846,98
2112,NYK,2021-11-26,97,,PHO,L 97-118,240,34,92,.370,22,53,.415,12,39,.308,17,22,.773,97,44,79,.557,31,51,.608,13,28,.464,17,21,.810,118
2113,DEN,2021-11-21,97,@,PHO,L 97-126,240,33,90,.367,22,52,.423,11,38,.289,20,28,.714,97,46,87,.529,35,51,.686,11,36,.306,23,26,.885,126
2114,LAC,2021-11-21,97,,DAL,W 97-91,240,36,75,.480,24,46,.522,12,29,.414,13,18,.722,97,34,83,.410,28,53,.528,6,30,.200,17,18,.944,91
2115,WAS,2021-11-18,97,@,MIA,L 97-112,240,38,77,.494,23,41,.561,15,36,.417,6,10,.600,97,41,82,.500,31,56,.554,10,26,.385,20,24,.833,112
2116,SAC,2021-11-17,97,@,MIN,L 97-107,240,34,93,.366,24,55,.436,10,38,.263,19,25,.760,97,41,82,.500,31,46,.674,10,36,.278,15,18,.833,107
2117,CHO,2021-11-17,97,,WAS,W 97-87,240,42,96,.438,32,64,.500,10,32,.313,3,6,.500,97,33,90,.367,25,48,.521,8,42,.190,13,16,.813,87
2118,DET,2021-11-17,97,,IND,W 97-89,240,34,80,.425,26,52,.500,8,28,.286,21,28,.750,97,33,79,.418,24,42,.571,9,37,.243,14,19,.737,89
2119,WAS,2021-11-10,97,@,CLE,W 97-94,240,35,84,.417,25,56,.446,10,28,.357,17,17,1.000,97,35,76,.461,26,45,.578,9,31,.290,15,21,.714,94
2120,DEN,2021-11-01,97,@,MEM,L 97-106,240,39,88,.443,30,50,.600,9,38,.237,10,15,.667,97,44,97,.454,31,63,.492,13,34,.382,5,7,.714,106
2121,MIN,2021-11-01,97,,ORL,L 97-115,240,36,97,.371,22,46,.478,14,51,.275,11,19,.579,97,37,82,.451,20,39,.513,17,43,.395,24,30,.800,115
2122,TOR,2021-10-30,97,@,IND,W 97-94,240,39,92,.424,28,60,.467,11,32,.344,8,12,.667,97,35,81,.432,22,38,.579,13,43,.302,11,16,.688,94
2123,HOU,2021-10-24,97,,BOS,L 97-107,240,32,75,.427,18,43,.419,14,32,.438,19,24,.792,97,38,86,.442,23,39,.590,15,47,.319,16,20,.800,107
2124,CHI,2021-10-23,97,,DET,W 97-82,240,35,84,.417,24,58,.414,11,26,.423,16,19,.842,97,34,88,.386,29,60,.483,5,28,.179,9,15,.600,82
2125,NOP,2021-10-20,97,,PHI,L 97-117,240,39,93,.419,26,63,.413,13,30,.433,6,9,.667,97,44,85,.518,31,60,.517,13,25,.520,16,20,.800,117
2126,ORL,2021-10-20,97,@,SAS,L 97-123,240,35,86,.407,26,57,.456,9,29,.310,18,23,.783,97,49,98,.500,36,68,.529,13,30,.433,12,18,.667,123
2127,PHO,2022-04-03,96,@,OKC,L 96-117,240,37,89,.416,30,51,.588,7,38,.184,15,17,.882,96,43,87,.494,26,46,.565,17,41,.415,14,18,.778,117
2128,POR,2022-03-23,96,,SAS,L 96-133,240,36,94,.383,29,68,.426,7,26,.269,17,18,.944,96,46,94,.489,27,50,.540,19,44,.432,22,24,.917,133
2129,TOR,2022-03-06,96,@,CLE,L 96-104,240,37,94,.394,31,70,.443,6,24,.250,16,26,.615,96,39,85,.459,28,49,.571,11,36,.306,15,23,.652,104
2130,ORL,2022-03-05,96,@,MEM,L 96-124,240,37,86,.430,26,51,.510,11,35,.314,11,16,.688,96,46,92,.500,32,58,.552,14,34,.412,18,27,.667,124
2131,LAC,2022-02-15,96,@,PHO,L 96-103,240,40,97,.412,30,62,.484,10,35,.286,6,9,.667,96,44,90,.489,36,65,.554,8,25,.320,7,10,.700,103
2132,OKC,2022-02-04,96,@,POR,W 96-93,240,33,87,.379,18,45,.400,15,42,.357,15,21,.714,96,40,101,.396,34,68,.500,6,33,.182,7,10,.700,93
2133,SAC,2022-01-31,96,@,NYK,L 96-116,240,37,86,.430,26,48,.542,11,38,.289,11,22,.500,96,40,80,.500,27,45,.600,13,35,.371,23,29,.793,116
2134,NYK,2022-01-26,96,@,MIA,L 96-110,240,35,83,.422,20,39,.513,15,44,.341,11,17,.647,96,37,74,.500,21,37,.568,16,37,.432,20,22,.909,110
2135,BRK,2022-01-25,96,,LAL,L 96-106,240,37,88,.420,30,61,.492,7,27,.259,15,22,.682,96,42,89,.472,30,51,.588,12,38,.316,10,10,1.000,106
2136,OKC,2022-01-19,96,@,SAS,L 96-118,240,38,98,.388,30,67,.448,8,31,.258,12,15,.800,96,47,96,.490,32,56,.571,15,40,.375,9,14,.643,118
2137,LAL,2022-01-15,96,@,DEN,L 96-133,240,36,82,.439,26,52,.500,10,30,.333,14,19,.737,96,47,91,.516,24,51,.471,23,40,.575,16,17,.941,133
2138,MIL,2022-01-15,96,,TOR,L 96-103,240,26,77,.338,14,38,.368,12,39,.308,32,35,.914,96,40,91,.440,28,56,.500,12,35,.343,11,20,.550,103
2139,CHI,2022-01-14,96,,GSW,L 96-138,240,37,87,.425,27,49,.551,10,38,.263,12,18,.667,96,53,94,.564,34,52,.654,19,42,.452,13,17,.765,138
2140,SAS,2022-01-10,96,@,NYK,L 96-111,240,39,95,.411,31,66,.470,8,29,.276,10,15,.667,96,40,82,.488,27,50,.540,13,32,.406,18,24,.750,111
2141,GSW,2022-01-09,96,,CLE,W 96-82,240,39,97,.402,29,55,.527,10,42,.238,8,10,.800,96,32,75,.427,25,51,.490,7,24,.292,11,18,.611,82
2142,GSW,2022-01-06,96,@,NOP,L 96-101,240,37,87,.425,30,54,.556,7,33,.212,15,18,.833,96,35,83,.422,27,49,.551,8,34,.235,23,29,.793,101
2143,SAC,2021-12-31,96,,DAL,L 96-112,240,38,91,.418,28,62,.452,10,29,.345,10,12,.833,96,42,81,.519,33,59,.559,9,22,.409,19,22,.864,112
2144,NYK,2021-12-28,96,@,MIN,W 96-88,240,37,90,.411,21,50,.420,16,40,.400,6,16,.375,96,34,85,.400,27,47,.574,7,38,.184,13,20,.650,88
2145,WAS,2021-12-26,96,,PHI,L 96-117,240,35,90,.389,27,57,.474,8,33,.242,18,28,.643,96,43,86,.500,31,55,.564,12,31,.387,19,22,.864,117
2146,PHI,2021-12-23,96,,ATL,L 96-98,240,33,80,.413,27,53,.509,6,27,.222,24,26,.923,96,37,82,.451,30,58,.517,7,24,.292,17,19,.895,98
2147,IND,2021-12-21,96,@,MIA,L 96-125,240,31,87,.356,20,56,.357,11,31,.355,23,28,.821,96,47,95,.495,25,46,.543,22,49,.449,9,11,.818,125
2148,PHI,2021-12-15,96,,MIA,L 96-101,240,35,79,.443,23,42,.548,12,37,.324,14,17,.824,96,35,78,.449,17,34,.500,18,44,.409,13,17,.765,101
2149,NYK,2021-12-14,96,,GSW,L 96-105,240,30,83,.361,14,41,.341,16,42,.381,20,22,.909,96,35,77,.455,20,37,.541,15,40,.375,20,27,.741,105
2150,CHO,2021-12-13,96,@,DAL,L 96-120,240,34,86,.395,21,49,.429,13,37,.351,15,24,.625,96,43,83,.518,24,42,.571,19,41,.463,15,17,.882,120
2151,PHI,2021-12-09,96,,UTA,L 96-118,240,38,88,.432,32,55,.582,6,33,.182,14,15,.933,96,43,91,.473,28,51,.549,15,40,.375,17,24,.708,118
2152,MEM,2021-12-08,96,,DAL,L 96-104,240,36,90,.400,27,59,.458,9,31,.290,15,25,.600,96,37,77,.481,25,44,.568,12,33,.364,18,23,.783,104
2153,PHO,2021-12-03,96,@,GSW,L 96-118,240,31,81,.383,23,59,.390,8,22,.364,26,35,.743,96,45,92,.489,26,53,.491,19,39,.487,9,12,.750,118
2154,ATL,2021-12-03,96,,PHI,L 96-98,240,31,76,.408,21,48,.438,10,28,.357,24,30,.800,96,38,81,.469,29,59,.492,9,22,.409,13,17,.765,98
2155,GSW,2021-11-30,96,@,PHO,L 96-104,240,36,86,.419,22,46,.478,14,40,.350,10,14,.714,96,43,87,.494,31,57,.544,12,30,.400,6,11,.545,104
2156,DAL,2021-11-29,96,,CLE,L 96-114,240,39,89,.438,27,50,.540,12,39,.308,6,15,.400,96,45,80,.563,35,61,.574,10,19,.526,14,18,.778,114
2157,ORL,2021-11-29,96,@,PHI,L 96-101,240,37,90,.411,29,57,.509,8,33,.242,14,18,.778,96,39,97,.402,29,64,.453,10,33,.303,13,18,.722,101
2158,DET,2021-11-26,96,@,LAC,L 96-107,240,33,90,.367,25,57,.439,8,33,.242,22,26,.846,96,39,91,.429,28,53,.528,11,38,.289,18,19,.947,107
2159,SAS,2021-11-26,96,,BOS,W 96-88,240,38,87,.437,32,63,.508,6,24,.250,14,19,.737,96,34,92,.370,24,58,.414,10,34,.294,10,15,.667,88
2160,PHI,2021-11-24,96,@,GSW,L 96-116,240,34,80,.425,26,52,.500,8,28,.286,20,22,.909,96,42,80,.525,27,42,.643,15,38,.395,17,24,.708,116
2161,NOP,2021-11-22,96,,MIN,L 96-110,240,37,88,.420,31,56,.554,6,32,.188,16,18,.889,96,40,100,.400,30,56,.536,10,44,.227,20,28,.714,110
2162,MIL,2021-11-19,96,,OKC,W 96-89,240,31,83,.373,19,42,.452,12,41,.293,22,26,.846,96,32,91,.352,20,43,.465,12,48,.250,13,21,.619,89
2163,MIN,2021-11-15,96,,PHO,L 96-99,240,31,85,.365,18,41,.439,13,44,.295,21,27,.778,96,32,85,.376,25,54,.463,7,31,.226,28,36,.778,99
2164,OKC,2021-11-14,96,,BRK,L 96-120,240,36,90,.400,22,45,.489,14,45,.311,10,11,.909,96,41,82,.500,23,39,.590,18,43,.419,20,21,.952,120
2165,NYK,2021-11-12,96,@,CHO,L 96-104,240,36,93,.387,23,58,.397,13,35,.371,11,18,.611,96,39,90,.433,29,54,.537,10,36,.278,16,24,.667,104
2166,ATL,2021-11-12,96,@,DEN,L 96-105,240,38,93,.409,33,65,.508,5,28,.179,15,21,.714,96,40,90,.444,30,55,.545,10,35,.286,15,20,.750,105
2167,MIA,2021-11-08,96,@,DEN,L 96-113,240,31,78,.397,18,42,.429,13,36,.361,21,25,.840,96,42,91,.462,30,50,.600,12,41,.293,17,24,.708,113
2168,PHI,2021-11-08,96,,NYK,L 96-103,240,35,91,.385,22,51,.431,13,40,.325,13,16,.813,96,40,91,.440,27,51,.529,13,40,.325,10,13,.769,103
2169,BRK,2021-11-05,96,@,DET,W 96-90,240,36,80,.450,25,53,.472,11,27,.407,13,14,.929,96,33,87,.379,22,53,.415,11,34,.324,13,18,.722,90
2170,MEM,2021-10-27,96,@,POR,L 96-116,240,35,96,.365,18,46,.391,17,50,.340,9,19,.474,96,39,84,.464,24,48,.500,15,36,.417,23,31,.742,116
2171,MIN,2021-10-23,96,,NOP,W 96-89,240,39,96,.406,27,58,.466,12,38,.316,6,10,.600,96,31,89,.348,22,49,.449,9,40,.225,18,23,.783,89
2172,ORL,2021-10-22,96,,NYK,L 96-121,240,33,83,.398,16,40,.400,17,43,.395,13,15,.867,96,44,88,.500,20,34,.588,24,54,.444,9,17,.529,121
2173,SAS,2021-10-22,96,@,DEN,L 96-102,240,40,84,.476,34,60,.567,6,24,.250,10,14,.714,96,44,86,.512,35,56,.625,9,30,.300,5,8,.625,102
2174,GSW,2022-03-28,95,@,MEM,L 95-123,240,33,81,.407,24,52,.462,9,29,.310,20,26,.769,95,43,92,.467,31,62,.500,12,30,.400,25,35,.714,123
2175,MIA,2022-03-26,95,,BRK,L 95-110,240,33,75,.440,23,41,.561,10,34,.294,19,26,.731,95,39,83,.470,28,50,.560,11,33,.333,21,26,.808,110
2176,DAL,2022-03-25,95,@,MIN,L 95-116,240,35,90,.389,25,47,.532,10,43,.233,15,19,.789,95,43,84,.512,32,52,.615,11,32,.344,19,24,.792,116
2177,DAL,2022-03-13,95,@,BOS,W 95-92,240,33,74,.446,18,37,.486,15,37,.405,14,19,.737,95,33,88,.375,24,51,.471,9,37,.243,17,19,.895,92
2178,SAC,2022-03-02,95,@,NOP,L 95-125,240,35,89,.393,27,54,.500,8,35,.229,17,25,.680,95,52,88,.591,41,59,.695,11,29,.379,10,12,.833,125
2179,LAL,2022-02-27,95,,NOP,L 95-123,240,35,84,.417,28,50,.560,7,34,.206,18,20,.900,95,47,92,.511,34,62,.548,13,30,.433,16,25,.640,123
2180,POR,2022-02-24,95,,GSW,L 95-132,240,31,79,.392,22,44,.500,9,35,.257,24,29,.828,95,45,88,.511,30,47,.638,15,41,.366,27,32,.844,132
2181,ATL,2022-02-13,95,@,BOS,L 95-105,240,34,93,.366,22,55,.400,12,38,.316,15,15,1.000,95,36,85,.424,25,47,.532,11,38,.289,22,27,.815,105
2182,POR,2022-02-08,95,,ORL,L 95-113,240,32,91,.352,21,53,.396,11,38,.289,20,26,.769,95,44,90,.489,25,52,.481,19,38,.500,6,8,.750,113
2183,PHO,2022-02-05,95,@,WAS,W 95-80,240,40,99,.404,32,68,.471,8,31,.258,7,14,.500,95,30,85,.353,25,61,.410,5,24,.208,15,19,.789,80
2184,SAS,2022-02-03,95,,MIA,L 95-112,240,30,80,.375,22,47,.468,8,33,.242,27,38,.711,95,42,83,.506,30,53,.566,12,30,.400,16,18,.889,112
2185,WAS,2022-01-29,95,@,MEM,L 95-115,240,35,84,.417,25,55,.455,10,29,.345,15,21,.714,95,46,100,.460,33,69,.478,13,31,.419,10,12,.833,115
2186,CLE,2022-01-24,95,,NYK,W 95-93,240,35,81,.432,22,45,.489,13,36,.361,12,20,.600,95,35,84,.417,23,46,.500,12,38,.316,11,21,.524,93
2187,CHI,2022-01-23,95,@,ORL,L 95-114,240,33,76,.434,28,55,.509,5,21,.238,24,32,.750,95,42,80,.525,30,54,.556,12,26,.462,18,23,.783,114
2188,UTA,2022-01-17,95,@,LAL,L 95-101,240,31,83,.373,19,37,.514,12,46,.261,21,24,.875,95,38,86,.442,27,49,.551,11,37,.297,14,23,.609,101
2189,TOR,2022-01-11,95,,PHO,L 95-99,240,36,89,.404,28,52,.538,8,37,.216,15,25,.600,95,35,74,.473,24,42,.571,11,32,.344,18,22,.818,99
2190,OKC,2022-01-09,95,,DEN,L 95-99,240,38,88,.432,29,50,.580,9,38,.237,10,12,.833,95,37,89,.416,24,53,.453,13,36,.361,12,16,.750,99
2191,DAL,2022-01-02,95,@,OKC,W 95-86,240,38,85,.447,24,46,.522,14,39,.359,5,7,.714,95,35,85,.412,25,55,.455,10,30,.333,6,9,.667,86
2192,OKC,2021-12-31,95,,NYK,W 95-80,240,36,87,.414,18,44,.409,18,43,.419,5,7,.714,95,30,81,.370,22,40,.550,8,41,.195,12,22,.545,80
2193,SAC,2021-12-29,95,,DAL,W 95-94,240,36,75,.480,26,49,.531,10,26,.385,13,15,.867,95,38,81,.469,29,57,.509,9,24,.375,9,13,.692,94
2194,DAL,2021-12-23,95,,MIL,L 95-102,240,35,86,.407,23,41,.561,12,45,.267,13,17,.765,95,37,82,.451,27,46,.587,10,36,.278,18,22,.818,102
2195,PHO,2021-12-13,95,@,LAC,L 95-111,240,36,96,.375,29,67,.433,7,29,.241,16,19,.842,95,43,78,.551,34,57,.596,9,21,.429,16,23,.696,111
2196,OKC,2021-12-10,95,,LAL,L 95-116,240,38,96,.396,28,52,.538,10,44,.227,9,14,.643,95,41,87,.471,22,45,.489,19,42,.452,15,20,.750,116
2197,LAL,2021-12-09,95,@,MEM,L 95-108,240,36,78,.462,24,48,.500,12,30,.400,11,17,.647,95,41,94,.436,27,52,.519,14,42,.333,12,18,.667,108
2198,ORL,2021-12-06,95,@,GSW,L 95-126,240,33,76,.434,22,38,.579,11,38,.289,18,22,.818,95,43,87,.494,23,47,.489,20,40,.500,20,29,.690,126
2199,MEM,2021-11-20,95,@,MIN,L 95-138,240,29,83,.349,20,51,.392,9,32,.281,28,35,.800,95,49,91,.538,29,50,.580,20,41,.488,20,28,.714,138
2200,POR,2021-11-14,95,@,DEN,L 95-124,240,35,80,.438,22,41,.537,13,39,.333,12,13,.923,95,47,90,.522,28,50,.560,19,40,.475,11,14,.786,124
2201,BRK,2021-11-08,95,@,CHI,L 95-118,240,34,86,.395,23,53,.434,11,33,.333,16,19,.842,95,46,98,.469,37,67,.552,9,31,.290,17,20,.850,118
2202,DEN,2021-11-06,95,,HOU,W 95-94,240,36,89,.404,27,49,.551,9,40,.225,14,17,.824,95,35,75,.467,27,47,.574,8,28,.286,16,24,.667,94
2203,BOS,2021-11-04,95,@,MIA,W 95-78,240,31,78,.397,15,37,.405,16,41,.390,17,20,.850,95,28,81,.346,19,40,.475,9,41,.220,13,19,.684,78
2204,MIL,2021-10-31,95,,UTA,L 95-107,240,39,96,.406,27,55,.491,12,41,.293,5,6,.833,95,35,75,.467,23,38,.605,12,37,.324,25,27,.926,107
2205,LAL,2021-10-31,95,,HOU,W 95-85,240,39,96,.406,30,65,.462,9,31,.290,8,13,.615,95,32,76,.421,26,48,.542,6,28,.214,15,29,.517,85
2206,BRK,2021-10-24,95,,CHO,L 95-111,240,38,87,.437,29,52,.558,9,35,.257,10,12,.833,95,43,94,.457,33,64,.516,10,30,.333,15,19,.789,111
2207,TOR,2021-10-23,95,,DAL,L 95-103,240,34,85,.400,23,48,.479,11,37,.297,16,23,.696,95,38,91,.418,24,49,.490,14,42,.333,13,18,.722,103
2208,ATL,2021-10-23,95,@,CLE,L 95-101,240,38,99,.384,28,65,.431,10,34,.294,9,15,.600,95,37,89,.416,30,61,.492,7,28,.250,20,27,.741,101
2209,MIL,2021-10-21,95,@,MIA,L 95-137,240,32,84,.381,20,42,.476,12,42,.286,19,29,.655,95,51,96,.531,36,61,.590,15,35,.429,20,31,.645,137
2210,TOR,2022-04-10,94,@,NYK,L 94-105,240,36,92,.391,24,50,.480,12,42,.286,10,11,.909,94,40,87,.460,25,44,.568,15,43,.349,10,12,.833,105
2211,SAS,2022-04-09,94,,GSW,L 94-100,240,32,80,.400,22,49,.449,10,31,.323,20,27,.741,94,33,81,.407,25,49,.510,8,32,.250,26,33,.788,100
2212,POR,2022-04-07,94,@,NOP,L 94-127,240,36,69,.522,25,38,.658,11,31,.355,11,13,.846,94,44,93,.473,31,56,.554,13,37,.351,26,31,.839,127
2213,CHI,2022-04-06,94,,BOS,L 94-117,240,35,80,.438,28,57,.491,7,23,.304,17,23,.739,94,43,88,.489,26,51,.510,17,37,.459,14,22,.636,117
2214,POR,2022-04-05,94,@,OKC,L 94-98,240,35,83,.422,24,51,.471,11,32,.344,13,16,.813,94,39,81,.481,30,52,.577,9,29,.310,11,22,.500,98
2215,PHI,2022-03-31,94,@,DET,L 94-102,240,31,69,.449,24,43,.558,7,26,.269,25,28,.893,94,41,82,.500,31,47,.660,10,35,.286,10,15,.667,102
2216,WAS,2022-03-29,94,,CHI,L 94-107,240,38,79,.481,32,53,.604,6,26,.231,12,17,.706,94,43,85,.506,37,67,.552,6,18,.333,15,18,.833,107
2217,CLE,2022-03-26,94,,CHI,L 94-98,240,34,82,.415,27,51,.529,7,31,.226,19,27,.704,94,36,75,.480,31,54,.574,5,21,.238,21,25,.840,98
2218,ORL,2022-03-22,94,,GSW,W 94-90,240,34,79,.430,24,43,.558,10,36,.278,16,20,.800,94,34,85,.400,23,53,.434,11,32,.344,11,16,.688,90
2219,DET,2022-02-14,94,@,WAS,L 94-103,240,32,85,.376,24,62,.387,8,23,.348,22,27,.815,94,40,85,.471,31,56,.554,9,29,.310,14,18,.778,103
2220,ATL,2022-02-06,94,@,DAL,L 94-103,240,37,95,.389,32,70,.457,5,25,.200,15,16,.938,94,38,88,.432,22,52,.423,16,36,.444,11,13,.846,103
2221,POR,2022-02-02,94,@,LAL,L 94-99,240,35,98,.357,21,56,.375,14,42,.333,10,19,.526,94,33,78,.423,22,48,.458,11,30,.367,22,33,.667,99
2222,GSW,2022-01-23,94,,UTA,W 94-92,240,36,83,.434,23,41,.561,13,42,.310,9,10,.900,94,31,81,.383,20,46,.435,11,35,.314,19,23,.826,92
2223,CLE,2022-01-22,94,,OKC,W 94-87,240,35,76,.461,29,49,.592,6,27,.222,18,35,.514,94,33,85,.388,21,44,.477,12,41,.293,9,16,.563,87
2224,MIL,2022-01-21,94,,CHI,W 94-90,240,34,88,.386,28,57,.491,6,31,.194,20,28,.714,94,31,85,.365,24,47,.511,7,38,.184,21,24,.875,90
2225,LAC,2022-01-15,94,@,SAS,L 94-101,240,38,100,.380,26,62,.419,12,38,.316,6,8,.750,94,34,83,.410,23,46,.500,11,37,.297,22,27,.815,101
2226,IND,2022-01-14,94,,PHO,L 94-112,240,34,88,.386,21,45,.467,13,43,.302,13,18,.722,94,40,88,.455,29,60,.483,11,28,.393,21,23,.913,112
2227,IND,2022-01-04,94,@,NYK,L 94-104,240,32,76,.421,23,38,.605,9,38,.237,21,32,.656,94,39,80,.488,33,52,.635,6,28,.214,20,28,.714,104
2228,DAL,2021-12-29,94,@,SAC,L 94-95,240,38,81,.469,29,57,.509,9,24,.375,9,13,.692,94,36,75,.480,26,49,.531,10,26,.385,13,15,.867,95
2229,NYK,2021-12-29,94,@,DET,W 94-85,240,31,81,.383,23,50,.460,8,31,.258,24,27,.889,94,30,81,.370,18,46,.391,12,35,.343,13,17,.765,85
2230,DEN,2021-12-22,94,@,OKC,L 94-108,240,33,84,.393,20,40,.500,13,44,.295,15,26,.577,94,42,94,.447,34,60,.567,8,34,.235,16,19,.842,108
2231,MIA,2021-12-13,94,@,CLE,L 94-105,240,38,85,.447,25,45,.556,13,40,.325,5,9,.556,94,36,81,.444,20,45,.444,16,36,.444,17,18,.944,105
2232,ORL,2021-12-12,94,@,LAL,L 94-106,240,33,88,.375,20,50,.400,13,38,.342,15,19,.789,94,41,84,.488,28,56,.500,13,28,.464,11,17,.647,106
2233,POR,2021-12-08,94,@,GSW,L 94-104,240,33,80,.413,25,50,.500,8,30,.267,20,28,.714,94,33,83,.398,19,37,.514,14,46,.304,24,31,.774,104
2234,SAC,2021-11-22,94,,PHI,L 94-102,240,33,80,.413,26,49,.531,7,31,.226,21,29,.724,94,36,85,.424,27,53,.509,9,32,.281,21,27,.778,102
2235,NOP,2021-11-20,94,@,IND,L 94-111,240,35,88,.398,29,70,.414,6,18,.333,18,19,.947,94,42,91,.462,28,53,.528,14,38,.368,13,18,.722,111
2236,NOP,2021-11-19,94,,LAC,W 94-81,240,38,87,.437,25,57,.439,13,30,.433,5,8,.625,94,34,90,.378,25,53,.472,9,37,.243,4,5,.800,81
2237,MEM,2021-11-12,94,,PHO,L 94-119,240,37,98,.378,30,65,.462,7,33,.212,13,23,.565,94,46,94,.489,28,57,.491,18,37,.486,9,9,1.000,119
2238,CLE,2021-11-10,94,,WAS,L 94-97,240,35,76,.461,26,45,.578,9,31,.290,15,21,.714,94,35,84,.417,25,56,.446,10,28,.357,17,17,1.000,97
2239,MIL,2021-11-07,94,@,WAS,L 94-101,240,37,94,.394,27,58,.466,10,36,.278,10,18,.556,94,41,81,.506,30,54,.556,11,27,.407,8,13,.615,101
2240,SAS,2021-11-07,94,@,OKC,L 94-99,240,41,100,.410,35,70,.500,6,30,.200,6,9,.667,94,35,94,.372,23,52,.442,12,42,.286,17,20,.850,99
2241,IND,2021-11-07,94,@,SAC,W 94-91,240,37,83,.446,31,58,.534,6,25,.240,14,18,.778,94,31,84,.369,21,50,.420,10,34,.294,19,22,.864,91
2242,HOU,2021-11-06,94,@,DEN,L 94-95,240,35,75,.467,27,47,.574,8,28,.286,16,24,.667,94,36,89,.404,27,49,.551,9,40,.225,14,17,.824,95
2243,OKC,2021-11-01,94,@,LAC,L 94-99,240,35,90,.389,24,53,.453,11,37,.297,13,16,.813,94,35,92,.380,20,50,.400,15,42,.357,14,19,.737,99
2244,ATL,2021-10-30,94,@,PHI,L 94-122,240,36,95,.379,28,73,.384,8,22,.364,14,19,.737,94,46,86,.535,34,48,.708,12,38,.316,18,19,.947,122
2245,IND,2021-10-30,94,,TOR,L 94-97,240,35,81,.432,22,38,.579,13,43,.302,11,16,.688,94,39,92,.424,28,60,.467,11,32,.344,8,12,.667,97
2246,CHI,2021-10-20,94,@,DET,W 94-88,240,37,86,.430,30,63,.476,7,23,.304,13,15,.867,94,36,90,.400,30,62,.484,6,28,.214,10,13,.769,88
2247,TOR,2022-03-20,93,@,PHI,W 93-88,240,35,93,.376,28,67,.418,7,26,.269,16,23,.696,93,30,73,.411,23,46,.500,7,27,.259,21,28,.750,88
2248,NYK,2022-03-20,93,,UTA,L 93-108,240,31,83,.373,15,43,.349,16,40,.400,15,21,.714,93,34,74,.459,17,28,.607,17,46,.370,23,29,.793,108
2249,LAC,2022-03-06,93,,NYK,L 93-116,240,33,88,.375,22,54,.407,11,34,.324,16,22,.727,93,42,89,.472,29,60,.483,13,29,.448,19,30,.633,116
2250,TOR,2022-02-25,93,@,CHO,L 93-125,240,37,84,.440,31,61,.508,6,23,.261,13,23,.565,93,52,94,.553,37,54,.685,15,40,.375,6,9,.667,125
2251,CLE,2022-02-12,93,@,PHI,L 93-103,240,36,77,.468,28,53,.528,8,24,.333,13,15,.867,93,38,79,.481,28,57,.491,10,22,.455,17,21,.810,103
2252,POR,2022-02-04,93,,OKC,L 93-96,240,40,101,.396,34,68,.500,6,33,.182,7,10,.700,93,33,87,.379,18,45,.400,15,42,.357,15,21,.714,96
2253,DET,2022-02-04,93,,BOS,L 93-102,240,34,104,.327,24,78,.308,10,26,.385,15,20,.750,93,37,82,.451,28,54,.519,9,28,.321,19,25,.760,102
2254,CLE,2022-01-31,93,,NOP,W 93-90,240,36,84,.429,27,53,.509,9,31,.290,12,14,.857,93,33,85,.388,27,55,.491,6,30,.200,18,21,.857,90
2255,NYK,2022-01-24,93,@,CLE,L 93-95,240,35,84,.417,23,46,.500,12,38,.316,11,21,.524,93,35,81,.432,22,45,.489,13,36,.361,12,20,.600,95
2256,ATL,2022-01-09,93,@,LAC,L 93-106,240,35,78,.449,28,52,.538,7,26,.269,16,19,.842,93,44,92,.478,32,59,.542,12,33,.364,6,7,.857,106
2257,CLE,2021-12-30,93,@,WAS,L 93-110,240,35,83,.422,27,55,.491,8,28,.286,15,23,.652,93,45,90,.500,36,61,.590,9,29,.310,11,17,.647,110
2258,MIA,2021-12-26,93,,ORL,W 93-83,240,36,89,.404,26,55,.473,10,34,.294,11,18,.611,93,31,72,.431,21,40,.525,10,32,.313,11,17,.647,83
2259,BRK,2021-12-18,93,,ORL,L 93-100,240,39,102,.382,30,56,.536,9,46,.196,6,8,.750,93,39,94,.415,29,63,.460,10,31,.323,12,13,.923,100
2260,GSW,2021-12-11,93,@,PHI,L 93-102,240,34,85,.400,22,37,.595,12,48,.250,13,18,.722,93,35,76,.461,26,49,.531,9,27,.333,23,26,.885,102
2261,DAL,2021-12-10,93,@,IND,L 93-106,240,39,84,.464,35,55,.636,4,29,.138,11,12,.917,93,41,87,.471,28,51,.549,13,36,.361,11,12,.917,106
2262,DET,2021-12-10,93,@,NOP,L 93-109,240,35,90,.389,23,53,.434,12,37,.324,11,12,.917,93,41,95,.432,28,58,.483,13,37,.351,14,16,.875,109
2263,MIL,2021-12-02,93,@,TOR,L 93-97,240,32,85,.376,21,54,.389,11,31,.355,18,25,.720,93,37,88,.420,23,48,.479,14,40,.350,9,14,.643,97
2264,DET,2021-11-24,93,@,MIL,L 93-114,240,34,95,.358,23,50,.460,11,45,.244,14,19,.737,93,42,87,.483,27,51,.529,15,36,.417,15,17,.882,114
2265,CHI,2021-11-12,93,@,GSW,L 93-119,240,34,78,.436,26,51,.510,8,27,.296,17,22,.773,93,45,93,.484,30,47,.638,15,46,.326,14,16,.875,119
2266,DEN,2021-10-30,93,@,MIN,W 93-91,240,36,88,.409,27,51,.529,9,37,.243,12,16,.750,93,35,89,.393,22,48,.458,13,41,.317,8,9,.889,91
2267,MIL,2021-10-30,93,,SAS,L 93-102,240,36,89,.404,26,50,.520,10,39,.256,11,16,.688,93,39,95,.411,32,64,.500,7,31,.226,17,24,.708,102
2268,BRK,2021-10-27,93,,MIA,L 93-106,240,33,85,.388,19,42,.452,14,43,.326,13,14,.929,93,38,96,.396,30,67,.448,8,29,.276,22,26,.846,106
2269,WAS,2022-04-08,92,,NYK,L 92-114,240,35,69,.507,26,41,.634,9,28,.321,13,17,.765,92,41,88,.466,25,49,.510,16,39,.410,16,20,.800,114
2270,POR,2022-04-03,92,@,SAS,L 92-113,240,33,84,.393,17,39,.436,16,45,.356,10,15,.667,92,38,84,.452,24,42,.571,14,42,.333,23,30,.767,113
2271,LAC,2022-03-18,92,@,UTA,L 92-121,240,31,86,.360,20,51,.392,11,35,.314,19,21,.905,92,47,97,.485,31,53,.585,16,44,.364,11,14,.786,121
2272,BOS,2022-03-13,92,,DAL,L 92-95,240,33,88,.375,24,51,.471,9,37,.243,17,19,.895,92,33,74,.446,18,37,.486,15,37,.405,14,19,.737,95
2273,POR,2022-02-27,92,,DEN,L 92-124,240,34,91,.374,28,55,.509,6,36,.167,18,26,.692,92,44,86,.512,32,49,.653,12,37,.324,24,31,.774,124
2274,CLE,2022-02-26,92,,WAS,W 92-86,240,32,83,.386,24,58,.414,8,25,.320,20,24,.833,92,35,81,.432,24,58,.414,11,23,.478,5,6,.833,86
2275,SAS,2022-02-09,92,@,CLE,L 92-105,240,38,99,.384,30,66,.455,8,33,.242,8,11,.727,92,39,82,.476,30,61,.492,9,21,.429,18,24,.750,105
2276,MIA,2022-01-31,92,@,BOS,L 92-122,240,34,87,.391,17,43,.395,17,44,.386,7,10,.700,92,44,84,.524,28,42,.667,16,42,.381,18,27,.667,122
2277,BOS,2022-01-28,92,@,ATL,L 92-108,240,30,86,.349,23,50,.460,7,36,.194,25,27,.926,92,41,89,.461,29,58,.500,12,31,.387,14,20,.700,108
2278,DAL,2022-01-25,92,@,GSW,L 92-130,240,32,91,.352,22,51,.431,10,40,.250,18,18,1.000,92,49,92,.533,32,49,.653,17,43,.395,15,18,.833,130
2279,UTA,2022-01-23,92,@,GSW,L 92-94,240,31,81,.383,20,46,.435,11,35,.314,19,23,.826,92,36,83,.434,23,41,.561,13,42,.310,9,10,.900,94
2280,POR,2022-01-19,92,@,MIA,L 92-104,240,33,81,.407,19,35,.543,14,46,.304,12,16,.750,92,37,80,.463,25,45,.556,12,35,.343,18,25,.720,104
2281,NOP,2022-01-17,92,@,BOS,L 92-104,240,36,87,.414,27,57,.474,9,30,.300,11,18,.611,92,38,80,.475,28,48,.583,10,32,.313,18,20,.900,104
2282,ORL,2022-01-15,92,@,DAL,L 92-108,240,37,77,.481,30,51,.588,7,26,.269,11,16,.688,92,32,78,.410,20,44,.455,12,34,.353,32,38,.842,108
2283,ORL,2022-01-08,92,@,DET,L 92-97,240,29,86,.337,15,40,.375,14,46,.304,20,23,.870,92,38,87,.437,28,54,.519,10,33,.303,11,16,.688,97
2284,LAC,2021-12-20,92,,SAS,L 92-116,240,34,87,.391,25,55,.455,9,32,.281,15,20,.750,92,50,114,.439,38,77,.494,12,37,.324,4,6,.667,116
2285,LAL,2021-12-17,92,@,MIN,L 92-110,240,30,78,.385,18,35,.514,12,43,.279,20,29,.690,92,41,98,.418,29,54,.537,12,44,.273,16,24,.667,110
2286,CHI,2021-12-11,92,@,MIA,L 92-118,240,31,83,.373,14,43,.326,17,40,.425,13,20,.650,92,46,93,.495,27,50,.540,19,43,.442,7,9,.778,118
2287,CHI,2021-12-08,92,@,CLE,L 92-115,240,35,84,.417,28,58,.483,7,26,.269,15,21,.714,92,44,80,.550,31,52,.596,13,28,.464,14,16,.875,115
2288,SAC,2021-11-30,92,,LAL,L 92-117,240,35,79,.443,29,50,.580,6,29,.207,16,22,.727,92,46,92,.500,35,64,.547,11,28,.393,14,20,.700,117
2289,DET,2021-11-30,92,@,POR,L 92-110,240,29,76,.382,20,41,.488,9,35,.257,25,30,.833,92,41,96,.427,27,54,.500,14,42,.333,14,18,.778,110
2290,ORL,2021-11-27,92,@,CLE,L 92-105,240,35,88,.398,27,56,.482,8,32,.250,14,23,.609,92,41,90,.456,27,51,.529,14,39,.359,9,12,.750,105
2291,DET,2021-11-23,92,,MIA,L 92-100,240,35,84,.417,25,46,.543,10,38,.263,12,14,.857,92,35,76,.461,26,47,.553,9,29,.310,21,29,.724,100
2292,ORL,2021-11-22,92,@,MIL,L 92-123,240,34,93,.366,23,52,.442,11,41,.268,13,18,.722,92,44,94,.468,26,49,.531,18,45,.400,17,24,.708,123
2293,SAS,2021-11-16,92,@,LAC,L 92-106,240,41,95,.432,36,73,.493,5,22,.227,5,7,.714,92,37,85,.435,25,47,.532,12,38,.316,20,22,.909,106
2294,CLE,2021-11-15,92,,BOS,L 92-98,240,32,83,.386,16,43,.372,16,40,.400,12,16,.750,92,36,78,.462,26,49,.531,10,29,.345,16,20,.800,98
2295,NYK,2021-11-15,92,,IND,W 92-84,240,37,86,.430,26,52,.500,11,34,.324,7,10,.700,92,32,86,.372,24,49,.490,8,37,.216,12,16,.750,84
2296,ORL,2021-11-13,92,,WAS,L 92-104,240,31,92,.337,18,52,.346,13,40,.325,17,20,.850,92,42,84,.500,30,49,.612,12,35,.343,8,10,.800,104
2297,HOU,2021-11-12,92,,POR,L 92-104,240,34,85,.400,27,53,.509,7,32,.219,17,27,.630,92,34,87,.391,23,51,.451,11,36,.306,25,31,.806,104
2298,NOP,2021-11-08,92,@,DAL,L 92-108,240,37,87,.425,28,53,.528,9,34,.265,9,11,.818,92,43,85,.506,29,50,.580,14,35,.400,8,13,.615,108
2299,BOS,2021-11-03,92,@,ORL,W 92-79,240,33,79,.418,23,42,.548,10,37,.270,16,25,.640,92,27,84,.321,18,41,.439,9,43,.209,16,20,.800,79
2300,CHO,2021-11-03,92,@,GSW,L 92-114,240,34,91,.374,24,55,.436,10,36,.278,14,19,.737,92,42,86,.488,24,41,.585,18,45,.400,12,18,.667,114
2301,CLE,2021-10-30,92,@,PHO,L 92-101,240,36,91,.396,22,47,.468,14,44,.318,6,7,.857,92,39,84,.464,33,58,.569,6,26,.231,17,27,.630,101
2302,LAC,2021-10-29,92,@,POR,L 92-111,240,34,87,.391,19,45,.422,15,42,.357,9,16,.563,92,41,98,.418,22,57,.386,19,41,.463,10,16,.625,111
2303,CLE,2021-10-27,92,@,LAC,W 92-79,240,33,81,.407,30,61,.492,3,20,.150,23,27,.852,92,31,87,.356,22,46,.478,9,41,.220,8,13,.615,79
2304,IND,2022-03-26,91,@,TOR,L 91-131,240,33,79,.418,22,43,.512,11,36,.306,14,20,.700,91,51,84,.607,36,52,.692,15,32,.469,14,19,.737,131
2305,HOU,2022-03-23,91,@,DAL,L 91-110,240,33,82,.402,29,54,.537,4,28,.143,21,28,.750,91,42,86,.488,34,53,.642,8,33,.242,18,22,.818,110
2306,SAS,2022-03-18,91,,NOP,L 91-124,240,32,89,.360,21,45,.467,11,44,.250,16,20,.800,91,48,96,.500,34,62,.548,14,34,.412,14,18,.778,124
2307,CLE,2022-03-12,91,@,CHI,L 91-101,240,36,86,.419,31,62,.500,5,24,.208,14,17,.824,91,39,88,.443,30,67,.448,9,21,.429,14,15,.933,101
2308,MIN,2022-02-16,91,,TOR,L 91-103,240,30,77,.390,20,35,.571,10,42,.238,21,29,.724,91,40,88,.455,32,63,.508,8,25,.320,15,19,.789,103
2309,BRK,2022-02-08,91,,BOS,L 91-126,240,38,99,.384,28,63,.444,10,36,.278,5,13,.385,91,50,91,.549,36,51,.706,14,40,.350,12,16,.750,126
2310,CHO,2022-01-23,91,,ATL,L 91-113,240,34,87,.391,30,51,.588,4,36,.111,19,27,.704,91,40,88,.455,25,49,.510,15,39,.385,18,24,.750,113
2311,MEM,2022-01-23,91,@,DAL,L 91-104,240,37,99,.374,33,75,.440,4,24,.167,13,19,.684,91,36,74,.486,27,44,.614,9,30,.300,23,31,.742,104
2312,NYK,2022-01-20,91,,NOP,L 91-102,240,29,77,.377,20,39,.513,9,38,.237,24,36,.667,91,38,76,.500,27,48,.563,11,28,.393,15,22,.682,102
2313,ATL,2022-01-12,91,,MIA,L 91-115,240,31,82,.378,18,37,.486,13,45,.289,16,23,.696,91,43,90,.478,27,45,.600,16,45,.356,13,14,.929,115
2314,UTA,2022-01-12,91,,CLE,L 91-111,240,34,85,.400,18,38,.474,16,47,.340,7,11,.636,91,43,81,.531,32,51,.627,11,30,.367,14,17,.824,111
2315,HOU,2022-01-10,91,,PHI,L 91-111,240,30,77,.390,17,35,.486,13,42,.310,18,27,.667,91,43,94,.457,33,59,.559,10,35,.286,15,18,.833,111
2316,LAC,2021-12-29,91,@,BOS,W 91-82,240,33,81,.407,22,53,.415,11,28,.393,14,17,.824,91,35,101,.347,31,59,.525,4,42,.095,8,11,.727,82
2317,DET,2021-12-21,91,@,NYK,L 91-105,240,34,94,.362,26,61,.426,8,33,.242,15,19,.789,91,40,90,.444,29,57,.509,11,33,.333,14,19,.737,105
2318,PHI,2021-12-13,91,@,MEM,L 91-126,240,37,83,.446,33,61,.541,4,22,.182,13,19,.684,91,47,89,.528,33,55,.600,14,34,.412,18,23,.783,126
2319,DAL,2021-12-03,91,,NOP,L 91-107,240,32,79,.405,22,45,.489,10,34,.294,17,26,.654,91,37,90,.411,25,60,.417,12,30,.400,21,28,.750,107
2320,TOR,2021-11-30,91,,MEM,L 91-98,240,36,91,.396,26,52,.500,10,39,.256,9,12,.750,91,36,93,.387,26,59,.441,10,34,.294,16,19,.842,98
2321,DAL,2021-11-21,91,@,LAC,L 91-97,240,34,83,.410,28,53,.528,6,30,.200,17,18,.944,91,36,75,.480,24,46,.522,12,29,.414,13,18,.722,97
2322,CLE,2021-11-13,91,,BOS,W 91-89,240,31,81,.383,21,43,.488,10,38,.263,19,22,.864,91,33,78,.423,27,55,.491,6,23,.261,17,18,.944,89
2323,SAC,2021-11-07,91,,IND,L 91-94,240,31,84,.369,21,50,.420,10,34,.294,19,22,.864,91,37,83,.446,31,58,.534,6,25,.240,14,18,.778,94
2324,DET,2021-10-31,91,@,BRK,L 91-117,240,32,79,.405,20,46,.435,12,33,.364,15,22,.682,91,47,72,.653,34,47,.723,13,25,.520,10,16,.625,117
2325,MIN,2021-10-30,91,,DEN,L 91-93,240,35,89,.393,22,48,.458,13,41,.317,8,9,.889,91,36,88,.409,27,51,.529,9,37,.243,12,16,.750,93
2326,HOU,2021-10-28,91,,UTA,L 91-122,240,31,95,.326,22,51,.431,9,44,.205,20,23,.870,91,41,85,.482,25,39,.641,16,46,.348,24,30,.800,122
2327,MIA,2021-10-23,91,@,IND,L 91-102 (OT),265,35,91,.385,26,58,.448,9,33,.273,12,14,.857,91,38,97,.392,28,58,.483,10,39,.256,16,21,.762,102
2328,OKC,2021-10-22,91,@,HOU,L 91-124,240,34,91,.374,20,48,.417,14,43,.326,9,16,.563,91,48,95,.505,31,57,.544,17,38,.447,11,14,.786,124
2329,SAC,2022-04-03,90,,GSW,L 90-109,240,31,81,.383,24,48,.500,7,33,.212,21,24,.875,90,41,79,.519,25,45,.556,16,34,.471,11,15,.733,109
2330,GSW,2022-03-22,90,@,ORL,L 90-94,240,34,85,.400,23,53,.434,11,32,.344,11,16,.688,90,34,79,.430,24,43,.558,10,36,.278,16,20,.800,94
2331,ORL,2022-03-20,90,,OKC,W 90-85,240,32,83,.386,25,52,.481,7,31,.226,19,24,.792,90,30,92,.326,17,44,.386,13,48,.271,12,18,.667,85
2332,MIA,2022-03-09,90,,PHO,L 90-111,240,35,88,.398,25,55,.455,10,33,.303,10,13,.769,90,45,99,.455,34,62,.548,11,37,.297,10,10,1.000,111
2333,UTA,2022-03-04,90,@,NOP,L 90-124,240,31,89,.348,20,48,.417,11,41,.268,17,26,.654,90,50,97,.515,39,61,.639,11,36,.306,13,17,.765,124
2334,POR,2022-03-02,90,@,PHO,L 90-120,240,30,78,.385,19,47,.404,11,31,.355,19,25,.760,90,40,80,.500,26,44,.591,14,36,.389,26,31,.839,120
2335,TOR,2022-02-14,90,@,NOP,L 90-120,240,29,95,.305,21,61,.344,8,34,.235,24,31,.774,90,45,77,.584,29,42,.690,16,35,.457,14,16,.875,120
2336,NOP,2022-01-31,90,@,CLE,L 90-93,240,33,85,.388,27,55,.491,6,30,.200,18,21,.857,90,36,84,.429,27,53,.509,9,31,.290,12,14,.857,93
2337,CHO,2022-01-30,90,,LAC,L 90-115,240,32,98,.327,24,64,.375,8,34,.235,18,27,.667,90,44,84,.524,33,56,.589,11,28,.393,16,19,.842,115
2338,CHI,2022-01-21,90,@,MIL,L 90-94,240,31,85,.365,24,47,.511,7,38,.184,21,24,.875,90,34,88,.386,28,57,.491,6,31,.194,20,28,.714,94
2339,OKC,2022-01-05,90,@,MIN,L 90-98,240,33,90,.367,24,55,.436,9,35,.257,15,18,.833,90,36,90,.400,24,46,.522,12,44,.273,14,20,.700,98
2340,LAL,2021-12-21,90,,PHO,L 90-108,240,34,87,.391,27,52,.519,7,35,.200,15,23,.652,90,41,93,.441,29,52,.558,12,41,.293,14,15,.933,108
2341,MIA,2021-12-19,90,@,DET,L 90-100,240,28,74,.378,15,31,.484,13,43,.302,21,33,.636,90,35,75,.467,27,43,.628,8,32,.250,22,30,.733,100
2342,MIL,2021-12-18,90,,CLE,L 90-119,240,35,89,.393,23,51,.451,12,38,.316,8,11,.727,90,45,90,.500,29,45,.644,16,45,.356,13,14,.929,119
2343,BOS,2021-12-10,90,@,PHO,L 90-111,240,35,93,.376,31,67,.463,4,26,.154,16,24,.667,90,43,96,.448,29,58,.500,14,38,.368,11,11,1.000,111
2344,TOR,2021-12-10,90,,NYK,W 90-87,240,30,87,.345,18,52,.346,12,35,.343,18,23,.783,90,29,81,.358,20,47,.426,9,34,.265,20,24,.833,87
2345,POR,2021-12-06,90,,LAC,L 90-102,240,35,79,.443,30,57,.526,5,22,.227,15,20,.750,90,41,92,.446,30,56,.536,11,36,.306,9,14,.643,102
2346,MIA,2021-12-06,90,,MEM,L 90-105,240,35,76,.461,29,54,.537,6,22,.273,14,17,.824,90,38,89,.427,25,56,.446,13,33,.394,16,21,.762,105
2347,WAS,2021-12-05,90,@,TOR,L 90-102,240,30,73,.411,22,48,.458,8,25,.320,22,29,.759,90,38,85,.447,30,62,.484,8,23,.348,18,24,.750,102
2348,DAL,2021-12-04,90,,MEM,L 90-97,240,31,92,.337,16,49,.327,15,43,.349,13,19,.684,90,37,76,.487,28,50,.560,9,26,.346,14,24,.583,97
2349,LAC,2021-11-28,90,,GSW,L 90-105,240,32,80,.400,23,52,.442,9,28,.321,17,25,.680,90,38,86,.442,21,46,.457,17,40,.425,12,22,.545,105
2350,ATL,2021-11-27,90,,NYK,L 90-99,240,33,93,.355,24,56,.429,9,37,.243,15,20,.750,90,36,82,.439,25,53,.472,11,29,.379,16,22,.727,99
2351,HOU,2021-11-22,90,@,BOS,L 90-108,240,31,83,.373,20,41,.488,11,42,.262,17,24,.708,90,39,92,.424,27,57,.474,12,35,.343,18,19,.947,108
2352,SAS,2021-11-18,90,@,MIN,L 90-115,240,35,84,.417,29,52,.558,6,32,.188,14,19,.737,90,41,86,.477,20,37,.541,21,49,.429,12,15,.800,115
2353,OKC,2021-11-15,90,,MIA,L 90-103,240,34,83,.410,19,42,.452,15,41,.366,7,10,.700,90,37,82,.451,19,42,.452,18,40,.450,11,13,.846,103
2354,LAC,2021-11-14,90,,CHI,L 90-100,240,29,81,.358,18,47,.383,11,34,.324,21,21,1.000,90,38,86,.442,27,57,.474,11,29,.379,13,14,.929,100
2355,ORL,2021-11-10,90,,BRK,L 90-123,240,35,92,.380,31,59,.525,4,33,.121,16,24,.667,90,46,91,.505,30,54,.556,16,37,.432,15,17,.882,123
2356,LAL,2021-11-06,90,@,POR,L 90-105,240,31,90,.344,22,58,.379,9,32,.281,19,24,.792,90,36,95,.379,21,40,.525,15,55,.273,18,24,.750,105
2357,DET,2021-11-05,90,,BRK,L 90-96,240,33,87,.379,22,53,.415,11,34,.324,13,18,.722,90,36,80,.450,25,53,.472,11,27,.407,13,14,.929,96
2358,WAS,2021-10-25,90,@,BRK,L 90-104,240,33,95,.347,24,56,.429,9,39,.231,15,20,.750,90,40,94,.426,30,59,.508,10,35,.286,14,17,.824,104
2359,ORL,2021-10-25,90,@,MIA,L 90-107,240,33,81,.407,21,37,.568,12,44,.273,12,19,.632,90,41,87,.471,35,60,.583,6,27,.222,19,19,1.000,107
2360,ORL,2022-04-01,89,,TOR,L 89-102,240,34,79,.430,23,44,.523,11,35,.314,10,11,.909,89,36,86,.419,23,44,.523,13,42,.310,17,20,.850,102
2361,LAC,2022-01-13,89,@,NOP,L 89-113,240,31,81,.383,21,47,.447,10,34,.294,17,20,.850,89,43,97,.443,29,58,.500,14,39,.359,13,16,.813,113
2362,LAC,2022-01-06,89,@,PHO,L 89-106,240,31,86,.360,25,58,.431,6,28,.214,21,25,.840,89,44,107,.411,34,76,.447,10,31,.323,8,10,.800,106
2363,DEN,2022-01-03,89,@,DAL,L 89-103,240,31,67,.463,25,42,.595,6,25,.240,21,29,.724,89,35,78,.449,21,41,.512,14,37,.378,19,21,.905,103
2364,DEN,2021-12-28,89,@,GSW,W 89-86,240,34,83,.410,26,50,.520,8,33,.242,13,20,.650,89,30,72,.417,20,40,.500,10,32,.313,16,31,.516,86
2365,SAC,2021-12-22,89,,LAC,L 89-105,240,34,85,.400,22,47,.468,12,38,.316,9,12,.750,89,42,82,.512,35,58,.603,7,24,.292,14,16,.875,105
2366,HOU,2021-12-15,89,@,CLE,L 89-124,240,30,78,.385,25,49,.510,5,29,.172,24,35,.686,89,45,80,.563,27,40,.675,18,40,.450,16,24,.667,124
2367,OKC,2021-11-29,89,@,HOU,L 89-102,240,31,87,.356,24,44,.545,7,43,.163,20,26,.769,89,40,96,.417,25,50,.500,15,46,.326,7,11,.636,102
2368,SAC,2021-11-19,89,,TOR,L 89-108,240,32,84,.381,23,47,.489,9,37,.243,16,25,.640,89,38,84,.452,26,53,.491,12,31,.387,20,24,.833,108
2369,OKC,2021-11-19,89,@,MIL,L 89-96,240,32,91,.352,20,43,.465,12,48,.250,13,21,.619,89,31,83,.373,19,42,.452,12,41,.293,22,26,.846,96
2370,CLE,2021-11-18,89,,GSW,L 89-104,240,34,80,.425,22,41,.537,12,39,.308,9,16,.563,89,41,83,.494,26,40,.650,15,43,.349,7,8,.875,104
2371,DEN,2021-11-18,89,,PHI,L 89-103,240,32,89,.360,20,53,.377,12,36,.333,13,16,.813,89,43,85,.506,32,56,.571,11,29,.379,6,12,.500,103
2372,IND,2021-11-17,89,@,DET,L 89-97,240,33,79,.418,24,42,.571,9,37,.243,14,19,.737,89,34,80,.425,26,52,.500,8,28,.286,21,28,.750,97
2373,HOU,2021-11-17,89,@,OKC,L 89-101,240,32,90,.356,20,48,.417,12,42,.286,13,19,.684,89,41,92,.446,31,53,.585,10,39,.256,9,16,.563,101
2374,HOU,2021-11-14,89,,PHO,L 89-115,240,35,85,.412,28,53,.528,7,32,.219,12,18,.667,89,42,97,.433,28,57,.491,14,40,.350,17,20,.850,115
2375,BOS,2021-11-13,89,@,CLE,L 89-91,240,33,78,.423,27,55,.491,6,23,.261,17,18,.944,89,31,81,.383,21,43,.488,10,38,.263,19,22,.864,91
2376,ORL,2021-11-05,89,,SAS,L 89-102,240,35,89,.393,23,48,.479,12,41,.293,7,10,.700,89,40,90,.444,34,71,.479,6,19,.316,16,18,.889,102
2377,DET,2021-11-02,89,,MIL,L 89-117,240,30,93,.323,22,46,.478,8,47,.170,21,30,.700,89,42,84,.500,25,47,.532,17,37,.459,16,21,.762,117
2378,NOP,2021-10-23,89,@,MIN,L 89-96,240,31,89,.348,22,49,.449,9,40,.225,18,23,.783,89,39,96,.406,27,58,.466,12,38,.316,6,10,.600,96
2379,OKC,2022-04-10,88,@,LAC,L 88-138,240,37,98,.378,28,64,.438,9,34,.265,5,9,.556,88,54,97,.557,36,62,.581,18,35,.514,12,14,.857,138
2380,ORL,2022-04-03,88,,NYK,L 88-118,240,30,85,.353,18,41,.439,12,44,.273,16,27,.593,88,45,93,.484,30,49,.612,15,44,.341,13,16,.813,118
2381,PHI,2022-03-20,88,,TOR,L 88-93,240,30,73,.411,23,46,.500,7,27,.259,21,28,.750,88,35,93,.376,28,67,.418,7,26,.269,16,23,.696,93
2382,GSW,2022-03-16,88,,BOS,L 88-110,240,32,86,.372,21,38,.553,11,48,.229,13,16,.813,88,38,81,.469,23,41,.561,15,40,.375,19,22,.864,110
2383,ORL,2022-01-17,88,,POR,L 88-98,240,34,90,.378,26,58,.448,8,32,.250,12,20,.600,88,37,90,.411,30,56,.536,7,34,.206,17,18,.944,98
2384,SAC,2022-01-09,88,@,POR,L 88-103,240,33,85,.388,26,54,.481,7,31,.226,15,21,.714,88,37,88,.420,20,48,.417,17,40,.425,12,15,.800,103
2385,DET,2022-01-06,88,@,MEM,L 88-118,240,34,99,.343,24,55,.436,10,44,.227,10,13,.769,88,48,98,.490,38,66,.576,10,32,.313,12,19,.632,118
2386,MIN,2021-12-28,88,,NYK,L 88-96,240,34,85,.400,27,47,.574,7,38,.184,13,20,.650,88,37,90,.411,21,50,.420,16,40,.400,6,16,.375,96
2387,BOS,2021-12-01,88,,PHI,W 88-87,240,33,79,.418,22,51,.431,11,28,.393,11,15,.733,88,33,89,.371,25,58,.431,8,31,.258,13,17,.765,87
2388,BOS,2021-11-26,88,@,SAS,L 88-96,240,34,92,.370,24,58,.414,10,34,.294,10,15,.667,88,38,87,.437,32,63,.508,6,24,.250,14,19,.737,96
2389,ORL,2021-11-26,88,,CHI,L 88-123,240,30,80,.375,23,48,.479,7,32,.219,21,30,.700,88,48,86,.558,31,52,.596,17,34,.500,10,16,.625,123
2390,TOR,2021-11-10,88,@,BOS,L 88-104,240,33,77,.429,27,52,.519,6,25,.240,16,19,.842,88,42,94,.447,32,65,.492,10,29,.345,10,15,.667,104
2391,DET,2021-10-20,88,,CHI,L 88-94,240,36,90,.400,30,62,.484,6,28,.214,10,13,.769,88,37,86,.430,30,63,.476,7,23,.304,13,15,.867,94
2392,PHI,2022-02-15,87,,BOS,L 87-135,240,23,80,.288,15,48,.313,8,32,.250,33,39,.846,87,46,82,.561,21,37,.568,25,45,.556,18,22,.818,135
2393,OKC,2022-02-11,87,@,PHI,L 87-100,240,35,90,.389,29,55,.527,6,35,.171,11,12,.917,87,36,93,.387,29,67,.433,7,26,.269,21,26,.808,100
2394,LAL,2022-01-27,87,@,PHI,L 87-105,240,36,88,.409,30,59,.508,6,29,.207,9,9,1.000,87,41,82,.500,28,47,.596,13,35,.371,10,17,.588,105
2395,WAS,2022-01-23,87,,BOS,L 87-116,240,33,93,.355,25,59,.424,8,34,.235,13,16,.813,87,40,90,.444,21,51,.412,19,39,.487,17,21,.810,116
2396,OKC,2022-01-22,87,@,CLE,L 87-94,240,33,85,.388,21,44,.477,12,41,.293,9,16,.563,87,35,76,.461,29,49,.592,6,27,.222,18,35,.514,94
2397,NYK,2022-01-17,87,,CHO,L 87-97,240,32,80,.400,20,46,.435,12,34,.353,11,21,.524,87,36,86,.419,22,47,.468,14,39,.359,11,17,.647,97
2398,TOR,2022-01-14,87,@,DET,L 87-103,240,28,87,.322,17,49,.347,11,38,.289,20,26,.769,87,38,81,.469,30,54,.556,8,27,.296,19,23,.826,103
2399,LAC,2022-01-11,87,,DEN,W 87-85,240,34,84,.405,24,50,.480,10,34,.294,9,12,.750,87,32,80,.400,28,47,.596,4,33,.121,17,20,.850,85
2400,DET,2022-01-11,87,@,CHI,L 87-133,240,30,89,.337,24,54,.444,6,35,.171,21,27,.778,87,50,92,.543,32,58,.552,18,34,.529,15,19,.789,133
2401,ATL,2021-12-25,87,@,NYK,L 87-101,240,33,87,.379,20,49,.408,13,38,.342,8,14,.571,87,38,85,.447,18,35,.514,20,50,.400,5,12,.417,101
2402,NYK,2021-12-10,87,@,TOR,L 87-90,240,29,81,.358,20,47,.426,9,34,.265,20,24,.833,87,30,87,.345,18,52,.346,12,35,.343,18,23,.783,90
2403,PHI,2021-12-01,87,@,BOS,L 87-88,240,33,89,.371,25,58,.431,8,31,.258,13,17,.765,87,33,79,.418,22,51,.431,11,28,.393,11,15,.733,88
2404,WAS,2021-11-17,87,@,CHO,L 87-97,240,33,90,.367,25,48,.521,8,42,.190,13,16,.813,87,42,96,.438,32,64,.500,10,32,.313,3,6,.500,97
2405,MEM,2021-11-05,87,@,WAS,L 87-115,240,34,96,.354,28,65,.431,6,31,.194,13,17,.765,87,49,84,.583,39,59,.661,10,25,.400,7,13,.538,115
2406,DEN,2021-10-25,87,,CLE,L 87-99,240,35,86,.407,26,48,.542,9,38,.237,8,12,.667,87,38,82,.463,31,57,.544,7,25,.280,16,20,.800,99
2407,DAL,2021-10-21,87,@,ATL,L 87-113,240,31,93,.333,18,50,.360,13,43,.302,12,13,.923,87,45,94,.479,30,59,.508,15,35,.429,8,9,.889,113
2408,WAS,2022-02-26,86,@,CLE,L 86-92,240,35,81,.432,24,58,.414,11,23,.478,5,6,.833,86,32,83,.386,24,58,.414,8,25,.320,20,24,.833,92
2409,DET,2022-02-08,86,@,DAL,L 86-116,240,33,87,.379,28,57,.491,5,30,.167,15,22,.682,86,40,79,.506,22,43,.512,18,36,.500,18,23,.783,116
2410,CHO,2022-02-05,86,,MIA,L 86-104,240,33,86,.384,23,50,.460,10,36,.278,10,16,.625,86,38,91,.418,27,59,.458,11,32,.344,17,18,.944,104
2411,DET,2022-01-18,86,@,GSW,L 86-102,240,30,85,.353,21,51,.412,9,34,.265,17,24,.708,86,34,83,.410,20,41,.488,14,42,.333,20,27,.741,102
2412,OKC,2022-01-02,86,,DAL,L 86-95,240,35,85,.412,25,55,.455,10,30,.333,6,9,.667,86,38,85,.447,24,46,.522,14,39,.359,5,7,.714,95
2413,GSW,2021-12-28,86,,DEN,L 86-89,240,30,72,.417,20,40,.500,10,32,.313,16,31,.516,86,34,83,.410,26,50,.520,8,33,.242,13,20,.650,89
2414,POR,2021-10-25,86,@,LAC,L 86-116,240,32,85,.376,24,48,.500,8,37,.216,14,18,.778,86,44,93,.473,30,50,.600,14,43,.326,14,19,.737,116
2415,OKC,2021-10-20,86,@,UTA,L 86-107,240,34,91,.374,27,56,.482,7,35,.200,11,18,.611,86,40,91,.440,26,44,.591,14,47,.298,13,15,.867,107
2416,OKC,2022-03-20,85,@,ORL,L 85-90,240,30,92,.326,17,44,.386,13,48,.271,12,18,.667,85,32,83,.386,25,52,.481,7,31,.226,19,24,.792,90
2417,POR,2022-03-09,85,@,UTA,L 85-123,240,29,89,.326,20,53,.377,9,36,.250,18,22,.818,85,42,81,.519,25,35,.714,17,46,.370,22,27,.815,123
2418,SAC,2022-02-14,85,@,BRK,L 85-109,240,31,90,.344,22,55,.400,9,35,.257,14,18,.778,85,43,84,.512,34,58,.586,9,26,.346,14,15,.933,109
2419,GSW,2022-02-09,85,@,UTA,L 85-111,240,28,78,.359,12,35,.343,16,43,.372,13,17,.765,85,41,89,.461,24,38,.632,17,51,.333,12,17,.706,111
2420,IND,2022-02-06,85,@,CLE,L 85-98,240,31,83,.373,23,52,.442,8,31,.258,15,17,.882,85,34,84,.405,23,52,.442,11,32,.344,19,28,.679,98
2421,MEM,2022-01-14,85,,DAL,L 85-112,240,34,89,.382,27,58,.466,7,31,.226,10,13,.769,85,47,91,.516,39,59,.661,8,32,.250,10,16,.625,112
2422,DAL,2022-01-12,85,@,NYK,L 85-108,240,32,78,.410,24,41,.585,8,37,.216,13,19,.684,85,42,90,.467,30,63,.476,12,27,.444,12,15,.800,108
2423,DEN,2022-01-11,85,@,LAC,L 85-87,240,32,80,.400,28,47,.596,4,33,.121,17,20,.850,85,34,84,.405,24,50,.480,10,34,.294,9,12,.750,87
2424,DET,2021-12-29,85,,NYK,L 85-94,240,30,81,.370,18,46,.391,12,35,.343,13,17,.765,85,31,81,.383,23,50,.460,8,31,.258,24,27,.889,94
2425,MIA,2021-12-01,85,,CLE,L 85-111,240,32,85,.376,20,48,.417,12,37,.324,9,13,.692,85,37,68,.544,21,37,.568,16,31,.516,21,23,.913,111
2426,PHI,2021-11-16,85,@,UTA,L 85-120,240,33,90,.367,27,61,.443,6,29,.207,13,17,.765,85,46,89,.517,30,51,.588,16,38,.421,12,19,.632,120
2427,NOP,2021-11-05,85,@,GSW,L 85-126,240,31,88,.352,20,44,.455,11,44,.250,12,16,.750,85,47,91,.516,27,41,.659,20,50,.400,12,14,.857,126
2428,HOU,2021-10-31,85,@,LAL,L 85-95,240,32,76,.421,26,48,.542,6,28,.214,15,29,.517,85,39,96,.406,30,65,.462,9,31,.290,8,13,.615,95
2429,OKC,2021-12-12,84,,DAL,L 84-103,240,30,80,.375,17,43,.395,13,37,.351,11,16,.688,84,38,90,.422,29,57,.509,9,33,.273,18,23,.783,103
2430,IND,2021-11-15,84,@,NYK,L 84-92,240,32,86,.372,24,49,.490,8,37,.216,12,16,.750,84,37,86,.430,26,52,.500,11,34,.324,7,10,.700,92
2431,MIN,2021-11-05,84,,LAC,L 84-104,240,31,89,.348,14,37,.378,17,52,.327,5,7,.714,84,36,88,.409,30,60,.500,6,28,.214,26,32,.813,104
2432,ORL,2022-02-06,83,,BOS,L 83-116,240,29,81,.358,24,55,.436,5,26,.192,20,21,.952,83,45,99,.455,32,53,.604,13,46,.283,13,14,.929,116
2433,ORL,2021-12-26,83,@,MIA,L 83-93,240,31,72,.431,21,40,.525,10,32,.313,11,17,.647,83,36,89,.404,26,55,.473,10,34,.294,11,18,.611,93
2434,POR,2021-12-02,83,,SAS,L 83-114,240,29,82,.354,17,48,.354,12,34,.353,13,17,.765,83,44,91,.484,30,55,.545,14,36,.389,12,16,.750,114
2435,LAL,2021-11-12,83,,MIN,L 83-107,240,29,82,.354,20,41,.488,9,41,.220,16,20,.800,83,43,94,.457,31,57,.544,12,37,.324,9,12,.750,107
2436,BOS,2021-10-22,83,,TOR,L 83-115,240,32,82,.390,21,48,.438,11,34,.324,8,11,.727,83,42,100,.420,32,65,.492,10,35,.286,21,21,1.000,115
2437,TOR,2021-10-20,83,,WAS,L 83-98,240,30,97,.309,23,63,.365,7,34,.206,16,22,.727,83,36,81,.444,31,54,.574,5,27,.185,21,26,.808,98
2438,PHI,2022-03-05,82,@,MIA,L 82-99,240,28,82,.341,21,41,.512,7,41,.171,19,23,.826,82,35,72,.486,22,44,.500,13,28,.464,16,19,.842,99
2439,CLE,2022-01-09,82,@,GSW,L 82-96,240,32,75,.427,25,51,.490,7,24,.292,11,18,.611,82,39,97,.402,29,55,.527,10,42,.238,8,10,.800,96
2440,GSW,2022-01-05,82,@,DAL,L 82-99,240,33,81,.407,28,53,.528,5,28,.179,11,16,.688,82,33,87,.379,21,47,.447,12,40,.300,21,26,.808,99
2441,BOS,2021-12-29,82,,LAC,L 82-91,240,35,101,.347,31,59,.525,4,42,.095,8,11,.727,82,33,81,.407,22,53,.415,11,28,.393,14,17,.824,91
2442,OKC,2021-10-30,82,@,GSW,L 82-103,240,29,83,.349,21,44,.477,8,39,.205,16,21,.762,82,39,92,.424,18,38,.474,21,54,.389,4,8,.500,103
2443,DET,2021-10-23,82,@,CHI,L 82-97,240,34,88,.386,29,60,.483,5,28,.179,9,15,.600,82,35,84,.417,24,58,.414,11,26,.423,16,19,.842,97
2444,POR,2022-03-07,81,@,MIN,L 81-124,240,23,83,.277,16,55,.291,7,28,.250,28,38,.737,81,38,92,.413,25,49,.510,13,43,.302,35,44,.795,124
2445,POR,2022-01-31,81,@,OKC,L 81-98,240,34,81,.420,27,43,.628,7,38,.184,6,8,.750,81,35,86,.407,23,45,.511,12,41,.293,16,17,.941,98
2446,LAC,2021-11-19,81,@,NOP,L 81-94,240,34,90,.378,25,53,.472,9,37,.243,4,5,.800,81,38,87,.437,25,57,.439,13,30,.433,5,8,.625,94
2447,POR,2022-04-10,80,,UTA,L 80-111,240,31,83,.373,22,49,.449,9,34,.265,9,12,.750,80,37,82,.451,28,46,.609,9,36,.250,28,38,.737,111
2448,WAS,2022-02-05,80,,PHO,L 80-95,240,30,85,.353,25,61,.410,5,24,.208,15,19,.789,80,40,99,.404,32,68,.471,8,31,.258,7,14,.500,95
2449,NYK,2021-12-31,80,@,OKC,L 80-95,240,30,81,.370,22,40,.550,8,41,.195,12,22,.545,80,36,87,.414,18,44,.409,18,43,.419,5,7,.714,95
2450,OKC,2021-12-02,79,@,MEM,L 79-152,240,25,76,.329,14,38,.368,11,38,.289,18,22,.818,79,60,96,.625,41,60,.683,19,36,.528,13,18,.722,152
2451,ORL,2021-11-03,79,,BOS,L 79-92,240,27,84,.321,18,41,.439,9,43,.209,16,20,.800,79,33,79,.418,23,42,.548,10,37,.270,16,25,.640,92
2452,LAC,2021-10-27,79,,CLE,L 79-92,240,31,87,.356,22,46,.478,9,41,.220,8,13,.615,79,33,81,.407,30,61,.492,3,20,.150,23,27,.852,92
2453,POR,2022-04-08,78,@,DAL,L 78-128,240,31,83,.373,24,51,.471,7,32,.219,9,12,.750,78,42,79,.532,22,34,.647,20,45,.444,24,31,.774,128
2454,DET,2021-11-12,78,@,CLE,L 78-98,240,29,79,.367,20,49,.408,9,30,.300,11,13,.846,78,39,82,.476,25,41,.610,14,41,.341,6,9,.667,98
2455,MIA,2021-11-04,78,,BOS,L 78-95,240,28,81,.346,19,40,.475,9,41,.220,13,19,.684,78,31,78,.397,15,37,.405,16,41,.390,17,20,.850,95
2456,DAL,2022-03-09,77,,NYK,L 77-107,240,27,86,.314,21,42,.500,6,44,.136,17,25,.680,77,36,84,.429,27,50,.540,9,34,.265,26,33,.788,107
2457,CHI,2021-11-22,77,,IND,L 77-109,240,31,85,.365,25,57,.439,6,28,.214,9,15,.600,77,40,90,.444,27,59,.458,13,31,.419,16,18,.889,109
2458,SAC,2022-01-25,75,@,BOS,L 75-128,240,29,95,.305,23,62,.371,6,33,.182,11,15,.733,75,51,103,.495,31,58,.534,20,45,.444,6,7,.857,128
2459,NYK,2022-01-08,75,@,BOS,L 75-99,240,29,79,.367,18,48,.375,11,31,.355,6,15,.400,75,36,76,.474,24,47,.511,12,29,.414,15,17,.882,99
2460,DAL,2021-10-29,75,@,DEN,L 75-106,240,23,78,.295,15,41,.366,8,37,.216,21,27,.778,75,43,83,.518,32,47,.681,11,36,.306,9,13,.692,106